Affrica	Afrika
Iapan	Japan
Sūðamerica	Sydamerika
Norþweg	Norge
Englaland	England
Scotland	Skottland
Wēalas	Wales
Norðerne Īrland	Nordirland
Īrland Cynewīse	Irland
Ungerland	Ungern
Spēonland	Spanien
Geānedu Rīcu American	USA
Belgice	Belgien
Letseburg	Luxemburg
Eorðe	Jorden
Līf	Liv
George Washington	George Washington
Finnland	Finland
Swēoland	Sverige
Denemearc	Danmark
Polaland	Polen
Liþþuania	Litauen
Italia	Italien
Swissland	Schweiz
Ēastrīce	Österrike
Grēcland	Grekland
Turcland	Turkiet
Bēor	Öl
Portugal	Portugal
Europe	Europa
Asia	Asien
Norðamerica	Nordamerika
Antarctica	Antarktis
Wikipǣdia	Wikipedia
Niðerland	Nederländerna
Nīweoforwīcburg	New York
Hwæsingatūn, D.C.	Washington, D.C.
Berlin	Berlin
Los Angeles	Los Angeles
Spearctelle	Dator
Genf	Genève
Betweoxnett	Internet
Barack Obama	Barack Obama
Uruguay	Uruguay
Lunden	London
Æppel	Äpple
Paris	Paris
Abraham Lincoln	Abraham Lincoln
Android	Android (operativsystem)
Google	Google
Mexico	Mexiko
Atlantisc Gārsecg	Atlanten
Sericus Gārsecg	Stilla havet
California	Kalifornien
Mōnandæg	Måndag
Æfterra Gēola	Januari
Solmōnaþ	Februari
Hrēþmōnaþ	Mars (månad)
Tīw (tungol)	Mars (planet)
Cenia	Kenya
Sigelhearwenaland	Etiopien
Ēastermōnaþ	April
Þrimilcemōnaþ	Maj
Sēremōnaþ	Juni
Mǣdmōnaþ	Juli
Wēodmōnaþ	Augusti
Hāligmōnaþ	September
Winterfylleþ	Oktober
Blōtmōnaþ	November
Gēolmōnaþ	December
Tīwesdæg	Tisdag
Wēdnesdæg	Onsdag
Þunresdæg	Torsdag
Frīgedæg	Fredag
Sæternesdæg	Lördag
Sunnandæg	Söndag
Lēo	Lejon
Francland	Frankrike
Esperanto	Esperanto
Geāned Cynerīce	Storbritannien
Catte	Katt
Cīnan Folclicu Cynewīse	Kina
Frencisc sprǣc	Franska
Fisc	Fiskar
Brasil	Brasilien
Russland	Ryssland
Eoferwicscīr	Yorkshire
Sǣ	Hav
Euxinus	Svarta havet
Toronto	Toronto
Alabama	Alabama
São Paulo	São Paulo
São Paulo (rīce)	São Paulo (delstat)
Quebec	Québec
Piza	Pizza
Þēodscland	Tyskland
Hwītrussland	Vitryssland
Þēodsc sprǣc	Tyska
Īsland	Island
God	Gud
Estland	Estland
Sætern (tungol)	Saturnus
Ceocōlāte	Choklad
2 (getæl)	2 (tal)
Þrīe	3 (tal)
Fēower	4 (tal)
Fīf	5 (tal)
George W. Bush	George W. Bush
Lettland	Lettland
Ucrægna	Ukraina
Cecland	Tjeckien
Slofacia	Slovakien
Slofenia	Slovenien
Vilnius	Vilnius
Moldofa	Moldavien
Rumǣnia	Rumänien
Pulgaraland	Bulgarien
Rōm	Rom
Macedonia Cynewīse	Makedonien
Albania	Albanien
Grēneland	Grönland
Croatia	Kroatien
Bosnia and Herzegofina	Bosnien och Hercegovina
Godhopa	Nuuk
Azerbaijan	Azerbajdzjan
Andorra	Andorra
Cipros	Cypern
Georgia (land)	Georgien
Casahstan	Kazakstan
Melita	Malta
Flandras	Flandern
Monaco	Monaco
Sweartbeorg	Montenegro
Faticanburg	Vatikanstaten
San Marino	San Marino
Brysel	Bryssel (kommun)
Cūba	Kuba
Barbados	Barbados
Cǣgbord (spearctellend)	Tangentbord
Indonesia	Indonesien
Wolfgang Amadeus Mozart	Wolfgang Amadeus Mozart
Ludwig van Beethoven	Ludwig van Beethoven
Sūðaffrica	Sydafrika
Algeria	Algeriet
Usbecastan	Uzbekistan
Warsaw	Warszawa
Wīn (drinc)	Vin
Wæter	Vatten
Holt	Trä
Feorrsīen	Television
Īslendisc sprǣc	Isländska
Cile	Chile
Iesus	Jesus
Elvis Presley	Elvis Presley
Wōden (tungol)	Merkurius
Stǣr	Historia
Apple Inc.	Apple Inc.
Frig (tungol)	Venus
Sprǣc	Språk
Lufu	Kärlek
Þunor (tungol)	Jupiter
Uranus	Uranus
Neptune (planēta)	Neptunus
Tungolcræft	Astronomi
Witancræft	Vetenskap
Pluto	Pluto
Montreal	Montréal
Lēohtenstān	Liechtenstein
Plega	Sport
Grantanbrycg	Cambridge
Adolf Hitler	Adolf Hitler
Fyrst Woruldgūþ	Första världskriget
Ōðru Woruldgūþ	Andra världskriget
Wikibēc	Wikibooks
Augusto Pinochet	Augusto Pinochet
Geanca Cupala	Janka Kupala
Ubuntu	Ubuntu
Stettin	Szczecin
Rīmcræft	Matematik
U2	U2
Lǣden	Latin
Bahrain	Bahrain
Armenia	Armenien
Serbia	Serbien
Mōna	Månen
Constantinopolis	Istanbul
Australia	Australien
Bob Marley	Bob Marley
Argentina	Argentina
Peru	Peru
Norþcorēa	Nordkorea
Cambodia	Kambodja
Kuiperes gyrtel	Kuiperbältet
Curān	Koranen
Alladōm	Islam
Lech Wałęsa	Lech Wałęsa
Europisce Gesamnung	Europeiska unionen
Woruldwīd Webb	World Wide Web
Wīf	Kvinna
Wætertyge	Akvedukt
Don Quijote	Don Quijote
Megelan	Milano
Burg	Stad
Napoleon I Francena Cāsere	Napoleon I
Uesuuius	Vesuvius
Sunne	Solen
Lēohtgēar	Ljusår
Sunnlicu Endebyrdnes	Solsystemet
Ostsǣ	Östersjön
Wisle	Wisła
Tōþ	Tänder
Wætertimber	Väte
Wikimedia Commons	Wikimedia Commons
Dæg	Dygn
Ēasttimor	Östtimor
Niht	Natt
Gēar	År
Hundgēar	Sekel
Rīn	Rhen
Oslo	Oslo
Katowice	Katowice
1 Ceres	Ceres (dvärgplanet)
Ii	Iona
Dubai	Dubai
Folga	Volga
Æðmlyft	Syre
Dweligende tungol	Planet
Venetia	Venedig
Naruto	Naruto
Moscow	Moskva
Italisc sprǣc	Italienska
Cead	Tchad
Nīwe Sǣland	Nya Zeeland
Indea	Indien
Īsen	Järn
Willelm Scacaspere	William Shakespeare
Lēad	Bly
Mongolland	Mongoliet
Ficgīege	Fiji
Feneswela	Venezuela
Blēobord	Schack
Maine	Maine
Hors	Häst
Amsterdam	Amsterdam
Wǣpen	Vapen
Dēor	Djur
Paraguay	Paraguay
Ecuador	Ecuador
Colombia	Colombia
Strēawberge	Smultronsläktet
Buddendōm	Buddhism
Bolifia	Bolivia
Coper	Koppar
Plante	Växt
Nīwu Hāmtūnscīr	New Hampshire
Iamaica	Jamaica
Massachusetts	Massachusetts
Connecticut	Connecticut
Henn	Tamhöna
Hawaii	Hawaii
Cēsarēa	Jersey
Swīn	Gris
Īshæf	Norra ishavet
Persealand	Iran
Irac	Irak
Alaska	Alaska
Israhēl	Israel
Utrecht	Utrecht
Gemen	Jemen
Clēofanwyrm	Virus
Polisc sprǣc	Polska
Hascemisc Cynerīce þæs Iordanes	Jordanien
Florida	Florida
Arizona	Arizona
Cuwait	Kuwait
Libanus	Libanon
Oregon	Oregon
Utah	Utah
Hriðer	Nötkreatur
Malægsia	Malaysia
Burma	Burma
Oman	Oman
Pacistan	Pakistan
Qatar	Qatar
Tennis	Tennis
Saudisc Arabea	Saudiarabien
Tāprabane	Sri Lanka
Iosep Stalin	Josef Stalin
Syria	Syrien
Plato	Platon
Tacgicastan	Tadzjikistan
Aristoteles	Aristoteles
Thailand	Thailand
Ūtƿeorp	Radio
Turcmenistan	Turkmenistan
Geānedu Arabisc Bregorīcu	Förenade Arabemiraten
Fietnam	Vietnam
Sūþcorēa	Sydkorea
Afghanistan	Afghanistan
J. R. R. Tolkien	J.R.R. Tolkien
Gold	Guld
Bængladesc	Bangladesh
Bleach (manga)	Bleach (manga)
Socrates	Sokrates
Angola	Angola
Tansania	Tanzania
Philippines	Filippinerna
Middel Affricanisc Cynewīse	Centralafrikanska republiken
Sūþende þǣre eaxe	Sydpolen
Norþende þære eaxe	Nordpolen
Isaac Newton	Isaac Newton
Albert Einstein	Albert Einstein
Geolu	Gul
Tunisia	Tunisien
Simbabwe	Zimbabwe
Beicing	Peking
Sūþsudan	Sydsudan
Botswana	Botswana
Burkina Faso	Burkina Faso
Folcrīcelicu Cynewīse þæs Congwes	Kongo-Kinshasa
Bægwaraland	Bayern
Baden-Wyrttemberg	Baden-Württemberg
Æriþrea	Eritrea
Nīwe Delhi	New Delhi
Iohannes Paulus II Pāpa	Johannes Paulus II
Gabon	Gabon
Mohandas Karamchand Gandhi	Mahatma Gandhi
Gambia	Gambia
Guinea	Guinea
Elpendbānrima	Elfenbenskusten
Camerun	Kamerun
Grēnenæs Īega	Kap Verde
Lesotho	Lesotho
Liberia	Liberia
Libia	Libyen
Madagascar	Madagaskar
Mauritania	Mauretanien
Morocco	Marocko
Mosambice	Moçambique
Namibia	Namibia
Nigeria	Nigeria
Charles Darwin	Charles Darwin
Uganda	Uganda
Rwanda	Rwanda
Sōmalia	Somalia
Gaius Iulius Caesar	Julius Caesar
Sudan	Sudan
Swasiland	Swaziland
Hamburg	Hamburg
Heorte	Hjärta
Brægen	Hjärna
Prag	Prag
Bleoh	Blå
Seolfor	Silver
Tin	Tenn
Reddit	Reddit
Elsass	Alsace
Bihar	Bihar
Michigan	Michigan
Puerto Rico	Puerto Rico
Niðerseaxland	Niedersachsen
Hetwaraland	Hessen
Illinois	Illinois
Norþdakota	North Dakota
Brandenburg	Brandenburg
Langbeardnaland	Lombardiet
Sūþdakota	South Dakota
Montǣna	Montana
Wyoming	Wyoming
Ierusalem	Jerusalem
Idaho	Idaho
Hwæsingatūn	Washington (delstat)
Nevada	Nevada
Danais	Don (flod)
Indisc Gārsecg	Indiska oceanen
Caribisc Sǣ	Karibiska havet
Colorado	Colorado
Tuscania	Toscana
Alpis	Alperna
Gænt	Gent
Chicago	Chicago
The Beatles	The Beatles
Winter	Vinter
Ēawielm	Vår
Efenniht	Dagjämning
Spēonisc sprǣc	Spanska
Caligardamana	Calcutta
West Bengal	Västbengalen
Ātorcoppe	Spindlar
Virginia	Virginia
Westvirginia	West Virginia
Nīwe Eoforwīc	New York (delstat)
Rhode Īeg	Rhode Island
Ceorfdēor	Insekter
Marianland	Maryland
Delaware	Delaware
Fladimir Lenin	Vladimir Lenin
Ohio	Ohio
Pennsylvānia	Pennsylvania
Uetersen	Uetersen
Augustus	Augustus
Microsoft Windows	Microsoft Windows
Nīwe Cēsarēa	New Jersey
Calpis	Gibraltar
Finnisc sprǣc	Finska
Indiǣna	Indiana
Selffērende wægn	Bil
Roger Federer	Roger Federer
Georgia (America)	Georgia
Marcus Aurelius	Marcus Aurelius
Texas	Texas
Puilla	Apulien
Norþcarolīna	North Carolina
Sūþcarolīna	South Carolina
Sicilia	Sicilien
Sardinia	Sardinien
Ligore	Loire
Sigen	Seine
Buenos Aires	Buenos Aires
Mexicoburg	Mexico City
Pīnæppel	Ananas
Mississippi	Mississippi
Mississippi ēa	Mississippifloden
Mizoram	Mizoram
Tennessee	Tennessee
Abu Dhabi	Abu Dhabi
Nīwe Mexico	New Mexico
Athēnas	Aten
Minnesota	Minnesota
Wisconsin	Wisconsin
Iowa	Iowa
Nebraska	Nebraska
Kansas	Kansas
Hafana	Havanna
Pīpwēod	Tobak
Missouri	Missouri
Louisiāna	Louisiana
Nagaland	Nagaland
Kentucky	Kentucky
Arkansas	Arkansas
Ælf ēa	Elbe
Oklahoma	Oklahoma
Donua	Donau
Hæfel	Havel
Norþsǣ	Nordsjön
Flēogeball	Volleyboll
Uigenna	Wien
Cēapmannahæfen	Köpenhamn
Stoccholm	Stockholm
Helsinki	Helsingfors
Difelin	Dublin
Rēcwīc	Reykjavik
Riga	Riga
Menuþias	Zanzibar
Dantsic	Gdańsk
Frankfurt	Frankfurt am Main
Death Note	Death Note
Biblioþēce	Bibeln
Ho Chi Minh Burg	Ho Chi Minh-staden
Sōþ Iesus Cirice	The True Jesus Church
Nīwenglisc sprǣc	Engelska
Andorra la Vella	Andorra la Vella
Đồng Hới	Dong Hoi
Concepcion	Concepción, Chile
Cænugeard	Kiev
Ontario	Ontario
Ottawa	Ottawa
Alberta	Alberta
Nīwe Scotland	Nova Scotia
Końskowola	Końskowola
Geocon Landscipe	Yukon
Florentia	Florens
Ǣt	Mat
Snaca	Ormar
Halifax	Halifax, Nova Scotia
Quebecceaster	Québec (stad)
3. Æfterran Gēolan	3 januari
4. Æfterran Gēolan	4 januari
Región del Biobío (Cile)	Región del Biobío
5. Æfterran Gēolan	5 januari
Arica	Arica
6. Æfterran Gēolan	6 januari
7. Æfterran Gēolan	7 januari
8. Æfterran Gēolan	8 januari
9. Æfterran Gēolan	9 januari
10. Æfterran Gēolan	10 januari
11. Æfterran Gēolan	11 januari
12. Æfterran Gēolan	12 januari
13. Æfterran Gēolan	13 januari
Beormingahām	Birmingham
14. Æfterran Gēolan	14 januari
15. Æfterran Gēolan	15 januari
16. Æfterran Gēolan	16 januari
17. Æfterran Gēolan	17 januari
18. Æfterran Gēolan	18 januari
Rōmānisc Rīce	Romerska kejsardömet
Microsoft	Microsoft
30. Æfterran Gēolan	30 januari
Kurów	Kurów
11. Solmōnðes	11 februari
11. Gēolmōnþes	11 december
12. Gēolmōnðes	12 december
17. Gēolmōnðes	17 december
Wæþ	Forth (flod)
Þrittiggēara Orlege	Trettioåriga kriget
Benedictus XVI Pāpa	Benedictus XVI
6. Ēastermōnðes	6 april
4. Ēastermōnþes	4 april
Helmut Kohl	Helmut Kohl
17. Ēastermōnðes	17 april
12. Þrimilcemōnþes	12 maj
13. Þrimilcemōnþes	13 maj
20. Þrimilcemōnðes	20 maj
31 Þrimilcemōnaþ	31 maj
6. Mǣdmōnðes	6 juli
1. Mǣdmōnðes	1 juli
18. Mǣdmōnðes	18 juli
Gyldfōtþōðer	Fotboll
26. Gēolmōnðes	26 december
Eallbærnet	Förintelsen
IPad	Ipad
Madrid	Madrid
Elton John	Elton John
Undersǣbāt	Ubåt
26. Wēodmōnðes	26 augusti
24. Wēodmōnðes	24 augusti
2. Hāligmōnþes	2 september
Kassel	Kassel
25. Hāligmōnðes	25 september
Santiago (Cile)	Santiago de Chile
1. Winterfylleðes	1 oktober
14. Winterfylleðes	14 oktober
8. Winterfylleðes	8 oktober
7. Winterfylleðes	7 oktober
Oldenburg (Oldenburg)	Oldenburg
26. Winterfylleðes	26 oktober
4. Blōtmōnðes	4 november
1. Blōtmōnðes	1 november
Wolfsburg	Wolfsburg
Carl Micela Francena Cyning	Karl den store
Canberra	Canberra
Sydney	Sydney
Grēne	Grön
Rēad	Röd
Perþ (Australia)	Perth, Western Australia
Fȳr	Eld
Westerne Australia	Western Australia
Nīwe Sūþwealas	New South Wales
Norþerne Landscipe	Northern Territory
Australisc Hēafodbyrig Landscipe	Australian Capital Territory
Fīfeldor	Eider
Nīl	Nilen
Heortfordscīr	Hertfordshire
Comēta	Komet
Antofagasta	Antofagasta
Ancyra	Ankara
Flocc:Bysen	Kategori:Mallar
Castro (Cile)	Castro (Chile)
Frencisc Guiana	Franska Guyana
Chillán (Cile)	Chillán
Amāzanēa	Amazonfloden
Tybingen	Tübingen
Coyhaique	Coyhaique
Flocc:Bysen Land	Kategori:Mallar med anknytning till länder
Willelmeshæfen	Wilhelmshaven
Copiapó (Cile)	Copiapó
Manama	Manama
Delmenhorst	Delmenhorst
Brandenburg (burg)	Brandenburg an der Havel
Wikipǣdia:Sandbox	Wikipedia:Sandlådan
Wikipǣdia:Inlǣdung	Wikipedia:Välkommen till Wikipedia
Cantabria	Kantabrien
Hūs	Hus
Rīmagiefung	Algebra
Mennisc bodiglār	Människans anatomi
Osasco	Osasco
Fujairah	Fujairah
Glasgow	Glasgow
Donghoi Lyfthæfene	Dong Hoi flygplats
Rodor	Rymden
Sweartweald	Schwarzwald
Curitiba	Curitiba
Weald	Skog
Flocc:Cliferfētedēor	Kategori:Partåiga hovdjur
Talca	Talca
Flothere	Örlogsflotta
Andalién	Andalién
Bysen:Lang-lt	Mall:Lang-lt
Cwidbōc	Ordspråksboken
Rancagua	Rancagua
Confucius	Konfucius
Corbin Bleu	Corbin Bleu
Flocc:Rīmcræft	Kategori:Matematik
Faroisca Īega	Färöarna
Wendelsǣ	Medelhavet
Flocc:Nīwes Sǣlandes īga	Kategori:Nya Zeelands öar
Cōcnearuness	Cooksundet
Crīstendōm	Kristendom
Windows 8	Windows 8
Bysen:Asia	Mall:Asien
Gandis	Ganges
Worulddǣl	Världsdelar och kontinenter
Fugol	Fåglar
Hēafodstōl	Huvudstad
Monzón	Monzón
Portuglisc sprǣc	Portugisiska
Mōnaþ	Månad
Almazán	Almazán
Huang Siānfan	Huang Xianfan
Kescwisc sprǣccynn	Quechua
Bill Gates	Bill Gates
Iapanisc sprǣc	Japanska
Wīsdōmbōc	Uppslagsverk
Hēafodtramet	Portal:Huvudsida
Golf	Golf
Hrōcburhfōtþōðer	Rugby
Olympisc Gamen	Olympiska spelen
Eurasia	Eurasien
Andes	Anderna
Durban	Durban
Caspia	Kaspiska havet
Uictoriamere	Victoriasjön
Estmere	Frisches Haff
Babilōn	Babylon
Ēalendisca Īega	Åland
Cægman Īegland	Caymanöarna
Novak Đoković	Novak Đoković
Fortunatus iegland	Kanarieöarna
Ūðwitegung	Filosofi
Flocc:Candidates for speedy deletion	Kategori:Snabbraderingar
Tē	Te
Hebe Camargo	Hebe Camargo
Gemǣnre ǣhte rǣd	Kommunism
Wealdlīste rǣd	Anarkism
Ǣhtwealdes endebyrdness	Kapitalism
Frēodōmes þōht	Liberalism
Gilmrǣd	Fascism
Cofentreo	Coventry
Lodi	Lodi
Ōðre Penisc Gūþ	Andra puniska kriget
Cartaina	Karthago
Bryttisc Museum	British Museum
Sund	Simning
1451	1451
Ellaspontus	Dardanellerna
Strǣtburg	Strasbourg
Gytārre	Gitarr
Croatisc sprǣc	Kroatiska
Cesena	Cesena
Hāmburgere	Hamburgare
Fédération Internationale de Volleyball	Fédération Internationale de Volleyball
20e gēarhundred	1900-talet
Stefan Raab	Stefan Raab
Catalan sprǣc	Katalanska
11e gēarhundred	1000-talet
Gelēaflēasnes	Ateism
Cynn scī huang	Qin Shi Huangdi
Elisabeþ I Engla Cwēn	Elisabet I av England
Cynewīse	Republik
Þēodlices gemǣnscipes rǣd	Nazism
Nazi Þēodscland	Nazityskland
Christopher Columbus	Christofer Columbus
Iacobus Cōc	James Cook
Ēare	Öra
Nasu	Nos
Ēage	Öga
Scēap	Tamfår
Mereswīn	Delfiner
Sǣhund	Hajar
Sycedēor	Däggdjur
Ǣmette	Myror
Niðerlendisc sprǣc	Nederländska
Ǣȝƿyrt	Aubergine
Draca	Drake
Mōdor	Moder
Snāw	Snö
Wæterþōðer	Vattenpolo
1865	1865
Napoleon III Francena Casere	Napoleon III
Russisc sprǣc	Ryska
Hloþwig XIV Francena Cyning	Ludvig XIV av Frankrike
Hām	Hem
Vladimir Putin	Vladimir Putin
Loðwic-Philippus Francena Cyning	Ludvig Filip I av Frankrike
Þēodacynewīse	Samväldet
Hlāf	Bröd
Taurica	Krim
Līfclēofa	Cell
Blōd	Blod
Īwungplega	Datorspel
Rumǣnisc sprǣc	Rumänska
Regn	Regn
Medumweder	Klimat
Woruldlicu wearmung	Global uppvärmning
Eorþbeofung	Jordbävning
Museum on Dēoraby	Derby Museum and Art Gallery
Winston Churchill	Winston Churchill
Nelson Mandela	Nelson Mandela
10. gēarhundred	900-talet
Fȳrbeorg	Vulkan
Wolcen	Moln
Īwungplegtōl	Spelkonsol
Wind	Vind
Lyfthelm	Atmosfär
Sprǣccræft	Språkvetenskap
Flocc:Pulgaraland	Kategori:Bulgarien
Flocc:Francland	Kategori:Frankrike
Flocc:Glīƿdrēam	Kategori:Musik
Flocc:Bōccræft	Kategori:Litteratur
Fox	Rödräv
Valladolid	Valladolid
Alexander Mæcedonia Cyning	Alexander den store
Hēaphandþōðer	Handboll
Hugo Chávez	Hugo Chávez
Þēowdōm	Slaveri
Caffig	Kaffe
Meolc	Mjölk
Beorg	Berg
Oferswefn	Hypnos
Andrew Johnson	Andrew Johnson
Miami	Miami
Americanisce Ingefeoht	Amerikanska inbördeskriget
Rio de Janeiro	Rio de Janeiro
Bryttisce Rīce	Brittiska imperiet
Albanisc sprǣc	Albanska
Ucrægnisc sprǣc	Ukrainska
Crabba (steorra)	Kräftan (stjärnbild)
Swēonisc sprǣc	Svenska
Denisc sprǣc	Danska
Norðisc sprǣc	Norska
Noam Chomsky	Noam Chomsky
Bæmisc sprǣc	Tjeckiska
Karl Marx	Karl Marx
Lettisc sprǣc	Lettiska
Liþþuanisc sprǣc	Litauiska
Hinduismus	Hinduism
Wīflicu brēost	Kvinnobröst
Mot	Atom
Crēacisc sprǣc	Grekiska
Weorcendebyrdness	Operativsystem
Īrisc sprǣc	Iriska
Ambihtlic Cīnisc sprǣc/ᚱᚢᚾ	Mandarin (språk)
C. S. Lewis	C.S. Lewis
Baku	Baku
Hebrēisc sprǣc	Hebreiska
Azeri sprǣc	Azerbajdzjanska
Wilisc sprǣc	Kymriska
Scyttisce sprǣc	Skotsk gäliska
John Locke	John Locke
Friedrich Nietzsche	Friedrich Nietzsche
Lifere	Lever
Drēag (Fūdū)	Zombie
Gārsecg	Ocean
Gautama Budda	Buddha
Premier League	Premier League
Mahomet	Muhammed
Ācweorna	Ekorrar
Rēmisc Cirice	Romersk-katolska kyrkan
Bengalisc sprǣc	Bengali
Tunge	Tunga
Folcland Īegland	Falklandsöarna
Manīeg	Isle of Man
Wiht (īeg)	Isle of Wight
Heortford	Hertford
Elisabeþ II	Elizabeth II
ß	ß
John F. Kennedy	John F. Kennedy
Ronald Reagan	Ronald Reagan
Æ	Æ
Ð	Ð
Fernando Alonso	Fernando Alonso
Flocc:Feneswela	Kategori:Venezuela
Þunreshæfen	Torshamn
11. Hāligmōnþes 2001. torngemōt	11 september-attackerna
Culfre	Duvor
Trēow	Träd
Cīese	Ost
Wīnberge	Druva
Hunig	Honung
Eorþperu	Potatis
Searuþræl	Robot
Searucræft	Teknologi
Feorrspreca	Telefon
Lugo	Lugo
Hēahdēmere þāra Geāndena Rīca American	Chefsdomare i USA:s högsta domstol
Windows 7	Windows 7
Windows Vista	Windows Vista
World Trade Center	World Trade Center
Nelson Rockefeller	Nelson Rockefeller
David Rockefeller	David Rockefeller
One World Trade Center	One World Trade Center
Fidel Castro	Fidel Castro
Rockefeller Center	Rockefeller Center
Flocc:Brasil	Kategori:Brasilien
Flocc:Rumǣnia	Kategori:Rumänien
Hēafodgesceaft	Grundämne
Gemot	Molekyl
Cræftlicu endebyrdung	Vetenskapligt namn
Lyft	Gas
Lyftcræft	Flygmaskin
Clāðas	Kläder
Swēg	Ljud
Paper	Papper
Rīm	Tal
Bere	Korn
Nirvana	Nirvana (musikgrupp)
Weder	Väder
Land þǣre worulde	Lista över självständiga stater
Bera	Björnar
John Adams	John Adams
Thomas Jefferson	Thomas Jefferson
James Madison	James Madison
James Monroe	James Monroe
John Quincy Adams	John Quincy Adams
Andrew Jackson	Andrew Jackson
Martin Van Buren	Martin Van Buren
William Henry Harrison	William Henry Harrison
John Tyler	John Tyler
James K. Polk	James K. Polk
Zachary Taylor	Zachary Taylor
Ǣtweg	Matspjälkning
Kylie Minogue	Kylie Minogue
Āc	Eksläktet
Pīntrēow	Tallsläktet
Āte	Havre
Hwǣte	Vetesläktet
Corn	Sädesslag
Unmeaht	Funktionsnedsättning
Gerīmbōc	Kalender
Ādl	Sjukdom
Gregorisc gerīmbōc	Gregorianska kalendern
Manisc sprǣc	Manx (språk)
Bysen:Stedefindend scite Breten	Mall:Kartposition Storbritannien
Millard Fillmore	Millard Fillmore
Franklin Pierce	Franklin Pierce
James Buchanan	James Buchanan
Pireni	Pyrenéerna
Hālig Rōmānisc Rīce	Tysk-romerska riket
Mongolrīce	Mongolväldet
Oþomanisce Rīce	Osmanska riket
Cirice Ednīwung	Reformationen
Wīcingas	Viking
Sweord	Svärd
Fȳrwǣpen	Eldvapen
Iberia	Pyreneiska halvön
Fȳrspringend	Sprängämne
Campwægn	Stridsvagn
Antwerpen	Antwerpen
Brycg (burh)	Brygge
Blæcberige	Björnbär
Fenberge	Tranbär
Cīnisc gōsberige	Kiwi
Retoromanisc sprǣc	Rätoromanska
Īsrēam	Glass
Ceace	Kaka
Īsbrīw	Sorbet
Dinegisc sprǣc	Navajo (språk)
Meolcbrīw	Yoghurt
Montserrat	Montserrat
Bysen:Location map Greenland	Mall:Kartposition Grönland
Wikicynn	Wikispecies
Arabisc sprǣc	Arabiska
Ian Magen	Jan Mayen
Corsica	Korsika
Affricanisc sprǣc	Afrikaans
Forma Þegn þæs Geānedan Cynerīces	Storbritanniens premiärminister
Santiago de Compostela	Santiago de Compostela
Fiscoþ	Fiske
Iquique	Iquique
La Serena (Cile)	La Serena
Las Condes	Las Condes
Niðerscyttisc sprǣc	Lågskotska
Linux (cyrnel)	Linux (kärna)
Darwin (æhtendebyrd)	Darwin (operativsystem)
Emmen	Emmen
Sofiet Gesamnung	Sovjetunionen
Se Hlāford þāra Hringa	Sagan om ringen
Hrūse	Jordskorpa
Sīensearu	Kamera
Gaðes	Cádiz
Llión	León
Fōt	Fot
Queen	Queen
Freddie Mercury	Freddie Mercury
Normandig	Normandie
Metallica	Metallica
Wikipǣdia:Fulgōd gewritu	Wikipedia:Utmärkta artiklar
Bysen:Link FA	Mall:Link FA
Lēoht (dæg)	Dagsljus
Wikipǣdia:Se Þorpes Wella	Wikipedia:Bybrunnen
Vermont	Vermont
Jacksonville, Florida	Jacksonville, Florida
Los Ángeles (Cile)	Los Ángeles
Eþna	Etna
Æg	Ägg
Tibet	Tibet
Handsprecend	Mobiltelefoni
Strȳta	Struts
Corēa	Korea
Wesend	Bison (släkte)
Mameceaster	Manchester
Turcas and Caicos Īegland	Turks- och Caicosöarna
Blēocræft	Broderi
Wulf	Varg
Major League Soccer	Major League Soccer
Þōðer	Boll
Club de Gimnasia y Esgrima La Plata	Club de Gimnasia y Esgrima La Plata
Nīwu Gecȳþnes	Nya Testamentet
Middelseaxe	Middlesex
San Pedro de la Paz	San Pedro de la Paz
Nha Trang	Nha Trang
Podolsk	Podolsk
Pāpa	Påve
Rafael Correa	Rafael Correa
5	5
Louvre	Louvren
Sæfern	Severn
Temes	Themsen
Tirana	Tirana
Motorhead	Motörhead
Afen	Bristol Avon
6	6
Josh Duhamel	Josh Duhamel
Stīðen Āc	Stevenage
Crīstesmæsse	Jul
Bises	Skottår
Steve Jobs	Steve Jobs
Indo-Europisc sprǣchīred	Indoeuropeiska språk
Breinigerberg	Breinigerberg
Muammar al-Gaddafi	Muammar al-Gaddafi
Tiger	Tiger
Moru	Rotfrukter
Samsunghēap	Samsung
Ēaster	Påsk
Germanisca sprǣca	Germanska språk
Windows Mobile	Windows Mobile
GNU Frēo Gewrita Amearcunge Lēaf	GNU Free Documentation License
John Kerry	John Kerry
Taiwan (īeg)	Taiwan (ö)
Searusprecend	Smarttelefon
Trōia	Troja
Nīwe Eoforwīc (scīrung)	New York (olika betydelser)
Ceafer	Skalbaggar
Scōh	Sko
Baðanceaster	Bath
Īrland	Irland (ö)
Bradanford	Bradford
Ceasterscīr	Cheshire
Lonceasterscīr	Lancashire
Norþhymbraland	Northumberland
Dūnholmscīr	Durham (grevskap)
Lincolnscīr	Lincolnshire
Snotingahāmscīr	Nottinghamshire
Dēorabyscīr	Derbyshire
Scrobbesbyrigscīr	Shropshire
Stæffordscīr	Staffordshire
Lægreceastrescīr	Leicestershire
Roteland	Rutland
Norþfolc	Norfolk
Sūþfolc	Suffolk
Grantabrycgscīr	Cambridgeshire
Norþhāmtūnescīr	Northamptonshire
Westmidlandscīr	West Midlands (storstadsområde)
Herefordscīr	Herefordshire
Wigreceastrescīr	Worcestershire
Wæringscīr	Warwickshire
Beadanfordscīr	Bedfordshire
Cornweal	Cornwall
Bricgstōw	Bristol
Defenascīr	Devon, England
Sumorsǣte	Somerset
Dorsǣte	Dorset
Gleawcesterscīr	Gloucestershire
Oxnafordscīr	Oxfordshire
Wiltūnscīr	Wiltshire
Hāmtūnescīr	Hampshire
Bearrucscīr	Berkshire
Buccingahāmscīr	Buckinghamshire
Ēastseaxe	Essex
Sūþrīge	Surrey
Cent	Kent (grevskap)
Lundenceaster	City of London
Westmoringaland	Westmorland
Huntandūnscīr	Huntingdonshire
Sūþseaxe	Sussex
Seofon	7 (tal)
Taylor Lautner	Taylor Lautner
Cumbraland	Cumberland
Jeremy Renner	Jeremy Renner
Īs	Is
Fæder ūre	Herrens bön
Musée d'Orsay	Musée d’Orsay
Hwerhwette	Gurka
Edinburg	Edinburgh
Hwīt	Vit
Sweart	Svart
Chris Pine	Chris Pine
Lordi	Lordi
6 (getæl)	6 (tal)
Ambihtlicu sprǣc	Officiellt språk
Heortæppel	Tomat
Phong Nha-Ke Bang	Phong Nha-Ke Bang nationalpark
Entrena	Entrena
Selena	Selena Quintanilla
NASA	NASA
Merida (Feneswela)	Mérida, Venezuela
Atlanta	Atlanta
Benito Mussolini	Benito Mussolini
Bermuda	Bermuda
Hēafod	Huvud
Weolingtūn (Nīwe Sǣland)	Wellington
Bryten	Storbritannien (ö)
Alfred Nobel	Alfred Nobel
Camb (tō hǣre)	Kam
Lila Downs	Lila Downs
Andrew Garfield	Andrew Garfield
Dottatiger	Gepard
Rosanna Davison	Rosanna Davison
Albany on Nīwum Eoforwīce	Albany, New York
Ūle	Ugglor
Anguilla	Anguilla
Guernsey	Guernsey
Scearpbeorgas	Svalbard
Hrycgdēor	Ryggradsdjur
Nowy Dwór Królewski	Nowy Dwór Królewski
Faroisc sprǣc	Färöiska
Catt	Kattdjur
Lytel Spēonland	Hispaniola
Harrisburg	Harrisburg
Hamor	Hammare (handverktyg)
Picilemo	Pichilemu
Bryttiscan Fæmne Īegland	Brittiska Jungfruöarna
Flēoge	Tvåvingar
Norða	Arktis
Hund	Hunddjur
Fresisc sprǣc	Frisiska
Antoni Gaudí	Antoni Gaudí
Cliferfētedēor	Partåiga hovdjur
Steorrfisc	Sjöstjärnor
Eurasisc bleohcrāwe	Nötskrika
Hrōc	Råka
Ēotaland	Jylland
Niþeru Þēodsc sprǣc	Lågtyska
Mölnlycke	Mölnlycke
Coning	Europeisk kanin
Cuscan Rīce	Kushan
Tromsīeg	Tromsø
Sandwīc	Sandwich, Kent
Eormengyld Niccolò Cusano	Università degli Studi Niccolò Cusano
Montpelier on Uermonte	Montpelier, Vermont
Geac	Jak
Palistiniscre Frēogunge Þēodnes	Palestinska befrielseorganisationen
Taylor Swift	Taylor Swift
Cōcīega	Cooköarna
Brocc	Europeisk grävling
Sealterisc sprǣc	Saterfrisiska
Middelasia	Centralasien
Langaland	Langeland
Sealterland	Saterland
Ofersǣwisc rind	Kanel
Jackson (Mississippi)	Jackson, Mississippi
Concord (Nīwu Hāmtūnscīr)	Concord, New Hampshire
Annapolis	Annapolis
Eald Corēa	Gojoseon
Hreaðemūs	Fladdermöss
Ēastrīce-Ungerland	Österrike-Ungern
Tarnobrzeg	Tarnobrzeg
Wesle	Mustela
Scīr	County
Sandwīc (ǣt)	Sandwich
Spearwa	Sparvfinkar
Eormanrīc	Ermanarik
Francisco Franco	Francisco Franco
Tarja Halonen	Tarja Halonen
Willis Tower	Willis Tower
Cantwaraburg	Canterbury
Cīna	Kina (region)
Tracter	Tratt
Englisc lagu	Common law
Seolh	Sälar
Ecser	Ecser
Silesisc gereord	Schlesiska
Zhengzhou	Zhengzhou
Foresittend	President
Frencisc Polynesia	Franska Polynesien
Roðem	Rouen
Crīstesmæsse Īeg	Julön
Bleohfugol	Papegojfåglar
Cambihtere	Kakaduor
Arabea	Arabiska halvön
Fȳstlāc	Boxning
Seax	Kniv
Top Gear	Top Gear (TV-serie, 2002)
Tasmansǣ	Tasmanhavet
Ceroke sprǣc	Cherokesiska
Campwīg be Tannebeorge	Slaget vid Tannenberg (1410)
Īsbera	Isbjörn
Hand	Hand
Tu Fu	Du Fu
Nīwe Scotta Ēaland	Nya Kaledonien
Cecoslofacia	Tjeckoslovakien
Lēaf	Blad
Nepal Bhasa	Newari
Valparaíso (on Cilan)	Valparaíso
Nathalia Dill	Nathalia Dill
Oaxaca	Oaxaca
Tahitisc sprǣc	Tahitiska
Flemisc sprǣc	Flamländska
Yasser Arafat	Yassir Arafat
Oxnaford	Oxford
Międzyrzec Podlaski	Międzyrzec Podlaski
Tasmania	Tasmanien
Creto	Kreta
Saint-Dié-des-Vosges	Saint-Dié-des-Vosges
Eormengyld Oxnafordes	Oxfords universitet
Þyrla	Helikopter
Sancte Elene Īeg	Sankta Helena
Nicor	Flodhäst
Egisca Sǣ	Egeiska havet
Ichiro Mizuki	Ichirou Mizuki
Anastacia	Anastacia
Eufrāte	Eufrat
James A. Garfield	James Garfield
Cirice	Kyrkan
Persisc Sǣ	Persiska viken
Sand	Sand
Cyningestūn (Iamaica)	Kingston
Lafor	Leopard
Age of Empires	Age of Empires (spelserie)
Tequixquiac	Tequixquiac
Ulysses S. Grant	Ulysses S. Grant
Oklahoma City	Oklahoma City
Meotedisca Mere	Azovska sjön
William McKinley	William McKinley
Foresittend þāra Geāndena Rīca	Lista över USA:s presidenter
Sūþgeorgia and þā Sūþsandwic Īegland	Sydgeorgien och Sydsandwichöarna
Webbsīde	Webbplats
Catalão	Catalão
Grover Cleveland	Grover Cleveland
Ealdseaxisc sprǣc	Fornsaxiska
Satan	Satan
Wordstǣrcræft	Etymologi
Beorglēo	Puma
Arabas	Araber
Proponditis	Marmarasjön
Ēagduru	Fönster
Chester A. Arthur	Chester A. Arthur
Riffeng	Uralbergen
Pitcearnīega	Pitcairnöarna
Benjamin Harrison	Benjamin Harrison
Rutherford B. Hayes	Rutherford B. Hayes
Wīnlendisc panðer	Jaguar
Sūþaustralia	South Australia
Gotisc sprǣc	Gotiska
Boise	Boise
Bāt	Båt
Awaisc sprǣc	Guaraní
Gærsbēam	Bambu
Interlingua	Interlingua
Bosporos	Bosporen
Smyrna	Izmir
Lemburg	Lviv
Cwēneland	Queensland
Siligo	Siligo
Puerto Montt	Puerto Montt
Iane Austen	Jane Austen
Tægcwondo	Taekwondo
Middel Englisc sprǣc	Medelengelska
Māorisc sprǣc	Maori
Hannibal	Hannibal
Hōrdōm	Prostitution
Twinemniendlic nama	Binomial nomenklatur
Victoria (Australia)	Victoria, Australien
Geugoslafia	Jugoslavien
Ætla	Attila
Scrælingas	Indianer
Arancón	Arancón
Willelm Heretoga of Grantanbrycge	Prins William, hertig av Cambridge
Toshiro Mifune	Toshiro Mifune
Tallahassee	Tallahassee
Sundorrīcehād	Självständighet
Bismarck (Norþdakota)	Bismarck, North Dakota
Aucland	Auckland
Iohannes Paulus I Pāpa	Johannes Paulus I
John Michael Talbot	John Michael Talbot
Acrotiri and Ðecelia	Akrotiri och Dhekelia
Arara	Arara
Cnēo	Knä
Willelm I Engla Cyning	Vilhelm Erövraren
Campora Sancte Iohannes	Campora San Giovanni
Sīde	Silke
Sint-Truiden	Sint-Truiden
Lēoðlic scātung	Konståkning
Stefn (līfcræft)	Fylum
Heanrig VIII Engla Cyning	Henrik VIII av England
Columbia (Sūþcarolīna)	Columbia, South Carolina
Xena: Warrior Princess	Xena – Krigarprinsessan
1880. gēar oþ 1889. gēar	1880-talet
Helena (Montana)	Helena, Montana
Wælhwelp	Jakthund
Eormengyld Biobiwes	Universidad del Bío-Bío
Sufa	Suva
Muntgumniscīr	Montgomeryshire
Eorþmistel	Basilika (krydda)
Lēohtfȳsend	Laser
Prēossland	Preussen
Cheyenne (Wyoming)	Cheyenne, Wyoming
Norðerne healftrendel	Norra halvklotet
Loidis	Leeds
Fūcgī Beorg	Fuji
Mūs	Möss
Geolurēad	Orange
Æcs	Yxa
Seofonbyrig	Transsylvanien
Tōl	Verktyg
Alī	Ali ibn Abi Talib
Hrān	Ren
Stānhencg	Stonehenge
Amazonas	Amazonas (delstat i Brasilien)
Ajaccio	Ajaccio
Rodorcræft	Rymdfarkost
Lisa Gerrard	Lisa Gerrard
Thirty Seconds to Mars	30 Seconds to Mars
Paulínia	Paulínia
Pierre	Pierre, South Dakota
Crabba	Krabbor
God Nerie þā Cwēne	God Save the Queen
Meteūtsiht	Diarré
Anna Maria Jopek	Anna Maria Jopek
Horshwæl	Valross
Fōrhēafod	Panna (anatomi)
Haile Selassie	Haile Selassie
Caðum	Caen
Sonygegyld	Sony
Mynet	Mynt
Sūðerne Healftrendel	Södra halvklotet
Cnihtas þæm Temple	Tempelherreorden
Americanisc fōtball	Amerikansk fotboll
Tōþsticca	Tandpetare
Folcmorðor	Folkmord
Hociȝ	Ishockey
Swīnmūþa	Świnoujście
Īrisc Sǣ	Irländska sjön
Tracia	Thrakien
Mongolas	Mongoler
Mǣs	Maas
Talcahuano	Talcahuano
Tahitīeg	Tahiti
Ontynung	Uppenbarelseboken
Abel Tasman	Abel Tasman
Gotan	Goter
Nettfrumfindend	Uniform Resource Locator
Ænglisc sprǣc	Fornengelska
Englisc folc	Engelsmän
Eoforwic	York
Iron Maiden	Iron Maiden
Asterix	Asterix
Grǣg	Grå
Hwælhuntoþ	Valfångst
Sǣcū	Manater
Gregorius Pāpa I	Gregorius I
Cȳta (lyftcræft)	Drake (leksak)
Þunor	Tor
Castel Goffredo	Castel Goffredo
Roðos	Rhodos
Sanct	Helgon
Wikipǣdia:FAQ	Wikipedia:Vanliga frågor
Cycene	Kök
Wæterdraca	Krokodiler
Hlæstwægn	Lastbil
Carl Wēala Þēoden	Prins Charles, prins av Wales
Villeneuve-d'Ascq	Villeneuve-d'Ascq
Crāwe	Corvus
Sūþtun on Defnum	Plymouth
Bryttisca Indisca Garsecg Landscipe	Brittiska territoriet i Indiska oceanen
Dēoraby	Derby, Storbritannien
Francan	Franker
Fealcen	Falco (släkte)
Nightwish	Nightwish
Mattheus se Godspellere	Matteus
Mac OS	Mac OS
Leyden	Leiden
Fiðerlēasere	Kivier
Montehermoso	Montehermoso
Louis the Pious	Ludvig den fromme
Cwēnsǣ	Vita havet
Jim Morrison	Jim Morrison
GNOME	GNOME
Hāt	Värme
Spere	Spjut
Ēadig getæl	Glada tal
Charleston (Westvirginia)	Charleston, West Virginia
Mynster	Kloster
Oxnaford Englisc Wordbōc	Oxford English Dictionary
Īsearn	Alcedines
Carl XVI Gustaf Swēona Cyning	Carl XVI Gustaf
Świętochłowice	Świętochłowice
Zac Efron	Zac Efron
Monte Carlo	Monte Carlo
Elba	Elba
The Doors	The Doors
Fylfōt	Svastika
Hara	Harar (släkte)
Rīcisc edisc	Nationalpark
Boga	Pilbåge
Byrdling	Landsköldpaddor
Bryttisc landbūnes	Storbritanniens utomeuropeiska territorier
Handscēotend	Sidovapen
Brūn	Brun
Hjaltland	Shetlandsöarna
Byrddæg	Födelsedag
Æx-in-Profentse	Aix-en-Provence
Gaza	Gaza
Īsbeorg	Isberg
Ephese	Efesos
Englisc wera rīcisc fōtballtēam	Englands herrlandslag i fotboll
Pratibha Patil	Pratibha Patil
Minte	Myntasläktet
Spilcarte	Spelkort
Bysen:Commonscat	Mall:Commonscat
Hālig Land	Heliga landet
Folcland Gewinn	Falklandskriget
Beadu be Culme	Slaget vid Kulm
Bēowulf	Beowulf
Marīahæfen	Mariehamn
Hrǣw	Lik
IOS	IOS
Lee Harvey Oswald	Lee Harvey Oswald
Frumtæl	Primtal
Þ	Þ
Orlando	Orlando, Florida
Saint Petersburg	Saint Petersburg
Hereðaland	Hordaland fylke
Sogn and þa Flēotas	Sogn og Fjordane fylke
Meore and Romsdæl	Møre og Romsdal fylke
Troms	Troms fylke
Dǣlere	Delbarhet
Australisc fōtþōðer	Australisk fotboll
Secglēac	Gräslök
Stānweall sacunga	Stonewallupproret
Punta Arenas	Punta Arenas
Aaron	Aron
Wu-Tang Clan	Wu-Tang Clan
Osgar I Swēona Cyning	Oscar I
Hwēolrinnung	Cykelsport
Aquilegia	Aquileia
Hyll	Ås
Beorneslēah	Barnsley
Banff	Banff, Aberdeenshire
Soria (scīr)	Soria (provins)
Harold V Norrena Cyning	Harald V av Norge
Þēodlic Dæg	Nationaldag
John Key	John Key
Ēadweard I Engla Cyning	Edvard I av England
Ariel Sharon	Ariel Sharon
1050e	1050-talet
Æneid	Aeneiden
Forma Frencisce Rīce	Första franska kejsardömet
Brādford	Bredevoort
Se Holbytla	Bilbo – En hobbits äventyr
Eocene	Eocen
Hwilpe	Långnäbbad spov
Strǣt	Gata
Superman	Stålmannen
Heorotbrēr	Getaplar
Wikipǣdia:Fulgōdra gewrita teohhunga	Wikipedia:Artikelnomineringar
Rætswīn	Marsvin
Iconium	Konya
Emma Goldman	Emma Goldman
Iacobus I Grēatre Bryten Cyning	Jakob I av England
Crīstcirice	Christchurch
Coronel Fabriciano	Coronel Fabriciano
Babsk	Babsk
Englisca Ingewinn	Engelska inbördeskriget
Bengal	Bengalen
Morgenmete	Frukost
1060e	1060-talet
Pippen III Francena Cyning	Pippin den lille
Carl I (Grēatre Bryten Cyning)	Karl I av England
Ȝealdor/ᚷᛖᚪᛚᛞᚩᚱ	Magi
Cucler	Sked
Geþofted Rīcu American	Amerikas konfedererade stater
Elpendbān	Elfenben
Villarrobledo	Villarrobledo
Temuco	Temuco
Hloðwic I Francena Cyning	Klodvig I
William Wallace	William Wallace
Bundesliga	Fußball-Bundesliga
Fȳrland	Eldslandet
Maria I Engla Cwēn	Maria I av England
Angelcirice	Engelska kyrkan
Engla Cyning	Lista över Englands regenter
Lencten (tīd)	Påskfastan
Fuþorc	Runor
Lēactric	Sallat
Beadu Hǣstingum	Slaget vid Hastings
Ēadweard VI Engla Cyning	Edvard VI av England
Jacques-Yves Cousteau	Jacques-Yves Cousteau
Horatio Nelson	Horatio Nelson
Galilēa	Galileen
Gaderscypefāna	Storbritanniens unionsflagga
Foldlic clūt	Litosfär
Þūma	Tumme
Ælfrēd Micela	Alfred den store
Hāmlǣrung	Hemundervisning
Teutoburg Weald Beadu	Slaget vid Teutoburgerskogen
Bysen:Cite book	Mall:Bokref
O Canada	O Canada
Biobío	Río Biobío
Orcanege	Orkneyöarna
Profentse	Provence
Predore	Predore
Seaxe	Saxare
Willelm II Engla Cyning	Vilhelm II av England
Limburgisc	Limburgiska
Eallerīca Gotena Cyning	Alarik I
Tygelwīg	Dragkamp
Boētius	Anicius Manlius Severinus Boethius
Hunigbēo	Honungsbin
Abbod	Abbot
Mæcedonia	Makedonien (historisk region)
Sameramis	Semiramis
Pīp	Rökpipa
Aerosol	Aerosol
Gangnihessou	Gangnihessou
Ilfingburg	Elbląg
Mierce	Mercia
Þēodrīc Ēastgotena Cyning	Theoderik den store
Westseaxena Rīce	Wessex
Hēahland	Skotska högländerna
Norþhymbra Rīce	Northumbria
Wulfila	Wulfila
Bram Stoker's Dracula	Bram Stokers Dracula
Angeow	Anjou
2011 FIFA Frēona Woruldceampscipe	Världsmästerskapet i fotboll för damer 2011
Alexander VI Pāpa	Alexander VI
Æppellēaf	Luktviol
Edward Braddock	Edward Braddock
Cethāmīga	Chathamöarna
Norþīg	Nordön
Anne Cwēn	Anna av Storbritannien
Sūþīeg	Sydön
Dziecinów	Dziecinów
Sunnstede	Solstånd
Wynton Rufer	Wynton Rufer
Regnwyrm	Daggmask
Kara	Kara (musikgrupp)
Ceadmere	Tchadsjön
Getalu Rōmāniscra Cāsera	Lista över romerska kejsare
Heantun	Wolverhampton
Minerva	Minerva
Fȳræg	Bomb
Ashley Tisdale	Ashley Tisdale
Þrondham	Trøndelag
Nīwe Woruld	Nya världen
Fȳrweorc	Fyrverkeri
Æsc	Askar
Galwæg	Galway
Ēadweard Andettere	Edvard Bekännaren
Hramsa	Ramslök
Scīdfarung	Skidsport
World of Warcraft	World of Warcraft
Byrig þāra Geāndena Rīca	Lista över USA:s städer efter folkmängd
Nemniendlic cāsus	Nominativ
Folcawanderung	Folkvandringstiden
Slayer	Slayer
Biliþ and lēoþcræft	Immagine & Poesia
Maria Scotta Cwēn	Maria Stuart
Scield	Sköld
Henry V Englalandes	Henrik V av England
Sciþþia	Skyter
Universidade Federal de Minas Gerais	Universidade Federal de Minas Gerais
Sceanca	Ben (kroppsdel)
Pulgare	Bulgarer
Lyftscip	Luftskepp
Cnut se Micela	Knut den store
Saturnus	Saturnus (mytologi)
Exanceaster	Exeter
Sanctes Laurentes Ēa	Saint Lawrencefloden
Mundlēow	Diskbänk
Sūþhjaltland	Sydshetlandsöarna
Cartespil	Kortspel
Iscimbag	Isjimbaj
Basu Heorte	Purpurhjärtat
Marianburg	Malbork
Rosseg	Mainland, Orkneyöarna
Nīwsǣlandworulddǣl	Zealandia (kontinent)
Carl Fǣtta Francena Cyning	Karl den tjocke
Þēodisc Āþbēorscipe	Tyska förbundet
Wikipǣdia:How to edit a page	Wikipedia:Redigering
Cantwarabyrig eorþbeofung 2011.	Jordbävningen i Christchurch i februari 2011
Eorðæppelstycce	Pommes frites
Rīnland	Rhenlandet
Eormengyld Tybingenes	Tübingens universitet
Blōdmearh	Blodkorv
Midsumor	Midsommar
Timborwyrhta	Timmerman
Anlaf V Norrena Cyning	Olav V av Norge
Ēadweard Westseaxna Eorl	Prins Edward, earl av Wessex
Hacun VII Norrena Cyning	Håkon VII av Norge
Ecgbryht	Egbert av Wessex
Earnulf Carendran	Arnulf av Kärnten
Bēda	Beda venerabilis
Laplandes Gūþ	Lapplandskriget
Willelm-Alexander Niðerlanda Cyning	Willem-Alexander av Nederländerna
Bredspearctellend	Surfplatta
Mathusal	Methusalem
Universidade Estadual de Feira de Santana	Universidade Estadual de Feira de Santana
Bægware	Bavarier
Europisc wild gingifer	Hasselört
Bēowyrt	Kalmus
Pontcysyllte Wætertyge	Pontcysyllteakvedukten
Universidade Federal da Bahia	Universidade Federal da Bahia
Centro Federal de Educação Tecnológica de Minas Gerais	Centro Federal de Educação Tecnológica de Minas Gerais
Nēohwæl	Narval
Ajman	Ajman
Harold Godwinson	Harald Godwinson
Ȳþrīdung	Surfing
Brū	Ögonfrans
Port:Stǣr	Tadzjikistans flagga
Kiæresburh	Cherbourg-Octeville
CONCACAF	CONCACAF
Mentha arvensis	Åkermynta
Searoburg	Salisbury, England
Lunden Ēage	London Eye
Valdivia	Valdivia
Pachuca de Soto	Pachuca de Soto
Crāwlēac	Sandlök
Balsminte	Vattenmynta
Dweorgedosle	Polejmynta
Landbūnes	Avhängiga territorier
Rēadingas	Reading
Mængo	Mangosläktet
Grēate Bryten Cynerīce	Kungariket Storbritannien
Brōcminte	Gråmynta
Iane Grey Hlæfdige	Jane Grey
Charmed	Förhäxad
Grammatisc cyn	Genus (språkvetenskap)
Nica Ūphebbung	Nikaupproret
Brycgāðexe	Sphenodon
Hetware	Chatter
Americanisc wera rīcisc fōtballtēam	USA:s herrlandslag i fotboll
Maywood, Illinois	Maywood, Illinois
Þrēo Coreaniscu Cynerīcu	Koreas tre kungariken
Feðer (blæces)	Penna
Pening	Pfennig
Bryttisca Antarctisca Landscipe	Brittiska Antarktis
Starcraft	Starcraft
Seofon dēadlica synna	De sju dödssynderna
Finger	Långfinger
Midwearme geardas	Tempererat klimat
Angleseg	Anglesey
Māse	Mesfåglar
Penwiðsteort	Land's End
Ratchet & Clank	Ratchet & Clank
Æðelstān Engla Cyning	Athelstan av England
Ras al-Khaimah	Ras al-Khaimah
Elene Constantinoples	Helena (helgon)
Nintendo DS	Nintendo DS
Ēse	Asar
Nīwe Francland	Nya Frankrike
Englalandes Fana	Englands flagga
Cyclades	Kykladerna
Trafalgar Sǣfeoht	Slaget vid Trafalgar
Iosephine Francena Caserin	Joséphine de Beauharnais
Sōlate	Solros
Cynelica Sciphere	Royal Navy
Inbærnes	Olibanum
Difelinscīr	Dublin (grevskap)
Æppelcyrnel (wǣpen)	Handgranat
Helm	Hjälm
Umm Al Quwain	Umm al-Qaywayn
Nīwes Sǣlandes þēodlīc fōtþōðerhēap	Nya Zeelands herrlandslag i fotboll
Ingang:Stǣr	Portal:Historia
Nonne Etone	Nuneaton
The Oval	The Oval
2010 FIFA Woruldceampscipe	Världsmästerskapet i fotboll 2010
Sunu	Son
Grīpfealcen	Jaktfalk
Snāwbordfarung	Snowboard
Ōsgeard	Asgård
Glīdflēogung	Skärmflygning
Mageoscīr	Mayo (grevskap)
Australisc rīce	Australiens delstater och territorier
Blizzard Entertainment	Blizzard Entertainment
Gerinnung	Blodkoagulering
Dofras	Dover
Cannae Beadu	Slaget vid Cannae
Herenuma	Krigsfångenskap
Dȳfung	Dykning
Daguerreotype	Dagerrotypi
Dūnholm	Durham
Þrēotīene Landbūnessa	Tretton kolonierna
Brenda Song	Brenda Song
Lincoln	Lincoln, Lincolnshire
Syllīega	Scillyöarna
Smallville (TV endebyrdnes)	Smallville
Helen Clark	Helen Clark
Būr	Sal (rum)
Wēala Þēoden	Prins av Wales
Scōnīeg	Skåne
Milanes Bann	Ediktet i Milano
Francforta	Varmkorv
Gelocen boge	Armborst
Meremægden	Sjöjungfru
Wichlawscīr	Wicklow (grevskap)
Striuelin	Stirling
Æðelred Unrǣd	Ethelred II av England
Twentig Þūsend Lēowena Under þǣm Sǣ	En världsomsegling under havet
Baius	Bayeux
Colneceaster	Colchester
Meodu	Mjöd
Met (Grammaticcræft)	Modus
Sǣelpend	Sjöelefanter
Grytviken	Grytviken
Fox News	Fox News Channel
Brīw	Gröt
Ēadweard se Ieldra	Edvard den äldre
Iþacige	Ithaka
Baius tæpped	Bayeuxtapeten
Montréal Canadiens	Montreal Canadiens
Underburg	Förort
Sharjah	Sharjah
Antrimscīr	Antrim (grevskap)
Vigdís Finnbogadóttir	Vigdís Finnbogadóttir
Final Fantasy	Final Fantasy
Norrena Cyning	Lista över Norges regenter
Ēadmund Æðeling	Edmund I av England
Rachel McAdams	Rachel McAdams
Fermanagh	Fermanagh
Dūnscīr	Down (grevskap)
E Pluribus Unum	E pluribus unum
Foresittend Franclandes	Frankrikes president
New Jersey Devils	New Jersey Devils
Philadelphia Flyers	Philadelphia Flyers
Yun Chi-ho	Yun Chi-ho
Sancte Elene Īeg, Upstigeīeg and Tristan da Cunha	Sankta Helena, Ascension och Tristan da Cunha
Tirowen	Tyrone
Jack Ruby	Jack Ruby
Ardmachusscīr	Armagh (grevskap)
Scene	Shannon (flod)
Wīnland	Vinland
Venom (trūðhlōð)	Venom (musikgrupp)
Luel	Carlisle
Ēadgar Engla Cyning	Edgar av England
Kea	Kea
Itumbiara	Itumbiara
A Night at the Opera	A Night at the Opera (musikalbum av Queen)
Queen (album)	Queen (musikalbum)
Þunres Hamor	Mjölner
Oben am jungen Rhein	Oben am jungen Rhein
Guinness	Guinness
Łobez	Łobez
Liðere	Slunga
Thomas Cranmer	Thomas Cranmer
Tawpomere	Tauposjön
Universidad de Concepción	Universidad de Concepción
Hameldūn (Nīwe Sǣland)	Hamilton, Nya Zeeland
Stǣr þǣre Worulde	Världens historia
Rēad wulf	Rödvarg
Fif Scīr	Fife
Stǣrwrītere	Historiker
Carolina Hurricanes	Carolina Hurricanes
Nebrond	Nimrod
Tampa Bay Lightning	Tampa Bay Lightning
Scrobbesburh	Shrewsbury
Fæger hǣr	Blond
Napier (Nīwe Sǣland)	Napier, Nya Zeeland
Myrra	Myrra
Harold III Norrena Cyning	Harald Hårdråde
Fisc and styccu	Fish and chips
Brooke Fraser	Brooke Fraser
Middeltūn þǣra de Cahaignes	Milton Keynes
Florida Panthers	Florida Panthers
Washington Capitals	Washington Capitals
Īrisc fōtþōðer	Gaelisk fotboll
Nīwes Sǣlandes Þēodlic Stēormǣlhēap	Nya Zeelands nationella parti
West Loðene	West Lothian
Lonceaster	Lancaster, Lancashire
Sūþalpis	Sydalperna
Midloðene	Midlothian
Neamere	Lough Neagh
Maðante	Mantes-la-Jolie
Ēast Loðene	East Lothian
Fermat tæl	Fermattal
Clackmannanscīr	Clackmannanshire
Liccidfeld	Lichfield
Sūþorcanege	Sydorkneyöarna
Rænkīnes hātȝemet	Rankine
Cod	Torskfiskar
Gold (bleoh)	Guld (färg)
Holstānburg	Sisimiut
Micel Ficgīeg	Viti Levu
Wrenna	Gärdsmygar
Ciricewæl	Kirkwall
1984 (bōc)	1984 (roman)
Folcaþing	Folketinget
Underset gamen	Expansionspaket
Elig	Ely
Getalu burga in Þēodsclande	Lista över städer i Tyskland
Innuendo	Innuendo (musikalbum)
Concepcion Hēafodcirice	Katedralen i Concepción, Chile
The Game	The Game (musikalbum)
Bancorena burg	Bangor (olika betydelser)
Gēol	Midvinterblot
Washington Redskins	Washington Redskins
Swīma	Yrsel
Ægelesburg	Aylesbury
Tristania	Tristania
Wuldor	Ull (mytologi)
Ēsatrēowþ	Modern asatro
Lāmwic	Lerwick
Westgeatland	Västergötland
Rosenrot	Rosenrot (musikalbum)
Wīcinga Ieldu	Vikingatiden
Victory (scip)	HMS Victory
Sihhem	Nablus
Beatrix Potter	Beatrix Potter
Ēadgar Æðeling	Edgar the Aetheling
Grēat Rōmisc Fȳr	Roms brand
Tollund wer	Tollundmannen
Hēapplega	Lagsport
Levanger	Levangers kommun
Violetta Villas	Violetta Villas
Ynce	Tum
Gearwung (plega)	Träning
Diablo (gamen)	Diablo
Anggun	Anggun
Verizon Center	Verizon Center
Wīfa rihta forðung	Kvinnors rättigheter
Apaxco	Apaxco
Cham	Ham
Zune	Zune
Nettþōðer	Netball
Lox	Lynx
In	IN
Wiltūn	Wilton
Roanoke	Roanoke
Cnut	Knut
Acan tūn	Acton
Eormengyld Ciles	Universidad de Chile
Sēremōnaþ 2007	Juni 2007
Offa Miercna Cyning	Offa
Mǣdmōnaþ 2006	Juli 2006
Mǣdmōnaþ 2007.	Juli 2007
Wēodmōnaþ 2007	Augusti 2007
Engel	Ängel
Sasha Cohen	Sasha Cohen
Æðelflǣd	Ethelfleda
Pat Benatar	Pat Benatar
Michelle Kwan	Michelle Kwan
Wæstm	Gröda
Beate Eriksen	Beate Eriksen
Berhte Cent Cwēn	Bertha av Kent
D.C. United	D.C. United
Eowland	Öland
Starcraft II	Starcraft II: Wings of Liberty
Allan Kardec	Allan Kardec
Deadache	Deadache
Diablo III	Diablo III
Sceadu (gyden)	Skade
Diablo II	Diablo II
Atlanta Thrashers	Atlanta Thrashers
Hwītlēachring	Lökringar
The God Delusion	Illusionen om Gud
Canadisc fōtþōðer	Kanadensisk fotboll
Hæstingas (missenlīc gewritu)	Hastings (olika betydelser)
Ealra Hālgena Ǣfen	Halloween
Sūþtun	Sutton
Weorcdæg	Arbetstid
Leðerhosu	Lederhosen
Acantūn on Sūþfolce	Acton, Suffolk
Bān	Ben (skelett)
7 World Trade Center	7 World Trade Center
Vampire Knight	Vampire Knight
Wēodmōnaþ 2006	Augusti 2006
Ælfweard West-Seaxes	Ethelweard av England
Bēagel	Bagel
Rēcels	Rökelse
Iapanisc āttorcopplic crabba	Japansk spindelkrabba
Woruldlic Gemōt þāra Ciricena	Kyrkornas världsråd
Blæcesburg, Virginia	Blacksburg, Virginia
Harriet Miers	Harriet Miers
Dūnhēafod	Launceston, Cornwall
Marjorie Estiano	Marjorie Estiano
Transformers	Transformers (olika betydelser)
Oresundes brycg	Öresundsförbindelsen
Denegield	Danagäld
Dohtor	Dotter
Spell Twēgra Burga	Två städer
Morbid Angel	Morbid Angel
John Ashcroft	John Ashcroft
Alexander Ovechkin	Aleksandr Ovetjkin
Orosius	Paulus Orosius
Alexis Tsipras	Alexis Tsipras
Dufenal I Scotta	Donald I av Skottland
Constontinus I Scotta Cyning	Konstantin I av Skottland
Seolfor (bleoh)	Silver (färg)
Babez for breakfast	Babez for Breakfast
Widukind	Widukind
Wælheall Herig	Walhalla
Æbbandūn	Abingdon, Oxfordshire
Law & Order	I lagens namn (TV-serie)
Westmannland	Västmanland
Hengest	Hengist
Moretoin	Mortain
Leaves' Eyes	Leaves' Eyes
Jeanette Biedermann	Jeanette Biedermann
Corn Flakes	Majsflingor
Amol	Amol
Penda Miercna Cyning	Penda
Dūnstān	Dunstan av Canterbury
Mælcolm II Scotta Cyning	Malkolm II av Skottland
Ēadgar Scotta Cyning	Edgar av Skottland
Ofergewiht	Övervikt
Constontinus II Scotta Cyning	Konstantin II av Skottland
Pak Hon-yong	Pak Hon-yong
Americanisc frēona rīcisc fōtballtēam	USA:s damlandslag i fotboll
Obituary	Obituary
Mǣdmōnaþ 2005	Juli 2005
Winterfylleþ 2005	Oktober 2005
Berserca	Bärsärk
Jordan Galland	Jordan Galland
Minoru Yamasaki	Minoru Yamasaki
Īslendisc stæfrǣw	Isländska alfabetet
Canceler	Kansler (ämbetsman)
Cuneglæsse	Hundtunga
Ēadmund se Martyr	Edmund martyren
Australisca Witenagemōt	Australiens parlament
Lao	Lao (etnisk grupp)
Agalloch	Agalloch
Godspell Mattheus	Matteusevangeliet
Palestinisce Landscipas	Palestinska områden
Ajattara	Ajattara
James Ēa	Jamesfloden
Ȝ	Yogh
Nazarēth	Nasaret
Rise of Nations	Rise of Nations
Kate Sheppard	Kate Sheppard
Getalu Smallville-belimpdǣla	Lista över avsnitt av Smallville
Kwara Rīce	Kwara
Windlesōra	Windsor, Berkshire
Ēastermōnaþ 2005	April 2005
America's Cup	America's Cup
Wīnlendisc cystel	Castanea dentata
Brian Jacques	Brian Jacques
Agmodesham	Amersham
Paramore	Paramore
Recedham	Rochdale
Illative cāsus	Illativ
Herelic munucregol	Riddarorden
Ǣȝhnōg	Äggtoddy
Coritiba Foot Ball Club	Coritiba Foot Ball Club
Tansonnhates Geondrīciscum Lyfthæfene	Tan Son Nhat internationella flygplats
Þresc stīele	Thrash metal
The Chronicles of Narnia	Berättelsen om Narnia
James Hetfield	James Hetfield
Keane	Keane
Medinaceli	Medinaceli
Láchar	Láchar
Get Heavy	Get Heavy
Pensacola	Pensacola
The Arockalypse	The Arockalypse
Anath	Anat
The Monsterican Dream	The Monsterican Dream
Barbourscīr, Westvirginia	Barbour County, West Virginia
Duval Scīr, Florida	Duval County, Florida
Hāmtūnscīr Scīr, West Virginia	Hampshire County, West Virginia
Rēadgrot mid flīetan	Saftkräm
Samsung Galaxy Note	Samsung Galaxy Note
Perfume	Perfume
Beadu Cealdre Hȳðe	Slaget vid Cold Harbor
Rōwrenoc (Virginia)	Roanoke, Virginia
Sūþtūn Hōh	Sutton Hoo
Tuidi	Tweed (flod)
Sǣbeorg	Djuphavsberg
Dornwaraceaster	Dorchester
Chris Pratt	Chris Pratt
Walhshalh	Walsall
Bēdesford, Virginia	Bedford, Virginia
Ēadƿeard Æðeling Scīr, Virginia	Prince Edward County
Angul	Angeln
Cambihtuc	Nymfparakit
Masters of the Universe	Masters of the Universe
Hwælsang	Valsång
Þrīnessunnandæg	Heliga Trefaldighets dag
Hramesige on Huntadūnscīre	Ramsey, Cambridgeshire
Simeon Varlamov	Semjon Varlamov
Cannae	Cannae
Þunresbeorg mōr	Torsbjergsfyndet
Niht (gyden)	Natt (mytologi)
JavaScript weorcsearu	Javascriptmotor
Mexicanisc frēona rīcisc fōtballtēam	Mexikos damlandslag i fotboll
Læland	Lolland
Bukan	Bukan
God Hates Us All	God Hates Us All
Gemǣne Rīca of Australie	Australiens generalguvernör
Grahamland	Graham Land
Wikipǣdia:Sceortpæþ	Wikipedia:Genvägar
Eormengyld Juraj Dobrila on Pula	Juraj Dobrila-universitetet i Pula
Scieppend	Skapare
Dopenid	Sothöns
Swearttægelhara	Svartsvansad åsnehare
Sybelhūs on Lundne	Banqueting House
Beadu þæs Bogn	Slaget vid Boyne
Puebla FC	Puebla FC
MorphOS	MorphOS
Atari Jaguar	Atari Jaguar
Ulfretūn	Newbury
Tæppa	Vattenkran
Tīdunghēap	Nyhetsgrupp
Nile (trūðhlōð)	Nile
Stǣr Angelþēode ciricean	Historia ecclesiastica gentis Anglorum
Rēan	Ran
Tæfingstoc	Tavistock
Negombo	Negombo
Þrimilcemōnaþ 2005	Maj 2005
Blecinga īeg	Blekinge
Lox (catte)	Lodjur (släkte)
Æfterra Gēola 2005.	Januari 2005
Huntandūn	Huntingdon
Scotburg ēa	Kongeå
Tomtun	Tamworth
City of Heroes	City of Heroes
Ambihtlicu Cīnisc sprǣc	Standardkinesiska
Mans	Maine (provins)
Falster	Falster
Janus (Windows beta)	Windows 3.x
Difelinburg	Dublin Castle
SOX leoht-fæt	Natriumlampa
Madrynhȳð	Puerto Madryn
Solmōnaþ 2005	Februari 2005
Hāligmōnaþ 2005	September 2005
Wuduhen	Wekarall
Centro Federal de Educação Tecnológica Celso Suckow da Fonseca	Centro Federal de Educação Tecnológica Celso Suckow da Fonseca
Chrono Trigger	Chrono Trigger
Télépopmusik	Télépopmusik
Selfrīcsiendlica landbūnessa	Autonom region
Berewicscīr	Berwickshire
Ægelesþrep	Aylesford
Bloomesdæg	Bloomsday
Bardanstapol	Barnstaple
Wedrebi	Wetherby
Adreminte	Mattram
Stæfford	Stafford
Aldealafuente	Aldealafuente
Ergo Proxy	Ergo proxy
Stromnæs	Stromness
Hwǣlbordfarung	Thrasher
Weogornaceasterscīrsēaw	Worcestershiresås
Picilemwes eorþbeofung 2010 gēares	Jordbävningen i Pichilemu 2010
Īslendisc frēona rīcisc fōtþōðerhēap	Islands damlandslag i fotboll
Worulde Fanan	Flags of the World
Hafoc	Hökar
York University	York University
Hrēþmōnaþ 2005	Mars 2005
Strēoneshalh	Whitby
Skræling	Skrälingar
Grēnelandes Norren sprǣc	Grönländsk nordiska
Gēolmōnaþ 2004	December 2004
Glamorgan	Glamorgan
Winterfylleþ 2004	Oktober 2004
Sǣearmlandes Rīcisc Edisc	Fiordland nationalpark
Port Authority of New York and New Jersey	Port Authority of New York and New Jersey
Getalu īega be landware	Lista över öar efter folkmängd
Denisc and Norþwegisc stæfrǣw	Dansknorska alfabetet
Street Fighter IV	Street Fighter IV
Help:Innoþ	Wikipedia:Hjälp
Wikipǣdia:Tutorial	Wikipedia:Introduktion
Wīntrēow	Klätterväxt
Witch Hunter Robin	Witch Hunter Robin
Twilight of the Thunder God	Twilight of the Thunder God
Pontifícia Universidade Católica de Minas Gerais	Pontifícia Universidade Católica de Minas Gerais
Deorwente	Derwent
Oenoīeg	Oeno
3 World Trade Center	Three World Trade Center
Landa getalu be lēodweardcynne	Lista över länder efter statsskick
Granta	Cam (flod)
Los Angeles Sol	Los Angeles Sol
Rūnstæfisc gerīmbōc	Runstav
Waneting	Wantage
Hāligmōnaþ 2006	September 2006
Hrodulf se rēadnosoda hrāndēor	Rudolf med röda mulen
2009–10 NHL tīma	National Hockey League 2009/2010
John Clare	John Clare
Elpendīeg	Elefantön
Faroisce cwidas	Kvad
Dærentamūða	Dartmouth, England
Elenesburh	Helensburgh
Exanmūþa	Exmouth
Sūþern Strēamflēot	Kangerlussuaq
Tottaness	Totnes
Mældūn	Maldon
Burns Niht	Burnsmiddag
Vrahovice	Vrahovice
Gēatland	Gotland
Būc	Magsäck
Loppestre	Hummer
Blōtmōnaþ 2004	November 2004
Nīwes Sǣlandes Weorces Stēormǣlhēap	New Zealand Labour Party
Stēamwægn	Ångvagn
Simeon II Pulgara Cyning	Simeon Sachsen-Coburg-Gotha
Lopphāma	Weta
Cutey Honey	Cutie Honey
Besancurt	Bézancourt
Umm Culþþūm	Om Khalsoum
Tenercebrai	Tinchebray
Germanisc Hǣðenscipe	Germansk religion
2 World Trade Center	Two World Trade Center
Gemyndigung Twintorra	National September 11 Memorial & Museum
Froggmann	Attackdykare
Beadu Omdurmanes	Slaget vid Omdurman
Cridiantūn	Crediton
Ƿ	Wynn
Lundene Foreweard (1839.)	Fördraget i London (1839)
Hellraiser	Hellraiser
Æsir–Vanir þurhgefeht	Vanakriget
Elisabeþ Cwēn Land	Drottning Elizabeths land
Wikipǣdia:Ambihtsecghof	Wikipedia:Ambassaden
Mǣþ	Slåtter
National Hockey League	National Hockey League
Frōm	Frome
Perþscīr	Perthshire
Flyhthæfen	Flygplats
Drēag	Draug
Mare	Mara (nordisk mytologi)
Sandeg, Orcanege	Sanday
Major Antônio Couto Pereira Stadium	Estádio Major Antônio Couto Pereira
Nīwes Sǣlandes Grēne Stēormǣlhēap	Green Party of Aotearoa New Zealand
Stǣrlice gemynddagas	Lista över datum
Pecland	Peak District
Uzumaki	Uzumaki
4 World Trade Center	Four World Trade Center
KMFDM	KMFDM
Women's Professional Soccer	Women's Professional Soccer
Sǣweardþrēat	Kustbevakning
Agnes Monica	Agnes Monica
Windlesōra and Mægdenhȳþ	Royal Borough of Windsor and Maidenhead
Wīdsīð	Widsith
Evile	Evile
Pasquier Quesnel	Pasquier Quesnel
Flocc:Ƿeras	Kategori:Män
Flocc:Ƿīf	Kategori:Kvinnor
Flocc:Þēodscland	Kategori:Tyskland
Flocc:Italia	Kategori:Italien
Flocc:Geānedu Rīcu American	Kategori:USA
Flocc:Russland	Kategori:Ryssland
Flocc:Canada	Kategori:Kanada
Flocc:Geānede Cynerīce	Kategori:Storbritannien
Flocc:Spēonland	Kategori:Spanien
Flocc:Cīna	Kategori:Kina
Flocc:Iapan	Kategori:Japan
Flocc:Australia	Kategori:Australien
Flocc:Mexico	Kategori:Mexiko
Flocc:Indea	Kategori:Indien
Flocc:Saudisc Arabea	Kategori:Saudiarabien
Flocc:Israhēl	Kategori:Israel
Flocc:Turcland	Kategori:Turkiet
Flocc:Sūðaffrica	Kategori:Sydafrika
Flocc:Ǣgypt	Kategori:Egypten
Flocc:Persealand	Kategori:Iran
Flocc:Nīwe Sǣland	Kategori:Nya Zeeland
Flocc:Argentina	Kategori:Argentina
Wergyld	Mansbot
Sky Blue FC	Sky Blue FC
Flocc:Afghanistan	Kategori:Afghanistan
Flocc:Algeria	Kategori:Algeriet
Flocc:Ēastrīce	Kategori:Österrike
Flocc:Bangladesc	Kategori:Bangladesh
Flocc:Cūba	Kategori:Kuba
Flocc:Sigelhearwenaland	Kategori:Etiopien
Flocc:Indonesia	Kategori:Indonesien
Flocc:Irac	Kategori:Irak
Flocc:Niðerland	Kategori:Nederländerna
Flocc:Nigeria	Kategori:Nigeria
Flocc:Pacistan	Kategori:Pakistan
Flocc:Pōlaland	Kategori:Polen
Flocc:Portugal	Kategori:Portugal
Flocc:Sudan	Kategori:Sudan
Flocc:Tansania	Kategori:Tanzania
Flocc:Ucrægna	Kategori:Ukraina
Flocc:Fietnam	Kategori:Vietnam
Flocc:Rōmānisc Cāsere	Kategori:Romerska riket
Flocc:Sycedēor	Kategori:Däggdjur
Flocc:Fugolas	Kategori:Fåglar
Flocc:Plantan	Kategori:Växter
Flocc:Stǣr	Kategori:Historia
Flocc:Ferscipe	Kategori:Samhälle
Flocc:Gelēafan	Kategori:Religion
Flocc:Plegan	Kategori:Sport
Flocc:Eorþ	Kategori:Jorden
Victor Iusccenco	Viktor Jusjtjenko
Surtur Rising	Surtur Rising
Gealdor	Galder
Lēo Hlāford Wǣponcyning	Lord Lyon King of Arms
Godmundesceaster	Godmanchester
Palmerland	Palmer Land
Handfisc	Brachionichthyidae
Phil Keaggy	Phil Keaggy
Hedingelei	Headingley
Hocig	Hockey (olika betydelser)
Frēodōm	Frihet (olika betydelser)
MTB	Motortorpedbåt
Īsensmiþ	Smed
Wiogoraceastre	Worcester, Storbritannien
Abbodesse	Abbedissa
Mōr	Myr
Truso	Truso
The Miracles	The Miracles
Loch a' Choire	Tjärn
Richard Pearse	Richard Pearse
Flocc:Scīrung	Kategori:Förgreningssidor
Flocc:Olympisc Gamen	Kategori:Olympiska spelen
Flocc:Crīstendōm	Kategori:Kristendom
Flocc:Alladōm	Kategori:Islam
Mǣþhild	Matilda
Decatur	Decatur
Earn	Örnar
Skaugum	Skaugum
Bresl/ᚱᚢᚾ	Kringla
Scyrte	Kjol
Wyomingdenu wæl	Slaget om Wyomingdalen
Elpend	Elefanter
Bochotnica	Bochotnica
Exanmynster	Exminster
Universidade do Estado de Minas Gerais	Universidade do Estado de Minas Gerais
Adesa	Skarvyxa
Abiron	Abiram
Harads	Harads
Flocc:Styccelicu gewritu	Kategori:Stubbar
Flocc:Wikipedia categorization	Kategori:Wikipedia:Strukturering
Flocc:Sidaþing	Kategori:Kultur
Flocc:Gēar	Kategori:Årtal
Flocc:Worulddǣl	Kategori:Världsdelar
Flocc:Lyftcræftas	Kategori:Luftfarkoster
Sprǣca merung	Miriwung
Wikipǣdia:Gecorene gemynddagas	Wikipedia:Dagens händelser
Wikipǣdia:Tutorial (Editing)	Wikipedia:Introduktion till redigering
Bysen:Stēorungsunnanendebyrdnes	Mall:Solsystemet
Wikipǣdia:Nīwe ēacan	Wikipedia:Visste du att...
Wikipǣdia:Wikibōceras	Wikipedia:Användare
Scearseax	Rakhyvel
Wikipǣdia:Recentchanges	Wikipedia:Senaste ändringar
Basu	Purpur
AmigaOS 4	AmigaOS 4
Bysen:Succession box	Mall:Succession box
Flocc:Flēogeball	Kategori:Volleyboll
Flocc:Wikipedia bots	Kategori:Wikipedia:Robotar
Bysen:Cquote	Mall:Citat
Flocc:Þēodisc	Kategori:Tyskar
Flocc:Land	Kategori:Världens länder
Wikipǣdia:Bewitendas	Wikipedia:Administratörer
Flocc:Lēode	Kategori:Personer
Wikipǣdia:Bēna tō and fram bewitendhāde	Wikipedia:Ansökan om administrativ behörighet
Flocc:Tīd	Kategori:Tid
Flocc:Bodiȝlār	Kategori:Anatomi
Wikipǣdia:Betwuxsprǽclice bendas	Wikipedia:Interwikilänkar
Flocc:Leornung	Kategori:Utbildning
Ægypt	Egypten
Yulia Lipnitskaya	Julia Lipnitskaja
Flocc:Ūtwitan	Kategori:Filosofer
Bysen:Bot	Mall:Bot
Wikipǣdia:Hwæt Wikipǣdia Nis	Wikipedia:Vad Wikipedia inte är
Canada	Kanada
Flocc:Ungerland	Kategori:Ungern
Flocc:Belgice	Kategori:Belgien
Flocc:Cipros	Kategori:Cypern
Flocc:Cecland	Kategori:Tjeckien
Flocc:Denemearc	Kategori:Danmark
Flocc:Estland	Kategori:Estland
Flocc:Finnland	Kategori:Finland
Flocc:Crecaland	Kategori:Grekland
Flocc:Lettland	Kategori:Lettland
Flocc:Īsland	Kategori:Island
Flocc:Letseburg	Kategori:Luxemburg
Flocc:Liþuania	Kategori:Litauen
Flocc:Melita	Kategori:Malta
Flocc:Swēoland	Kategori:Sverige
Flocc:Slofacia	Kategori:Slovakien
Flocc:Īrland Cynewīse	Kategori:Irland
Flocc:Fulgōd ȝeƿritu	Kategori:Wikipedia:Utmärkta artiklar
Flocc:Spærcletelle gamen	Kategori:Datorspel
Heofon	Himmelriket
Flocc:Microsoft	Kategori:Microsoft
Wikipǣdia:Edit summary	Wikipedia:Sammanfattningsfältet
Bysen:Flagicon	Mall:Flaggbild
Flocc:Land on Europan	Kategori:Europas länder
Flocc:Europe	Kategori:Europa
Flocc:Wikipedia:Help	Kategori:Wikipedia:Hjälp
Help:Mōtungtramet	Wikipedia:Diskussionssidor
Wikipǣdia:Efenealde belimpas	Portal:Aktuella händelser
Bysen:Documentation	Mall:Dokumentation
Wikipǣdia:Protected pages	Wikipedia:Skrivskydd
Flocc:Wikibōceras	Kategori:Wikipedia:Användare
Wikipǣdia:Gemǣnscipes Ingang	Wikipedia:Deltagarportalen
Flocc:Brūcendsprǣc	Kategori:Användare efter språk
Wikipǣdia:Fīf styde	Wikipedia:Grundprinciperna
Wikipǣdia:Ānsund styccegewrit	Wikipedia:Stubbar
Wikipǣdia:Bealu	Wikipedia:Klottersanering
Instituto Federal da Bahia	Instituto Federal da Bahia
Bysen:Softredirect	Mall:Mjuk omdirigering
Bysen:Delete	Mall:Radera
Snægel	Snäckor
Bryttisce Wealdendas	Lista över Storbritanniens regenter
Flocc:Searucræft	Kategori:Teknologi
Flocc:Sprǣca	Kategori:Språk
Flocc:Gerīmbōc	Kategori:Kalendrar
Flocc:Hāliȝdagas	Kategori:Högtider
Help:Onbregdan nīwne tramet	Wikipedia:Skriv en ny artikel
Flocc:Wikipǣdia	Kategori:Wikipedia
Flocc:Unȝebēacniende trametas	Kategori:Icke-indexerade sidor
Flocc:Pages with broken file links	Kategori:Sidor med trasiga fillänkar
Wikipǣdia:Manual of Style	Wikipedia:Stilguide
Bysen:Navbox	Mall:Navbox
Handspearctellend	Mobil enhet
Flocc:Byrig on Persum	Kategori:Orter i Iran
Bysen:Sēðung þurfed	Mall:Källa behövs
Angelfresisca sprǣca	Anglo-frisiska språk
Bysen:!	Mall:!
Flocc:Fana bysen	Kategori:Flaggmallar
Bysen:((	Mall:((
Bysen:!-	Mall:!-
Bysen:!!	Mall:!!
Bysen:=	Mall:=
Bysen:Navbar	Mall:Navbar
Bysen:Unicode	Mall:Unicode
Bysen:E	Mall:E
Bysen:Clear	Mall:Clear
Bysen:Col-break	Mall:Col-break
Bysen:Col-begin	Mall:Col-begin
Bysen:Col-end	Mall:Col-end
Bysen:Anchor	Mall:Ankare
Wikipǣdia:List of articles all languages should have	Wikipedia:Artiklar som bör finnas på Wikipedia
Flocc:Affrica	Kategori:Afrika
Flocc:Mǣdmōnaþ	Kategori:Juli
Flocc:Bēc	Kategori:Böcker
Flocc:Mōnþas	Kategori:Månader
Bysen:Wikisource	Mall:Wikisource
Bysen:Babel	Mall:Babel
Bysen:Commons	Mall:Commons
Bysen:Link GA	Mall:Link GA
Bysen:NavPeriodicTable	Mall:PeriodiskaSystemet
Wikipǣdia:Fulgōdra gewrita hwætgōdnesse	Wikipedia:Kriterier för utvalda artiklar
Bysen:Stycce	Mall:Stub
Bysen:Brūcend de	Mall:Användare de
Bysen:Brūcend de-1	Mall:Användare de-1
Bysen:Brūcend el	Mall:Användare el
Bysen:Brūcend es	Mall:Användare es
Bysen:Brūcend de-3	Mall:Användare de-3
Bysen:Brūcend en-3	Mall:Användare en-3
Bysen:Brūcend el-1	Mall:Användare el-1
Bysen:Brūcend en-1	Mall:Användare en-1
Bysen:Brūcend en-2	Mall:Användare en-2
Bysen:Brūcend eo-2	Mall:Användare eo-2
Bysen:Brūcend en-4	Mall:Användare en-4
Bysen:Brūcend fi	Mall:Användare fi
Bysen:Brūcend en-0	Mall:Användare en-0
Bysen:Brūcend en	Mall:Användare en
Bysen:Brūcend de-2	Mall:Användare de-2
Bysen:Brūcend es-1	Mall:Användare es-1
Bysen:Brūcend fi-1	Mall:Användare fi-1
Bysen:Brūcend fr-1	Mall:Användare fr-1
Flocc:Līf	Kategori:Liv
Bysen:Brūcend he-2	Mall:Användare he-2
Bysen:Brūcend it-3	Mall:Användare it-3
Bysen:User sk	Mall:Användare sk
Bysen:Brūcend fr-2	Mall:Användare fr-2
Bysen:Brūcend ja	Mall:Användare ja
Bysen:Brūcend ja-1	Mall:Användare ja-1
Bysen:Brūcend it-1	Mall:Användare it-1
Bysen:Brūcend fr	Mall:Användare fr
Cosco	Cusco
Flocc:Solmōnaþ	Kategori:Februari
Flocc:1949	Kategori:1949
Bysen:Stedefindend scite/Writ	Mall:Kartposition/Info
Flocc:Ceorfdēor	Kategori:Insekter
Flocc:Asia	Kategori:Asien
Flocc:Cile	Kategori:Chile
Flocc:21e gēarhundred	Kategori:2000-talet
Flocc:Lesotho	Kategori:Lesotho
Flocc:Brūcend uk	Kategori:Användare uk
Flocc:Sūðamerica	Kategori:Sydamerika
Flocc:Brūcend uk-M	Kategori:Användare uk-N
Flocc:1918	Kategori:1918
Flocc:1954	Kategori:1954
Flocc:Ǣt	Kategori:Mat
Flocc:1946	Kategori:1946
Flocc:Gyldfōtþōðer	Kategori:Fotboll
Flocc:1945	Kategori:1945
Bysen:Mod	Mall:Mod
Flocc:1926	Kategori:1926
Bysen:Brūcend sv	Mall:Användare sv
Flocc:1920	Kategori:1920
Bysen:Brūcend it	Mall:Användare it
Bysen:Brūcend uk	Mall:Användare uk
Bysen:Brūcend es-2	Mall:Användare es-2
Bysen:Infobox Football club	Mall:Lagfakta
Bysen:Welcome	Mall:Nybörjare
Flocc:Bysen mid ūtweardum hlence	Kategori:Externa länkmallar
Bysen:Country data Slovakia	Mall:Landsdata Slovakien
Bysen:Country flagnavy	Mall:Flotta/core
Bysen:Country data Czech Republic	Mall:Landsdata Tjeckien
Bysen:Country data Honduras	Mall:Landsdata Honduras
Bysen:Country data Bolivia	Mall:Landsdata Bolivia
Bysen:Country data Denemearc	Mall:Landsdata Danmark
Bysen:Country data Īsland	Mall:Landsdata Island
Bysen:Country data Poland	Mall:Landsdata Polen
Bysen:Scire in Irlande	Mall:Irland
Bysen:Wikivar	Mall:Wikivar
Flocc:Brūcend fr-1	Kategori:Användare fr-1
Bysen:Country data Norway	Mall:Landsdata Norge
Bysen:Wikiquote	Mall:Wikiquote
Bysen:Country showdata	Mall:Land showdata
Bysen:Country data Mexico	Mall:Landsdata Mexiko
Bysen:Affrica	Mall:Afrika
Bysen:Infobox television	Mall:Infobox TV-program
Flocc:Americisc Awendung Wig	Kategori:Amerikanska revolutionen
Bysen:Geānedu Rīcu American	Mall:USAs delstater
Bysen:Country data Australia	Mall:Landsdata Australien
Bysen:Cyþþubox ieg	Mall:Ö
Bysen:Country data France	Mall:Landsdata Frankrike
Bysen:Ambox	Mall:Ambox
Flocc:Americanisc stǣr	Kategori:USA:s historia
Bysen:Rnd	Mall:Rnd
Bysen:Infobox Country	Mall:Landsfakta
Bysen:Max	Mall:Högsta
Bysen:Country data Austria	Mall:Landsdata Österrike
Bysen:Country data Finland	Mall:Landsdata Finland
Bysen:Country data Japan	Mall:Landsdata Japan
Bysen:Infobox U.S. Scīr	Mall:Infobox USA-county
Bysen:Cleanup	Mall:Städa
Flocc:Crabbas	Kategori:Krabbor
Bysen:Cite journal	Mall:Tidskriftsref
Bysen:Lang-ar	Mall:Lang-ar
Bysen:Brūcend es-0	Mall:Användare es-0
Bysen:Cite news	Mall:Tidningsref
Bysen:Featured article	Mall:Utmärkt
Bysen:Country data Russia	Mall:Landsdata Ryssland
Flocc:Paris	Kategori:Paris
Flocc:Brūcend en-4	Kategori:Användare en-4
Flocc:Brūcend en	Kategori:Användare en
Flocc:Croatia	Kategori:Kroatien
Flocc:Brūcend en-2	Kategori:Användare en-2
Bysen:Infobox	Mall:Faktamall
Bysen:Main other	Mall:Artikel annan
Bysen:Image class names	Mall:Image class names
Flocc:Stafas	Kategori:Alfabet
Wikipǣdia:Gecorene gemynddagas/23 Hāligmōnaþ	Mall:23 september
Bysen:Template other	Mall:Mall annan
Wikipǣdia:Gecorene gemynddagas/4 Solmōnaþ	Mall:4 februari
Wikipǣdia:Gecorene gemynddagas/22 Hāligmōnaþ	Mall:22 september
Bysen:Lang-da	Mall:Lang-da
Wikipǣdia:Gecorene gemynddagas/30 Blōtmōnaþ	Mall:30 november
Wikipǣdia:Gecorene gemynddagas/18 Solmōnaþ	Mall:18 februari
Wikipǣdia:Gecorene gemynddagas/28 Æfterra Gēola	Mall:28 januari
Bysen:Legend	Mall:Legend
Wikipǣdia:Gecorene gemynddagas/14 Æfterra Gēola	Mall:14 januari
Wikipǣdia:Gecorene gemynddagas/25 Solmōnaþ	Mall:25 februari
Wikipǣdia:Gecorene gemynddagas/10 Wēodmōnaþ	Mall:10 augusti
Flocc:Bryttisce wrīteras	Kategori:Brittiska författare
Wikipǣdia:Gecorene gemynddagas/15 Winterfylleþ	Mall:15 oktober
Wikipǣdia:Gecorene gemynddagas/31 Wēodmōnaþ	Mall:31 augusti
Wikipǣdia:Gecorene gemynddagas/12 Blōtmōnaþ	Mall:12 november
Wikipǣdia:Gecorene gemynddagas/30 Mǣdmōnaþ	Mall:30 juli
Wikipǣdia:Gecorene gemynddagas/3 Wēodmōnaþ	Mall:3 augusti
Wikipǣdia:Gecorene gemynddagas/27 Wēodmōnaþ	Mall:27 augusti
Bysen:Cite web	Mall:Webbref
Wikipǣdia:Gecorene gemynddagas/21 Æfterra Gēola	Mall:21 januari
Wikipǣdia:Gecorene gemynddagas/8 Solmōnaþ	Mall:8 februari
Bysen:Country data Italy	Mall:Landsdata Italien
Wikipǣdia:Gecorene gemynddagas/20 Æfterra Gēola	Mall:20 januari
Wikipǣdia:Gecorene gemynddagas/23 Æfterra Gēola	Mall:23 januari
Wikipǣdia:Gecorene gemynddagas/28 Hāligmōnaþ	Mall:28 september
Bysen:Imdb title	Mall:IMDb-titel
Wikipǣdia:Gecorene gemynddagas/31 Gēolmōnaþ	Mall:31 december
Wikipǣdia:Gecorene gemynddagas/1 Solmōnaþ	Mall:1 februari
Wikipǣdia:Gecorene gemynddagas/14 Gēolmōnaþ	Mall:14 december
Wikipǣdia:Gecorene gemynddagas/25 Æfterra Gēola	Mall:25 januari
Wikipǣdia:Gecorene gemynddagas/6 Wēodmōnaþ	Mall:6 augusti
Wikipǣdia:Gecorene gemynddagas/24 Wēodmōnaþ	Mall:24 augusti
Wikipǣdia:Gecorene gemynddagas/9 Blōtmōnaþ	Mall:9 november
Wikipǣdia:Gecorene gemynddagas/18 Æfterra Gēola	Mall:18 januari
Wikipǣdia:Gecorene gemynddagas/17 Wēodmōnaþ	Mall:17 augusti
Wikipǣdia:Gecorene gemynddagas/27 Mǣdmōnaþ	Mall:27 juli
Bysen:Country data	Mall:Landsdata
Wikipǣdia:Gecorene gemynddagas/20 Wēodmōnaþ	Mall:20 augusti
Wikipǣdia:Gecorene gemynddagas/1 Winterfylleþ	Mall:1 oktober
Wikipǣdia:Gecorene gemynddagas/5 Winterfylleþ	Mall:5 oktober
Wikipǣdia:Gecorene gemynddagas/8 Winterfylleþ	Mall:8 oktober
Wikipǣdia:Gecorene gemynddagas/15 Solmōnaþ	Mall:15 februari
Bysen:Coor URL	Mall:Coor URL
Bysen:·	Mall:·
Bysen:Brūcend nl-1	Mall:Användare nl-1
Bysen:Min	Mall:Lägsta
Bysen:Wiktionarypar2	Mall:Wiktionary
Bysen:Brūcend nl-2	Mall:Användare nl-2
Bysen:Infobox Ice Hockey Player	Mall:Ishockeyspelare
Bysen:Country data Sweden	Mall:Landsdata Sverige
Flocc:Byrig on Dēnum	Kategori:Orter i Danmark
Flocc:Eorþtilþ	Kategori:Jordbruk
Wikipǣdia:Gecorene gemynddagas/26 Blōtmōnaþ	Mall:26 november
Wikipǣdia:Gecorene gemynddagas/26 Wēodmōnaþ	Mall:26 augusti
Wikipǣdia:Gecorene gemynddagas/12 Gēolmōnaþ	Mall:12 december
Wikipǣdia:Gecorene gemynddagas/25 Gēolmōnaþ	Mall:25 december
Wikipǣdia:Gecorene gemynddagas/10 Æfterra Gēola	Mall:10 januari
Wikipǣdia:Gecorene gemynddagas/31 Æfterra Gēola	Mall:31 januari
Wikipǣdia:Gecorene gemynddagas/6 Winterfylleþ	Mall:6 oktober
Wikipǣdia:Gecorene gemynddagas/6 Hrēþmōnaþ	Mall:6 mars
Wikipǣdia:Gecorene gemynddagas/18 Hrēþmōnaþ	Mall:18 mars
Wikipǣdia:Gecorene gemynddagas/17 Winterfylleþ	Mall:17 oktober
Wikipǣdia:Gecorene gemynddagas/27 Hrēþmōnaþ	Mall:27 mars
Wikipǣdia:Gecorene gemynddagas/19 Hrēþmōnaþ	Mall:19 mars
Wikipǣdia:Gecorene gemynddagas/2 Winterfylleþ	Mall:2 oktober
Wikipǣdia:Gecorene gemynddagas/2 Mǣdmōnaþ	Mall:2 juli
Wikipǣdia:Gecorene gemynddagas/10 Hrēþmōnaþ	Mall:10 mars
Wikipǣdia:Gecorene gemynddagas/1 Ēastermōnaþ	Mall:1 april
Wikipǣdia:Gecorene gemynddagas/31 Mǣdmōnaþ	Mall:31 juli
Wikipǣdia:Gecorene gemynddagas/12 Wēodmōnaþ	Mall:12 augusti
Wikipǣdia:Gecorene gemynddagas/26 Solmōnaþ	Mall:26 februari
Wikipǣdia:Gecorene gemynddagas/17 Mǣdmōnaþ	Mall:17 juli
Wikipǣdia:Gecorene gemynddagas/5 Wēodmōnaþ	Mall:5 augusti
Wikipǣdia:Gecorene gemynddagas/16 Hāligmōnaþ	Mall:16 september
Wikipǣdia:Gecorene gemynddagas/31 Winterfylleþ	Mall:31 oktober
Wikipǣdia:Gecorene gemynddagas/12 Solmōnaþ	Mall:12 februari
Wikipǣdia:Gecorene gemynddagas/15 Æfterra Gēola	Mall:15 januari
Wikipǣdia:Gecorene gemynddagas/19 Hāligmōnaþ	Mall:19 september
Wikipǣdia:Gecorene gemynddagas/16 Æfterra Gēola	Mall:16 januari
Wikipǣdia:Gecorene gemynddagas/13 Mǣdmōnaþ	Mall:13 juli
Wikipǣdia:Gecorene gemynddagas/2 Æfterra Gēola	Mall:2 januari
Wikipǣdia:Gecorene gemynddagas/9 Mǣdmōnaþ	Mall:9 juli
Wikipǣdia:Gecorene gemynddagas/10 Solmōnaþ	Mall:10 februari
Wikipǣdia:Gecorene gemynddagas/5 Hrēþmōnaþ	Mall:5 mars
Wikipǣdia:Gecorene gemynddagas/29 Sēremōnaþ	Mall:29 juni
Wikipǣdia:Gecorene gemynddagas/14 Blōtmōnaþ	Mall:14 november
Wikipǣdia:Gecorene gemynddagas/6 Æfterra Gēola	Mall:6 januari
Wikipǣdia:Gecorene gemynddagas/18 Mǣdmōnaþ	Mall:18 juli
Wikipǣdia:Gecorene gemynddagas/23 Mǣdmōnaþ	Mall:23 juli
Wikipǣdia:Gecorene gemynddagas/1 Mǣdmōnaþ	Mall:1 juli
Wikipǣdia:Gecorene gemynddagas/20 Gēolmōnaþ	Mall:20 december
Wikipǣdia:Gecorene gemynddagas/30 Wēodmōnaþ	Mall:30 augusti
Wikipǣdia:Gecorene gemynddagas/11 Wēodmōnaþ	Mall:11 augusti
Wikipǣdia:Gecorene gemynddagas/9 Wēodmōnaþ	Mall:9 augusti
Wikipǣdia:Gecorene gemynddagas/29 Blōtmōnaþ	Mall:29 november
Wikipǣdia:Gecorene gemynddagas/2 Ēastermōnaþ	Mall:2 april
Wikipǣdia:Gecorene gemynddagas/12 Mǣdmōnaþ	Mall:12 juli
Wikipǣdia:Gecorene gemynddagas/29 Wēodmōnaþ	Mall:29 augusti
Wikipǣdia:Gecorene gemynddagas/24 Sēremōnaþ	Mall:24 juni
Wikipǣdia:Gecorene gemynddagas/25 Blōtmōnaþ	Mall:25 november
Wikipǣdia:Gecorene gemynddagas/21 Wēodmōnaþ	Mall:21 augusti
Wikipǣdia:Gecorene gemynddagas/29 Mǣdmōnaþ	Mall:29 juli
Wikipǣdia:Gecorene gemynddagas/29 Æfterra Gēola	Mall:29 januari
Wikipǣdia:Gecorene gemynddagas/5 Gēolmōnaþ	Mall:5 december
Wikipǣdia:Gecorene gemynddagas/25 Hrēþmōnaþ	Mall:25 mars
Wikipǣdia:Gecorene gemynddagas/22 Hrēþmōnaþ	Mall:22 mars
Wikipǣdia:Gecorene gemynddagas/9 Hrēþmōnaþ	Mall:9 mars
Wikipǣdia:Gecorene gemynddagas/12 Hrēþmōnaþ	Mall:12 mars
Wikipǣdia:Gecorene gemynddagas/11 Hrēþmōnaþ	Mall:11 mars
Wikipǣdia:Gecorene gemynddagas/19 Gēolmōnaþ	Mall:19 december
Wikipǣdia:Gecorene gemynddagas/24 Solmōnaþ	Mall:24 februari
Wikipǣdia:Gecorene gemynddagas/13 Solmōnaþ	Mall:13 februari
Wikipǣdia:Gecorene gemynddagas/20 Solmōnaþ	Mall:20 februari
Wikipǣdia:Gecorene gemynddagas/5 Æfterra Gēola	Mall:5 januari
Wikipǣdia:Gecorene gemynddagas/15 Hrēþmōnaþ	Mall:15 mars
Wikipǣdia:Gecorene gemynddagas/23 Solmōnaþ	Mall:23 februari
Wikipǣdia:Gecorene gemynddagas/13 Hrēþmōnaþ	Mall:13 mars
Wikipǣdia:Gecorene gemynddagas/15 Hāligmōnaþ	Mall:15 september
Wikipǣdia:Gecorene gemynddagas/15 Gēolmōnaþ	Mall:15 december
Wikipǣdia:Gecorene gemynddagas/4 Hāligmōnaþ	Mall:4 september
Wikipǣdia:Gecorene gemynddagas/8 Hāligmōnaþ	Mall:8 september
Wikipǣdia:Gecorene gemynddagas/18 Gēolmōnaþ	Mall:18 december
Wikipǣdia:Gecorene gemynddagas/4 Hrēþmōnaþ	Mall:4 mars
Wikipǣdia:Gecorene gemynddagas/4 Winterfylleþ	Mall:4 oktober
Wikipǣdia:Gecorene gemynddagas/21 Blōtmōnaþ	Mall:21 november
Wikipǣdia:Gecorene gemynddagas/1 Hāligmōnaþ	Mall:1 september
Wikipǣdia:Gecorene gemynddagas/3 Mǣdmōnaþ	Mall:3 juli
Wikipǣdia:Gecorene gemynddagas/4 Mǣdmōnaþ	Mall:4 juli
Wikipǣdia:Gecorene gemynddagas/13 Æfterra Gēola	Mall:13 januari
Wikipǣdia:Gecorene gemynddagas/28 Sēremōnaþ	Mall:28 juni
Wikipǣdia:Gecorene gemynddagas/7 Sēremōnaþ	Mall:7 juni
Wikipǣdia:Gecorene gemynddagas/6 Hāligmōnaþ	Mall:6 september
Wikipǣdia:Gecorene gemynddagas/25 Hāligmōnaþ	Mall:25 september
Wikipǣdia:Gecorene gemynddagas/27 Æfterra Gēola	Mall:27 januari
Wikipǣdia:Gecorene gemynddagas/6 Mǣdmōnaþ	Mall:6 juli
Wikipǣdia:Gecorene gemynddagas/15 Mǣdmōnaþ	Mall:15 juli
Wikipǣdia:Gecorene gemynddagas/10 Hāligmōnaþ	Mall:10 september
Wikipǣdia:Gecorene gemynddagas/26 Hāligmōnaþ	Mall:26 september
Wikipǣdia:Gecorene gemynddagas/20 Hāligmōnaþ	Mall:20 september
Wikipǣdia:Gecorene gemynddagas/16 Mǣdmōnaþ	Mall:16 juli
Wikipǣdia:Gecorene gemynddagas/14 Mǣdmōnaþ	Mall:14 juli
Wikipǣdia:Gecorene gemynddagas/25 Mǣdmōnaþ	Mall:25 juli
Wikipǣdia:Gecorene gemynddagas/12 Æfterra Gēola	Mall:12 januari
Wikipǣdia:Gecorene gemynddagas/23 Wēodmōnaþ	Mall:23 augusti
Wikipǣdia:Gecorene gemynddagas/22 Sēremōnaþ	Mall:22 juni
Wikipǣdia:Gecorene gemynddagas/16 Wēodmōnaþ	Mall:16 augusti
Wikipǣdia:Gecorene gemynddagas/30 Gēolmōnaþ	Mall:30 december
Wikipǣdia:Gecorene gemynddagas/4 Blōtmōnaþ	Mall:4 november
Wikipǣdia:Gecorene gemynddagas/3 Æfterra Gēola	Mall:3 januari
Wikipǣdia:Gecorene gemynddagas/30 Hāligmōnaþ	Mall:30 september
Wikipǣdia:Gecorene gemynddagas/8 Æfterra Gēola	Mall:8 januari
Wikipǣdia:Gecorene gemynddagas/1 Hrēþmōnaþ	Mall:1 mars
Wikipǣdia:Gecorene gemynddagas/14 Solmōnaþ	Mall:14 februari
Wikipǣdia:Gecorene gemynddagas/7 Winterfylleþ	Mall:7 oktober
Wikipǣdia:Gecorene gemynddagas/19 Solmōnaþ	Mall:19 februari
Wikipǣdia:Gecorene gemynddagas/28 Hrēþmōnaþ	Mall:28 mars
Wikipǣdia:Gecorene gemynddagas/20 Hrēþmōnaþ	Mall:20 mars
Wikipǣdia:Gecorene gemynddagas/6 Solmōnaþ	Mall:6 februari
Wikipǣdia:Gecorene gemynddagas/7 Solmōnaþ	Mall:7 februari
Wikipǣdia:Gecorene gemynddagas/21 Solmōnaþ	Mall:21 februari
Wikipǣdia:Gecorene gemynddagas/1 Wēodmōnaþ	Mall:1 augusti
Wikipǣdia:Gecorene gemynddagas/14 Hrēþmōnaþ	Mall:14 mars
Wikipǣdia:Gecorene gemynddagas/28 Solmōnaþ	Mall:28 februari
Wikipǣdia:Gecorene gemynddagas/27 Hāligmōnaþ	Mall:27 september
Wikipǣdia:Gecorene gemynddagas/8 Mǣdmōnaþ	Mall:8 juli
Wikipǣdia:Gecorene gemynddagas/11 Hāligmōnaþ	Mall:11 september
Wikipǣdia:Gecorene gemynddagas/22 Mǣdmōnaþ	Mall:22 juli
Wikipǣdia:Gecorene gemynddagas/28 Wēodmōnaþ	Mall:28 augusti
Wikipǣdia:Gecorene gemynddagas/1 Blōtmōnaþ	Mall:1 november
Wikipǣdia:Gecorene gemynddagas/2 Solmōnaþ	Mall:2 februari
Wikipǣdia:Gecorene gemynddagas/4 Wēodmōnaþ	Mall:4 augusti
Wikipǣdia:Gecorene gemynddagas/22 Gēolmōnaþ	Mall:22 december
Wikipǣdia:Gecorene gemynddagas/20 Winterfylleþ	Mall:20 oktober
Wikipǣdia:Gecorene gemynddagas/28 Mǣdmōnaþ	Mall:28 juli
Wikipǣdia:Gecorene gemynddagas/17 Æfterra Gēola	Mall:17 januari
Wikipǣdia:Gecorene gemynddagas/3 Solmōnaþ	Mall:3 februari
Bysen:Lang-sr	Mall:Lang-sr
Wikipǣdia:Gecorene gemynddagas/7 Mǣdmōnaþ	Mall:7 juli
Wikipǣdia:Gecorene gemynddagas/24 Mǣdmōnaþ	Mall:24 juli
Wikipǣdia:Gecorene gemynddagas/21 Mǣdmōnaþ	Mall:21 juli
Wikipǣdia:Gecorene gemynddagas/6 Sēremōnaþ	Mall:6 juni
Wikipǣdia:Gecorene gemynddagas/11 Mǣdmōnaþ	Mall:11 juli
Wikipǣdia:Gecorene gemynddagas/8 Wēodmōnaþ	Mall:8 augusti
Wikipǣdia:Gecorene gemynddagas/15 Wēodmōnaþ	Mall:15 augusti
Wikipǣdia:Gecorene gemynddagas/10 Mǣdmōnaþ	Mall:10 juli
Wikipǣdia:Gecorene gemynddagas/16 Hrēþmōnaþ	Mall:16 mars
Wikipǣdia:Gecorene gemynddagas/14 Winterfylleþ	Mall:14 oktober
Wikipǣdia:Gecorene gemynddagas/17 Hrēþmōnaþ	Mall:17 mars
Wikipǣdia:Gecorene gemynddagas/24 Hrēþmōnaþ	Mall:24 mars
Wikipǣdia:Gecorene gemynddagas/21 Hrēþmōnaþ	Mall:21 mars
Wikipǣdia:Gecorene gemynddagas/5 Solmōnaþ	Mall:5 februari
Wikipǣdia:Gecorene gemynddagas/3 Winterfylleþ	Mall:3 oktober
Wikipǣdia:Gecorene gemynddagas/7 Hāligmōnaþ	Mall:7 september
Wikipǣdia:Gecorene gemynddagas/26 Mǣdmōnaþ	Mall:26 juli
Wikipǣdia:Gecorene gemynddagas/14 Sēremōnaþ	Mall:14 juni
Flocc:Beorgas	Kategori:Berg
Bysen:Brūcend ru	Mall:Användare ru
Flocc:20e gēarhundred	Kategori:1900-talet
Bysen:IPA	Mall:IPA
Bysen:USpresidents	Mall:USA:s presidenter
Wikipǣdia:Gecorene gemynddagas/7 Hrēþmōnaþ	Mall:7 mars
Wikipǣdia:Gecorene gemynddagas/29 Hrēþmōnaþ	Mall:29 mars
Flocc:Bysen Brūcend Box Spræc	Kategori:Babelmallar
Wikipǣdia:Gecorene gemynddagas/28 Ēastermōnaþ	Mall:28 april
Bysen:LangWithName	Mall:LangWithName
Flocc:Hwæsingatūn	Kategori:Washington
Flocc:Wihta	Kategori:Övernaturliga väsen
Wikipǣdia:Gecorene gemynddagas/30 Hrēþmōnaþ	Mall:30 mars
Wikipǣdia:Gecorene gemynddagas/22 Solmōnaþ	Mall:22 februari
Wikipǣdia:Gecorene gemynddagas/31 Hrēþmōnaþ	Mall:31 mars
Wikipǣdia:Gecorene gemynddagas/23 Hrēþmōnaþ	Mall:23 mars
Wikipǣdia:Gecorene gemynddagas/17 Solmōnaþ	Mall:17 februari
Bysen:Birth date and age	Mall:Ålder
Bysen:MONTHNAME	Mall:MÅNADSNAMN
Wikipǣdia:Gecorene gemynddagas/30 Æfterra Gēola	Mall:30 januari
Wikipǣdia:Gecorene gemynddagas/9 Solmōnaþ	Mall:9 februari
Wikipǣdia:Gecorene gemynddagas/8 Hrēþmōnaþ	Mall:8 mars
Bysen:Sortname	Mall:Sortname
Flocc:Gebēd	Kategori:Bön
Wikipǣdia:Gecorene gemynddagas/29 Solmōnaþ	Mall:29 februari
Wikipǣdia:Gecorene gemynddagas/2 Hrēþmōnaþ	Mall:2 mars
Wikipǣdia:Gecorene gemynddagas/27 Solmōnaþ	Mall:27 februari
Wikipǣdia:Gecorene gemynddagas/26 Hrēþmōnaþ	Mall:26 mars
Flocc:Country data templates	Kategori:Landsdatamallar
Wikipǣdia:Gecorene gemynddagas/Solmōnaþ	Wikipedia:Dagens händelser/Februari
Bysen:Country data England	Mall:Landsdata Kungariket England
Flocc:19e gēarhundred	Kategori:1800-talet
Bysen:Country data Republic of Ireland	Mall:Landsdata Republiken Irland
Flocc:Wrīteras	Kategori:Författare
Bysen:Country data Switzerland	Mall:Landsdata Schweiz
Bysen:Lang-cs	Mall:Lang-cs
Bysen:Lang-he	Mall:Lang-he
Bysen:Infobox OS	Mall:Infobox operativsystem
Bysen:Both	Mall:Both
Flocc:Æfterra Gēola	Kategori:Januari
Bysen:Lang-fa	Mall:Lang-fa
Bysen:Brūcend pl	Mall:Användare pl
Bysen:Brūcend nl	Mall:Användare nl-N
Bysen:Brūcend pl-0	Mall:Användare pl-0
Wikipǣdia:Gecorene gemynddagas/12 Winterfylleþ	Mall:12 oktober
Bysen:Brūcend no-2	Mall:Användare no-2
Wikipǣdia:Gecorene gemynddagas/11 Solmōnaþ	Mall:11 februari
Bysen:Australia	Mall:Australiens delstater och territorier
Wikipǣdia:Nospam	Wikipedia:Skyddade sidnamn
Wikipǣdia:Gecorene gemynddagas/5 Blōtmōnaþ	Mall:5 november
Wikipǣdia:Gecorene gemynddagas/11 Æfterra Gēola	Mall:11 januari
Wikipǣdia:Gecorene gemynddagas/3 Hāligmōnaþ	Mall:3 september
Wikipǣdia:Gecorene gemynddagas/24 Hāligmōnaþ	Mall:24 september
Bysen:CAN	Mall:CAN
Bysen:Lang-de	Mall:Lang-de
Bysen:Country data Austria-Hungary	Mall:Landsdata Österrike-Ungern
Bysen:Sæternes Bōtm	Mall:Saturnus månar
Bysen:Lang-la	Mall:Lang-la
Flocc:Wucu	Kategori:Veckor
Bysen:Lang-af	Mall:Lang-af
Wikipǣdia:Gecorene gemynddagas/Gēolmōnaþ	Wikipedia:Dagens händelser/December
Bysen:Infobox Album	Mall:Album infobox
Bysen:User	Mall:Anv-data
Wikipǣdia:Gecorene gemynddagas/16 Gēolmōnaþ	Mall:16 december
Wikipǣdia:Gecorene gemynddagas/9 Æfterra Gēola	Mall:9 januari
Wikipǣdia:Gecorene gemynddagas/7 Æfterra Gēola	Mall:7 januari
Wikipǣdia:Gecorene gemynddagas/19 Mǣdmōnaþ	Mall:19 juli
Wikipǣdia:Gecorene gemynddagas/13 Wēodmōnaþ	Mall:13 augusti
Wikipǣdia:Gecorene gemynddagas/12 Hāligmōnaþ	Mall:12 september
Wikipǣdia:Gecorene gemynddagas/2 Hāligmōnaþ	Mall:2 september
Wikipǣdia:Gecorene gemynddagas/7 Wēodmōnaþ	Mall:7 augusti
Wikipǣdia:Gecorene gemynddagas/4 Ēastermōnaþ	Mall:4 april
Wikipǣdia:Gecorene gemynddagas/22 Æfterra Gēola	Mall:22 januari
Wikipǣdia:Gecorene gemynddagas/4 Æfterra Gēola	Mall:4 januari
Wikipǣdia:Gecorene gemynddagas/19 Wēodmōnaþ	Mall:19 augusti
Wikipǣdia:Gecorene gemynddagas/18 Hāligmōnaþ	Mall:18 september
Wikipǣdia:Gecorene gemynddagas/4 Gēolmōnaþ	Mall:4 december
Wikipǣdia:Gecorene gemynddagas/2 Wēodmōnaþ	Mall:2 augusti
Wikipǣdia:Gecorene gemynddagas/21 Gēolmōnaþ	Mall:21 december
Wikipǣdia:Gecorene gemynddagas/20 Mǣdmōnaþ	Mall:20 juli
Wikipǣdia:Gecorene gemynddagas/18 Wēodmōnaþ	Mall:18 augusti
Wikipǣdia:Gecorene gemynddagas/24 Æfterra Gēola	Mall:24 januari
Wikipǣdia:Brōðra rǣdscēawung	Wikipedia:Artikelgranskningar
Flocc:Flyhthæfenan on Fietname	Kategori:Flygplatser i Vietnam
Bysen:Brūcend pl-1	Mall:Användare pl-1
Flocc:Gebed	Kategori:Kristna böner
Flocc:Cyningas of Englalande	Kategori:Englands regenter
Bysen:Brūcend fr-3	Mall:Användare fr-3
Bysen:Imdb name	Mall:IMDb-namn
Flocc:Tunisia	Kategori:Tunisien
Bysen:Wikispell	Mall:Wikinews
Bysen:Brūcend lt	Mall:Användare lt
Bysen:Coord/link	Mall:Coord/link
Bysen:Infobox UK place	Mall:Ortsfakta Storbritannien
Bysen:Brūcend is-2	Mall:Användare is-2
Bysen:Brūcend de-0	Mall:Användare de-0
Bysen:Brūcend en-5	Mall:Användare en-5
Bysen:Dagas þǣre wuce	Mall:Veckodagar
Flocc:Þēodisc burg	Kategori:Orter i Tyskland
Bysen:Brūcend fr-0	Mall:Användare fr-0
Flocc:Norþ Carolīna	Kategori:North Carolina
Flocc:Puerto Rico	Kategori:Puerto Rico
Flocc:Byrig þāra Geāndena Rīca American	Kategori:Orter i USA
Bysen:Country data West Germany	Mall:Landsdata Västtyskland
Bysen:Lang-ru	Mall:Lang-ru
Bysen:Country data East Germany	Mall:Landsdata Östtyskland
Bysen:Brūcend it-0	Mall:Användare it-0
Bysen:Browsebar	Mall:Browsebar
Flocc:Brittisca Here	Kategori:Storbritanniens armé
Bysen:Disambig	Mall:Förgrening
Flocc:Byrig on Israhēlum	Kategori:Orter i Israel
Bysen:Country data Nazi Germany	Mall:Landsdata Nazityskland
Bysen:Doi	Mall:DOI
Bysen:Country data German Empire	Mall:Landsdata Kejsardömet Tyskland
Flocc:Coreanisc stǣr	Kategori:Koreas historia
Bysen:Fb	Mall:Hff
Bysen:Lang-grc	Mall:Lang-grc
Bysen:Brūcend ksh	Mall:Användare ksh
Bysen:Infobox Film	Mall:Filmfakta
Bysen:Lang-id	Mall:Lang-id
Flocc:Byrig on Belgum	Kategori:Orter i Belgien
Bysen:Brūcend sv-2	Mall:Användare sv-2
Bysen:Brūcend it-2	Mall:Användare it-2
Bysen:Lang-fr	Mall:Lang-fr
Bysen:Betwuxwici	Mall:Interwiki
Flocc:Byrig in þǣm Niðerlandum	Kategori:Orter i Nederländerna
Wikipǣdia:Gecorene gemynddagas/Hāligmōnaþ	Wikipedia:Dagens händelser/September
Bysen:Coord	Mall:Coord
Flocc:Byrig on Lincolnscīre	Kategori:Orter i Lincolnshire
Bysen:Brūcend pt-2	Mall:Användare pt-2
Flocc:Wyoming	Kategori:Wyoming
Wikipǣdia:Gecorene gemynddagas/14 Hāligmōnaþ	Mall:14 september
Wikipǣdia:Gecorene gemynddagas/20 Sēremōnaþ	Mall:20 juni
Wikipǣdia:Gecorene gemynddagas/22 Wēodmōnaþ	Mall:22 augusti
Wikipǣdia:Gecorene gemynddagas/9 Hāligmōnaþ	Mall:9 september
Wikipǣdia:Gecorene gemynddagas/13 Hāligmōnaþ	Mall:13 september
Wikipǣdia:Gecorene gemynddagas/1 Æfterra Gēola	Mall:1 januari
Wikipǣdia:Gecorene gemynddagas/14 Wēodmōnaþ	Mall:14 augusti
Wikipǣdia:Gecorene gemynddagas/6 Gēolmōnaþ	Mall:6 december
Flocc:Grēneland	Kategori:Grönland
Wikipǣdia:Gecorene gemynddagas/Winterfylleþ	Wikipedia:Dagens händelser/Oktober
Bysen:Brūcend la-1	Mall:Användare la-1
Bysen:Land on Europan	Mall:Europa
Bysen:Brūcend is-0	Mall:Användare is-0
Flocc:User sk	Kategori:Användare sk
Flocc:Brūcend eo	Kategori:Användare eo
Flocc:Brūcend fr	Kategori:Användare fr
Flocc:Brūcend cy	Kategori:Användare cy
Flocc:Brūcend got	Kategori:Användare got
Flocc:Brūcend ang	Kategori:Användare ang
Flocc:Brūcend la	Kategori:Användare la
Flocc:Brūcend lt	Kategori:Användare lt
Flocc:Brūcend pt	Kategori:Användare pt
Flocc:Brūcend sv	Kategori:Användare sv
Flocc:Brūcend fr-3	Kategori:Användare fr-3
Flocc:Brūcend cy-3	Kategori:Användare cy-3
Flocc:Brūcend ang-3	Kategori:Användare ang-3
Flocc:Brūcend it-3	Kategori:Användare it-3
Flocc:Brūcend pl-3	Kategori:Användare pl-3
Flocc:Brūcend fi-1	Kategori:Användare fi-1
Flocc:Brūcend cy-1	Kategori:Användare cy-1
Flocc:Brūcend ang-1	Kategori:Användare ang-1
Flocc:Brūcend nl-1	Kategori:Användare nl-1
Flocc:Brūcend pl-1	Kategori:Användare pl-1
Flocc:Brūcend fr-4	Kategori:Användare fr-4
Flocc:Brūcend it-4	Kategori:Användare it-4
Flocc:Brūcend pl-4	Kategori:Användare pl-4
Flocc:Brūcend fr-2	Kategori:Användare fr-2
Flocc:Brūcend cy-2	Kategori:Användare cy-2
Flocc:Brūcend ang-2	Kategori:Användare ang-2
Flocc:Brūcend it-2	Kategori:Användare it-2
Flocc:Brūcend la-2	Kategori:Användare la-2
Flocc:Brūcend pl-2	Kategori:Användare pl-2
Flocc:Brūcend sv-2	Kategori:Användare sv-2
Flocc:Brūcend fr-M	Kategori:Användare fr-N
Flocc:Brūcend cy-M	Kategori:Användare cy-N
Flocc:Brūcend ang-N	Kategori:Användare ang-N
Flocc:Brūcend is-M	Kategori:Användare is-N
Flocc:Brūcend lt-N	Kategori:Användare lt-N
Flocc:Brūcend nl-M	Kategori:Användare nl-N
Flocc:Brūcend ru-M	Kategori:Användare ru-N
Flocc:Feormung	Kategori:Nöjen
Flocc:Hēafodstōlas þæs Sericus Gārsecges	Kategori:Oceaniens huvudstäder
Flocc:Turcas and Caicos Īegland	Kategori:Turks- och Caicosöarna
Flocc:Tudoryld	Kategori:Tudoreran
Flocc:Articles that need to be wikified	Kategori:Artiklar som behöver wikifieras
Flocc:Byrig on Canadan	Kategori:Orter i Kanada
Flocc:Īega	Kategori:Öar
Flocc:Sericus Garsecg	Kategori:Stilla havet
Flocc:User sk-N	Kategori:Användare sk-N
Flocc:Brūcend de	Kategori:Användare de
Flocc:Brūcend de-2	Kategori:Användare de-2
Flocc:Brūcend de-3	Kategori:Användare de-3
Flocc:Brūcend de-4	Kategori:Användare de-4
Flocc:Brūcend el	Kategori:Användare el
Flocc:Brūcend el-1	Kategori:Användare el-1
Flocc:Brūcend el-2	Kategori:Användare el-2
Flocc:Brūcend el-3	Kategori:Användare el-3
Flocc:Brūcend el-N	Kategori:Användare el-N
Flocc:Sūþgeorgia and þā Sūþsandwic Īegland	Kategori:Sydgeorgien och Sydsandwichöarna
Flocc:Brūcend en-3	Kategori:Användare en-3
Flocc:Brūcend en-M	Kategori:Användare en-N
Flocc:Brūcend eo-2	Kategori:Användare eo-2
Flocc:Brūcend es	Kategori:Användare es
Flocc:Brūcend es-1	Kategori:Användare es-1
Flocc:Brūcend es-2	Kategori:Användare es-2
Flocc:Puilla	Kategori:Apulien
Flocc:Brūcend es-3	Kategori:Användare es-3
Flocc:Brūcend es-4	Kategori:Användare es-4
Flocc:Brūcend es-N	Kategori:Användare es-N
Flocc:Brūcend fi	Kategori:Användare fi
Flocc:Brūcend fi-M	Kategori:Användare fi-N
Flocc:Brūcend fo	Kategori:Användare fo
Flocc:Brūcend fo-1	Kategori:Användare fo-1
Flocc:Brūcend fo-2	Kategori:Användare fo-2
Flocc:Brūcend fo-M	Kategori:Användare fo-N
Flocc:Brūcend is	Kategori:Användare is
Flocc:Brūcend is-1	Kategori:Användare is-1
Flocc:Brūcend is-2	Kategori:Användare is-2
Flocc:Brūcend is-3	Kategori:Användare is-3
Bysen:Brūcend la-3	Mall:Användare la-3
Flocc:Frencisc Guiana	Kategori:Franska Guyana
Ǣht	Egendom
Flocc:Hebrēisc sprǣc	Kategori:Hebreiska
Flocc:Brūcend pt-3	Kategori:Användare pt-3
Flocc:Bryttisc bōccræft	Kategori:Brittisk litteratur
Flocc:Brūcend pl-N	Kategori:Användare pl-N
Flocc:Brūcend pt-1	Kategori:Användare pt-1
Bysen:Country data Germany	Mall:Landsdata Tyskland
Bysen:Country data Geāned Cynerīce	Mall:Landsdata Storbritannien
Wikipǣdia:Gecorene gemynddagas/17 Gēolmōnaþ	Mall:17 december
Wikipǣdia:Gecorene gemynddagas/Mǣdmōnaþ	Wikipedia:Dagens händelser/Juli
Bysen:Lang-be	Mall:Lang-be
Bysen:Cite encyclopedia	Mall:Cite encyclopedia
Bysen:Country data Scotland	Mall:Landsdata Skottland
Wikipǣdia:Tutorial (Formatting)	Wikipedia:Introduktion till formatering
Flocc:Brūcend it	Kategori:Användare it
Flocc:Brūcend it-1	Kategori:Användare it-1
Flocc:Rīcu þāra Geāndena Rīca American	Kategori:USA:s delstater
Flocc:Brūcend ksh	Kategori:Användare ksh
Bysen:Mpl	Mall:Spl
Flocc:Brūcend la-1	Kategori:Användare la-1
Wikipǣdia:Gecorene gemynddagas/29 Hāligmōnaþ	Mall:29 september
Flocc:Brūcend la-3	Kategori:Användare la-3
Flocc:Brūcend la-N	Kategori:Användare la-N
Wikipǣdia:Gecorene gemynddagas/5 Hāligmōnaþ	Mall:5 september
Bysen:Cite doi	Mall:Cite doi
Flocc:Pulgara cyningas	Kategori:Bulgariens regenter
Flocc:Fȳrbeorgas	Kategori:Vulkaner
Flocc:Dēorabyscīr	Kategori:Derbyshire
Flocc:Byrig on Latie	Kategori:Kommuner i Lazio
Flocc:Feohtan	Kategori:Kampsport
Bysen:Country data Australasia	Mall:Landsdata Australasien
Flocc:Blōtmōnaþ	Kategori:November
Flocc:Difelinscīr	Kategori:Dublin (grevskap)
Wikipǣdia:Babel	Wikipedia:Babel
Flocc:Byrig on Australie	Kategori:Orter i Australien
Flocc:Scopas	Kategori:Poeter
Flocc:Hāligmōnaþ	Kategori:September
Flocc:Winterfylleþ	Kategori:Oktober
Flocc:Sǣ	Kategori:Hav
Flocc:Gēolmōnaþ	Kategori:December
Flocc:Wēodmōnaþ	Kategori:Augusti
Flocc:Þrimilcemōnaþ	Kategori:Maj
Flocc:Brandenburg	Kategori:Brandenburg
Flocc:Englaland	Kategori:England
Wikipǣdia:Gecorene gemynddagas/22 Blōtmōnaþ	Mall:22 november
Flocc:Ēastermōnaþ	Kategori:April
Bysen:IPA2	Mall:IPA2
Flocc:Līfnamrǣden	Kategori:Taxonomi
Bysen:Lang-it	Mall:Lang-it
Bysen:Country data Brazil	Mall:Landsdata Brasilien
Flocc:Gestorfen in 988	Kategori:Avlidna 988
Flocc:Wæter	Kategori:Vatten
Flocc:Hēafod and swēor	Kategori:Huvud och hals
Flocc:Geboren in 121	Kategori:Födda 121
Wikipǣdia:MediaWiki namespace	Wikipedia:Namnrymder/MediaWiki
Flocc:180	Kategori:180
Flocc:Gestorfen in 180	Kategori:Avlidna 180
Flocc:Drincas	Kategori:Drycker
Flocc:Gestorfen in 2005	Kategori:Avlidna 2005
Flocc:450	Kategori:450
Wikipǣdia:Administrators' how-to guide	Wikipedia:Manual för administratörer
Bysen:Start date and age	Mall:Startdatum och ålder
Wikipǣdia:Manigsprǣclicu samodwyrcung	Wikipedia:Lista över Wikipedias språkversioner
Flocc:Geboren in 1974	Kategori:Födda 1974
Flocc:Geboren in 1899	Kategori:Födda 1899
Flocc:Oklahoma	Kategori:Oklahoma
Flocc:Iapanisc sangeras	Kategori:Japanska sångare
Flocc:Geboren in 1954	Kategori:Födda 1954
Flocc:850	Kategori:850
Flocc:Geboren in 850	Kategori:Födda 850
Bysen:Cyþþubox Æþel	Mall:Regent
Flocc:Hwītrussland	Kategori:Vitryssland
Flocc:Alberta	Kategori:Alberta
Flocc:Ontario	Kategori:Ontario
Flocc:Nīwe Scotland	Kategori:Nova Scotia
Flocc:899	Kategori:899
Flocc:Gestorfen in 899	Kategori:Avlidna 899
Flocc:Geocon Landscipe	Kategori:Yukon
Flocc:Massachusetts	Kategori:Massachusetts
Flocc:924	Kategori:924
Flocc:Gestorfen in 924	Kategori:Avlidna 924
Bysen:Country data Ungerland	Mall:Landsdata Ungern
Flocc:Land on Affrice	Kategori:Afrikas länder
Bysen:Canadan underrīce	Mall:Kanada
Flocc:Geboren in 1239	Kategori:Födda 1239
Flocc:1249	Kategori:1249
Flocc:1289	Kategori:1289
Flocc:1305	Kategori:1305
Flocc:Gestorfen in 1305	Kategori:Avlidna 1305
Flocc:1307	Kategori:1307
Wikipǣdia:Gecorene gemynddagas/Blōtmōnaþ	Wikipedia:Dagens händelser/November
Bysen:Country data New Zealand	Mall:Landsdata Nya Zeeland
Bysen:Brūcend es-3	Mall:Användare es-3
Flocc:Ēa Franclandes	Kategori:Vattendrag i Frankrike
Flocc:Brūcend pt-2	Kategori:Användare pt-2
Flocc:Brūcend pt-N	Kategori:Användare pt-N
Flocc:Brūcend ru	Kategori:Användare ru
Flocc:Brūcend sv-M	Kategori:Användare sv-N
Flocc:1634	Kategori:1634
Flocc:1638	Kategori:1638
Bysen:En icon	Mall:En ikon
Flocc:1719	Kategori:1719
Flocc:Gestorfen in 1719	Kategori:Avlidna 1719
Bysen:Country data Faroe Islands	Mall:Landsdata Färöarna
Flocc:121	Kategori:121
Bysen:Lang	Mall:Lang
Wikipǣdia:Gecorene gemynddagas/21 Hāligmōnaþ	Mall:21 september
Flocc:Trēowu	Kategori:Träd
Bysen:Infobox ea	Mall:Infobox vattendrag
Flocc:Geboren in 1634	Kategori:Födda 1634
Flocc:Geboren in 1638	Kategori:Födda 1638
Flocc:Geboren in 1852	Kategori:Födda 1852
Flocc:Geboren in 1892	Kategori:Födda 1892
Flocc:Geboren in 1918	Kategori:Födda 1918
Flocc:Geboren in 1945	Kategori:Födda 1945
Flocc:Geboren in 1949	Kategori:Födda 1949
Flocc:Geboren in 1981	Kategori:Födda 1981
Flocc:Geboren in 1993	Kategori:Födda 1993
Flocc:1715	Kategori:1715
Wikipǣdia:Gecorene gemynddagas/Ēastermōnaþ	Wikipedia:Dagens händelser/April
Flocc:11e gēarhundred	Kategori:1000-talet
Flocc:988	Kategori:988
Flocc:10e gēarhundred	Kategori:900-talet
Flocc:7e gēarhundred	Kategori:600-talet
Flocc:1239	Kategori:1239
Flocc:Gestorfen in 1307	Kategori:Avlidna 1307
Flocc:Corsica	Kategori:Korsika
Flocc:Gestorfen in 1715	Kategori:Avlidna 1715
Flocc:Russisce bōccræft	Kategori:Rysk litteratur
Flocc:Sardinia	Kategori:Sardinien
Bysen:Lang-hi	Mall:Lang-hi
Flocc:Florida	Kategori:Florida
Flocc:Normandig	Kategori:Normandie
Flocc:Nevada	Kategori:Nevada
Flocc:Nebraska	Kategori:Nebraska
Flocc:Norþ Dakota	Kategori:North Dakota
Flocc:Nīwe Eoforwīc	Kategori:Delstaten New York
Flocc:Rhode Īeg	Kategori:Rhode Island
Flocc:Louisiāna	Kategori:Louisiana
Flocc:Marianland	Kategori:Maryland
Flocc:Maine	Kategori:Maine
Flocc:Minnesota	Kategori:Minnesota
Flocc:Michigan	Kategori:Michigan
Flocc:Mississippi	Kategori:Mississippi
Flocc:Missouri	Kategori:Missouri
Flocc:Vermont	Kategori:Vermont
Flocc:Virginia	Kategori:Virginia
Flocc:Idaho	Kategori:Idaho
Flocc:Iowa	Kategori:Iowa
Flocc:Arkansas	Kategori:Arkansas
Flocc:Alaska	Kategori:Alaska
Flocc:Arizona	Kategori:Arizona
Flocc:Alabama	Kategori:Alabama
Flocc:Ohio	Kategori:Ohio
Flocc:Westvirginia	Kategori:West Virginia
Flocc:Wisconsin	Kategori:Wisconsin
Flocc:Indiāna	Kategori:Indiana
Flocc:Illinois	Kategori:Illinois
Flocc:Kansas	Kategori:Kansas
Flocc:California	Kategori:Kalifornien
Flocc:Kentucky	Kategori:Kentucky
Flocc:Connecticut	Kategori:Connecticut
Flocc:Colorado	Kategori:Colorado
Flocc:Texas	Kategori:Texas
Flocc:Hawaii	Kategori:Hawaii
Melampyrum lineare	Melampyrum lineare
Flocc:Ōðru Woruldgūþ	Kategori:Andra världskriget
Flocc:Nīwes Sǣlandes byrig	Kategori:Orter i Nya Zeeland
Flocc:Hundas	Kategori:Hundar
Flocc:Cattas	Kategori:Kattdjur
Wikipǣdia:Gecorene gemynddagas/16 Solmōnaþ	Mall:16 februari
Wikipǣdia:Gecorene gemynddagas/25 Wēodmōnaþ	Mall:25 augusti
Flocc:Russisce wrīteras	Kategori:Ryska författare
Bysen:•	Mall:•
Flocc:1066	Kategori:1066
Flocc:Gestorfen in 1066	Kategori:Avlidna 1066
Flocc:Angola	Kategori:Angola
Flocc:Botswana	Kategori:Botswana
Flocc:Elpendbānrima	Kategori:Elfenbenskusten
Flocc:Æriþrea	Kategori:Eritrea
Flocc:Gabon	Kategori:Gabon
Flocc:Gambia	Kategori:Gambia
Flocc:Guinea	Kategori:Guinea
Flocc:Camerun	Kategori:Kamerun
Flocc:Grēnenæs Īega	Kategori:Kap Verde
Flocc:Cenia	Kategori:Kenya
Flocc:Liberia	Kategori:Liberia
Flocc:Libia	Kategori:Libyen
Flocc:Morocco	Kategori:Marocko
Flocc:Mauritania	Kategori:Mauretanien
Flocc:1451	Kategori:1451
Flocc:Namibia	Kategori:Namibia
Flocc:Delaware	Kategori:Delaware
Flocc:Georgia (America)	Kategori:Georgia
Flocc:Montāna	Kategori:Montana
Flocc:Eall gewritu þe hlȳtrunge þurfaþ	Kategori:Städa
Bysen:Merge	Mall:Slå ihop
Flocc:Tennessee	Kategori:Tennessee
Bysen:Sūðamerica	Mall:Sydamerika
Flocc:Baden-Wyrttemberg	Kategori:Baden-Württemberg
Flocc:1852	Kategori:1852
Flocc:1892	Kategori:1892
Flocc:Gestorfen in 1926	Kategori:Avlidna 1926
Flocc:1973	Kategori:1973
Flocc:Gestorfen in 1973	Kategori:Avlidna 1973
Flocc:1975	Kategori:1975
Flocc:1981	Kategori:1981
Flocc:Gestorfen in 1982	Kategori:Avlidna 1982
Flocc:2004	Kategori:2004
Flocc:Gestorfen in 2004	Kategori:Avlidna 2004
Flocc:2005	Kategori:2005
Flocc:2006	Kategori:2006
Flocc:2007	Kategori:2007
Flocc:2008	Kategori:2008
Flocc:Ēa	Kategori:Vattendrag
Bysen:Brūcend fo-3	Mall:Användare fo-3
Bysen:Brūcend la-2	Mall:Användare la-2
Bysen:Brūcend pt	Mall:Användare pt
Flocc:Sūþsudan	Kategori:Sydsudan
Flocc:Cead	Kategori:Tchad
Flocc:Uganda	Kategori:Uganda
Flocc:Rōmānisce Cāseras	Kategori:Romerska kejsare
Flocc:Brūcend nl	Kategori:Användare nl
Flocc:Sūþhjaltland	Kategori:Sydshetlandsöarna
Flocc:Brūcend no-1	Kategori:Användare no-1
Flocc:Brūcend no-2	Kategori:Användare no-2
Flocc:Brūcend no	Kategori:Användare no
Flocc:Niðerlanda Cyningas	Kategori:Nederländernas regenter
Flocc:Norrena cyningas	Kategori:Norges regenter
Flocc:Swēona cyningas	Kategori:Sveriges regenter
Flocc:Armenia	Kategori:Armenien
Flocc:Bahrain	Kategori:Bahrain
Flocc:Mennisc bodiȝlār	Kategori:Människans anatomi
Flocc:Feorrsīen	Kategori:Television
Flocc:Angelcirice	Kategori:Engelska kyrkan
Flocc:14e gēarhundred	Kategori:1300-talet
Flocc:13e gēarhundred	Kategori:1200-talet
Flocc:2e gēarhundred	Kategori:100-talet
Flocc:4e gēarhundred	Kategori:300-talet
Flocc:5e gēarhundred	Kategori:400-talet
Flocc:18e gēarhundred	Kategori:1700-talet
Flocc:6e gēarhundred	Kategori:500-talet
Flocc:Nīwlicu Word	Kategori:Neologismer
Flocc:Nīwesǣlendisce wrīteras	Kategori:Nyzeeländska författare
Flocc:Seaxland-Anhalt	Kategori:Sachsen-Anhalt
Flocc:Niðerseaxland	Kategori:Niedersachsen
Flocc:Russe	Kategori:Ryssar
Flocc:Unƿǣre lēode	Kategori:Fiktiva figurer
Flocc:Crēcisc ūtwitan	Kategori:Grekiska filosofer
Flocc:Sūþseaxe	Kategori:Sussex
Flocc:Bægwaraland	Kategori:Bayern
Flocc:Superman	Kategori:Stålmannen
Flocc:Ēage	Kategori:Ögat
Flocc:Corn	Kategori:Sädesslag
Flocc:Nīweoforwīcburg	Kategori:New York
Flocc:Norþfolc	Kategori:Norfolk
Flocc:Norþhāmtūnescīr	Kategori:Northamptonshire
Flocc:Snotingahāmscīr	Kategori:Nottinghamshire
Flocc:15e gēarhundred	Kategori:1400-talet
Flocc:Georgia (land)	Kategori:Georgien
Flocc:Cambodia	Kategori:Kambodja
Flocc:Americanisc sangeras	Kategori:Amerikanska sångare
Flocc:Bryttisce scopas	Kategori:Brittiska poeter
Flocc:Stǣr þæs Cynerices Greatbryttenes	Kategori:Storbritanniens historia
Flocc:Iamaica	Kategori:Jamaica
Bysen:Lang-hy	Mall:Lang-hy
Flocc:Scotta cyningas	Kategori:Skottlands regenter
Flocc:Bryttiscan Fæmne Īegland	Kategori:Brittiska Jungfruöarna
Flocc:Corēa	Kategori:Korea
Flocc:Burma	Kategori:Burma
Flocc:Taprabane	Kategori:Sri Lanka
Flocc:Tacgicastan	Kategori:Tadzjikistan
Flocc:Ēasttimor	Kategori:Östtimor
Flocc:Turcmenistan	Kategori:Turkmenistan
Flocc:Usbecastan	Kategori:Uzbekistan
Flocc:Geānedan Arabiscan Bregorīce	Kategori:Förenade Arabemiraten
Flocc:9e gēarhundred	Kategori:800-talet
Flocc:Sofiet Gesamnung	Kategori:Sovjetunionen
Flocc:Searwa stycce	Kategori:Teknikstubbar
Flocc:Wēalas	Kategori:Wales
Flocc:Blizzard Entertainment	Kategori:Blizzard Entertainment
Flocc:Foresittendas þāra Geāndena Rīca American	Kategori:USA:s presidenter
Flocc:Europisc stǣr	Kategori:Europas historia
Flocc:Hascemisce Cynerīce þæs Iordanes	Kategori:Jordanien
Flocc:Bosnia and Herzegovina	Kategori:Bosnien och Hercegovina
Flocc:Norþweg	Kategori:Norge
Flocc:Barbados	Kategori:Barbados
Flocc:Paraguay	Kategori:Paraguay
Flocc:Ficgiege	Kategori:Fiji
Flocc:Lēohtenstān	Kategori:Liechtenstein
Flocc:Uruguay	Kategori:Uruguay
Flocc:Andorra	Kategori:Andorra
Flocc:Serbia	Kategori:Serbien
Flocc:Ecuador	Kategori:Ecuador
Flocc:Peru	Kategori:Peru
Flocc:Bolifia	Kategori:Bolivia
Flocc:Albania	Kategori:Albanien
Flocc:Monaco	Kategori:Monaco
Flocc:Land on Norðamerican	Kategori:Nordamerikas länder
Flocc:Fiscas	Kategori:Fiskar
Flocc:Mūþ	Kategori:Munnen
Flocc:Wyrta	Kategori:Grönsaker
Flocc:Ofet	Kategori:Frukter
Flocc:Nīwu Gecȳþnes	Kategori:Nya Testamentet
Flocc:Musea	Kategori:Museer
Flocc:Rímcræft	Kategori:Funktioner
Flocc:Landscipas Swēolandes	Kategori:Sveriges län
Flocc:Stǣrlice Sprǣccræft	Kategori:Historisk lingvistik
Flocc:Dūnholmscīr	Kategori:Durham (grevskap)
Flocc:Manga	Kategori:Manga
Flocc:Eoferwicscīr	Kategori:Yorkshire
Flocc:Oferhæleðas	Kategori:Superhjältar
Flocc:Calpis	Kategori:Gibraltar
Flocc:Beadwe	Kategori:Slag
Flocc:Weorcendebyrdnessa	Kategori:Operativsystem
Flocc:Mexicorīce	Kategori:Mexikos delstater
Flocc:Hidalgo Rīce	Kategori:Hidalgo (delstat)
Flocc:Hetwaraland	Kategori:Hessen
Flocc:Canadan underrīce and landscipas	Kategori:Kanadas provinser och territorier
Flocc:Lunden	Kategori:London
Flocc:Lincolnscīr	Kategori:Lincolnshire
Bysen:Incubator	Mall:Incubator
Flocc:Dæg þæs gēares	Kategori:Datum
Flocc:Wikimedian geweorc	Kategori:Wikimedia
Flocc:Byrig on Buccingahamscīre	Kategori:Orter i Buckinghamshire
Flocc:Wiltūnscīr	Kategori:Wiltshire
Flocc:Wigreceastrescīr	Kategori:Worcestershire
Flocc:Americanisce Ingefeoht	Kategori:Amerikanska inbördeskriget
Flocc:Byrig on Tuscanie	Kategori:Orter i Toscana
Flocc:Wyrt	Kategori:Kryddväxter
Flocc:Dēor	Kategori:Djur
Flocc:Hweorfdēor	Kategori:Ryggradsdjur
Flocc:Pitcearnīega	Kategori:Pitcairn
Flocc:Cægman Īegland	Kategori:Caymanöarna
Flocc:Folcland Īegland	Kategori:Falklandsöarna
Flocc:Land on Sūðamerican	Kategori:Sydamerikas länder
Flocc:Colombia	Kategori:Colombia
Flocc:Anime	Kategori:Anime
Flocc:Oxnafordscīr	Kategori:Oxfordshire
Flocc:Heortfordscīr	Kategori:Hertfordshire
Flocc:Sicilia	Kategori:Sicilien
Flocc:Grantabrycgscīr	Kategori:Cambridgeshire
Flocc:Līþ	Kategori:Alkoholdrycker
Flocc:Spearctellas	Kategori:Spelkonsoler
Flocc:Englisc scīr	Kategori:Englands grevskap
Flocc:Æþelingas	Kategori:Prinsar
Flocc:Ceasterscīr	Kategori:Cheshire
Flocc:Sūþrige	Kategori:Surrey
Flocc:Defenascīr	Kategori:Devon
Flocc:Se Hlāford þāra Hringa	Kategori:Sagan om ringen
Flocc:Rōmāniscu Folclār	Kategori:Romersk mytologi
Flocc:Beadanfordscīr	Kategori:Bedfordshire
Flocc:Bergan	Kategori:Bär
Flocc:Bēor	Kategori:Öl
Flocc:Sang	Kategori:Sånger
Flocc:Hēafodstōlas	Kategori:Huvudstäder
Flocc:Byrig on Paraguay	Kategori:Orter i Paraguay
Flocc:Ēastseaxe	Kategori:Essex
Flocc:Middelasia	Kategori:Centralasien
Flocc:NFL	Kategori:National Football League
Flocc:Tuscania	Kategori:Toscana
Flocc:Latium	Kategori:Lazio
Flocc:Lonceasterscīr	Kategori:Lancashire
Flocc:Hāmtūnescīr	Kategori:Hampshire
Flocc:Brūcend pl	Kategori:Användare pl
Flocc:Gleawcesterscīr	Kategori:Gloucestershire
Flocc:Rōmānisca sprǣca	Kategori:Romanska språk
Flocc:Fōr	Kategori:Transport
Flocc:Sund	Kategori:Simning
Flocc:Hēapplegan	Kategori:Lagsport
Flocc:Toys	Kategori:Leksaker
Flocc:Hīwscipe	Kategori:Familjeliv
Flocc:Cornweall	Kategori:Cornwall
Flocc:Cīna Caseras	Kategori:Kinesiska kejsare
Flocc:Antarctica	Kategori:Antarktis
Flocc:Norðamerica	Kategori:Nordamerika
Flocc:Sangestre	Kategori:Sångare
Flocc:Euxinus	Kategori:Svarta havet
Flocc:Meras	Kategori:Insjöar
Bysen:Flagcountry	Mall:Flaggbild2
Bysen:Country data Weimar Republic	Mall:Landsdata Weimarrepubliken
Flocc:Sweartbeorg	Kategori:Montenegro
Flocc:Indisc Gārsecg	Kategori:Indiska oceanen
Flocc:Wægnas	Kategori:Bilar
Bysen:Brūcend af-2	Mall:Användare af-2
Wealhmoru	Morot
Flocc:Byrig on Francum	Kategori:Orter i Frankrike
Flocc:Cent	Kategori:Kent
Flocc:Byrig on þǣm Ucrægnan	Kategori:Orter i Ukraina
Flocc:Byrig on Eotolwarum	Kategori:Orter i Italien
Flocc:Beorgas on Brettum	Kategori:Berg i Storbritannien
Flocc:Scotland	Kategori:Skottland
Flocc:Spēonisc bōccræft	Kategori:Spansk litteratur
Flocc:Hēafodstōlas in Europe	Kategori:Europas huvudstäder
Flocc:Hēafodstōlas in Asie	Kategori:Asiens huvudstäder
Flocc:Norðerne Īrland	Kategori:Nordirland
Flocc:Īrisc bōccræft	Kategori:Irländsk litteratur
Flocc:Geāsparedu līc	Kategori:Mumier
Flocc:Wendelsǣ	Kategori:Medelhavet
Flocc:Byrig on Cile	Kategori:Orter i Chile
Flocc:Byrig on Īrum	Kategori:Orter i Irland
Bysen:Wikia	Mall:Wikia
Bysen:Rounddown	Mall:Avrunda ned
Flocc:Loidis	Kategori:Leeds
Flocc:Australisc Hēafodburg Landscipe	Kategori:Australian Capital Territory
Bysen:Country data Cænada	Mall:Landsdata Kanada
Bysen:Color box	Mall:Färgbox
Flocc:Cyþþubox	Kategori:Stående navigationsrutor
Bysen:Flag	Mall:Flagga
Bysen:Country data Barbados	Mall:Landsdata Barbados
Bysen:Country data Empire of Japan	Mall:Landsdata Japanska imperiet
Bysen:Country data Free French	Mall:Landsdata Fria franska styrkorna
Bysen:Country data Martinique	Mall:Landsdata Martinique
Bysen:Country data Åland Islands	Mall:Landsdata Åland
Bysen:Lang-pl	Mall:Lang-pl
Flocc:Flæmingaland	Kategori:Flandern
Flocc:Byrig on Difelinscīre	Kategori:Orter i Dublin
Trojany (Masovian Voivodship)	Trojany
Flocc:Willelm Shakespeare	Kategori:Shakespeare
Flocc:Byrig þāra Faroiscan Īegena	Kategori:Orter på Färöarna
Flocc:Sigelhearwena Cāseras	Kategori:Etiopiens kungligheter
Flocc:Land on Asie	Kategori:Asiens länder
Flocc:Windows gamen	Kategori:Windows-spel
Bysen:Dispute-resolution	Mall:Konflikthantering
Bysen:Landskap	Mall:Sveriges landskap
Flocc:Wicibōceras in þǣm Geānlǣhtum Rīcum American	Kategori:Användare USA
Bysen:Plegere-stycce	Mall:Skådespelarstub
Bysen:Nigerie Rīce	Mall:Nigerias delstater
Bysen:Brūcend la	Mall:Användare la
Bysen:Brūcend it-4	Mall:Användare it-4
Bysen:Brūcend is-3	Mall:Användare is-3
Bysen:Brūcend fo-2	Mall:Användare fo-2
Bysen:Brūcend fo	Mall:Användare fo
Bysen:Brūcend ang	Mall:Användare ang
Bysen:Lang-ty	Mall:Lang-ty
Bysen:Lang-sq	Mall:Lang-al
Bysen:Lang-ro	Mall:Lang-ro
Bysen:Lang-kl	Mall:Lang-kl
Bysen:Lang-es	Mall:Lang-es
Bysen:Lang-cy	Mall:Lang-cy
Bysen:Lang-bn	Mall:Lang-bn
Flocc:Westmidlandscīr	Kategori:West Midlands (storstadsområde)
Flocc:Wæringscīr	Kategori:Warwickshire
Flocc:Wīcinga Ieldu	Kategori:Vikingatiden
Wikipǣdia:Gecorene gemynddagas/Wēodmōnaþ	Wikipedia:Dagens händelser/Augusti
Flocc:Quebec	Kategori:Quebec
Flocc:Bryttisce ofersǣ landscipas	Kategori:Storbritanniens avhängiga territorier
Flocc:Ostsǣ	Kategori:Östersjön
Flocc:Bysen Brūcend Box	Kategori:Användarrutor
Flocc:Dēaþstīele glīwdrēame clīwene	Kategori:Death metal-grupper
Flocc:Gūþ	Kategori:Krig
Flocc:Lēoðlic scātung	Kategori:Konståkning
Bysen:Lang-zh	Mall:Zh
Bysen:Lang-mn	Mall:Lang-mn
Bysen:Lang-sv	Mall:Lang-sv
Flocc:Frencisc Polynesia	Kategori:Franska Polynesien
Flocc:Germanisca sprǣca	Kategori:Germanska språk
Bysen:Precision1	Mall:Precision1
Bysen:Precision/tz	Mall:Precision/tz
Flocc:Herefordscīr	Kategori:Herefordshire
Flocc:Rōmānisc stǣr	Kategori:Roms historia
Flocc:Īshocig	Kategori:Ishockey
Wikipǣdia:Edit conflicts	Wikipedia:Redigeringskonflikt
Flocc:Īrland	Kategori:Ön Irland
Flocc:Constantinopolis	Kategori:Istanbul
Wikipǣdia:Page history	Wikipedia:Versionshistorik
Flocc:Mintan	Kategori:Lamiaceae
Flocc:Lægreceastrescīr	Kategori:Leicestershire
Flocc:Langbeardnaland	Kategori:Lombardiet
Wikipǣdia:Sundortácnu	Wikipedia:Specialtecken
Flocc:Rōm	Kategori:Rom
Flocc:Norþhymbraland	Kategori:Northumberland
Flocc:Roteland	Kategori:Rutland
Flocc:Hjaltland	Kategori:Shetlandsöarna
Flocc:Scipu	Kategori:Fartyg
Flocc:Scrobbesbyrigscīr	Kategori:Shropshire
Flocc:Byrig on Gleawcesterscīre	Kategori:Orter i Gloucestershire
Flocc:Napoleon I Francena Casere	Kategori:Napoleon
Flocc:NHL	Kategori:National Hockey League
Flocc:Byrig on Nīwum Hāmtūnscīre	Kategori:Orter i New Hampshire
Flocc:Byrig on Dūnholmscīre	Kategori:Orter i Durham
Flocc:Byrig on Dēorabyscīre	Kategori:Orter i Derbyshire
Flocc:Byrig on Defenum	Kategori:Orter i Devon
Flocc:Byrig on Lonceasterscīre	Kategori:Orter i Lancashire
Flocc:Americanisc fōtball	Kategori:Amerikansk fotboll
Flocc:Stæffordscīr	Kategori:Staffordshire
Flocc:Bermuda	Kategori:Bermuda
Flocc:Bearrucscīr	Kategori:Berkshire
Flocc:Byrig on Bearrucscīre	Kategori:Orter i Berkshire
Flocc:Norþgermanisca sprǣca	Kategori:Nordiska språk
Flocc:São Paulo	Kategori:São Paulo
Flocc:Ucrægnisc sprǣc	Kategori:Ukrainska
Flocc:Byrig on Sūþrigum	Kategori:Orter i Surrey
Flocc:Byrig on Grantabrycgscīre	Kategori:Orter i Cambridgeshire
Flocc:Byrig on Cornweallum	Kategori:Orter i Cornwall
Flocc:Byrig on Cent	Kategori:Orter i Kent
Flocc:Byrig on Oxnafordscīre	Kategori:Orter i Oxfordshire
Flocc:Byrig on Westmidlandscīre	Kategori:Orter i West Midlands (storstadsområde)
Flocc:Dȳfung	Kategori:Dykning
Flocc:Byrig on Scrobbesbyrigscīre	Kategori:Orter i Shropshire
Flocc:Byrig on Stæffordscīre	Kategori:Orter i Staffordshire
Flocc:Byrig on Wigreceastrescīre	Kategori:Orter i Worcestershire
Flocc:Byrig on Wæringscīre	Kategori:Orter i Warwickshire
Flocc:Byrig on Wiltūnscīre	Kategori:Orter i Wiltshire
Flocc:Celtisc sprǣc	Kategori:Keltiska språk
Flocc:Coritiba Foot Ball Club	Kategori:Coritiba Foot Ball Club
Flocc:Landscipas Denemearce	Kategori:Halvöar i Danmark
Flocc:Wendelsǣs īega	Kategori:Öar i Medelhavet
Flocc:Orcanege	Kategori:Orkneyöarna
Flocc:Byrig on Brasile	Kategori:Orter i Brasilien
Flocc:Byrig on Ēastseaxum	Kategori:Orter i East Sussex
Flocc:Byrig on Polum	Kategori:Orter i Polen
Flocc:Tūnas on Mageoscīre	Kategori:Orter i Mayo
Flocc:Gyldfōtþōðres styccelicu gewritu	Kategori:Fotbollsstubbar
Flocc:Byrig	Kategori:Städer
Flocc:Brūcend fo-3	Kategori:Användare fo-3
Flocc:Lēode ȝehered in Ƿælhealle Heriȝe	Kategori:Walhalla
Flocc:Middelseaxe	Kategori:Middlesex
Bysen:Year in other calendars	Mall:Andra tideräkningar
Flocc:Brūcend en-1	Kategori:Användare en-1
Flocc:Geboren in 1946	Kategori:Födda 1946
Flocc:Brūcend de-1	Kategori:Användare de-1
Flocc:Geboren in 1920	Kategori:Födda 1920
Flocc:Germanisc mægþ	Kategori:Germaner
Flocc:Īrisce Scīre	Kategori:Irländska grevskap
Flocc:Skrælingcynn	Kategori:Indianer
Bysen:Virginia	Mall:Virginia
Bysen:Kylie Minogue	Mall:Kylie Minogue
Wikipǣdia:Gecorene gemynddagas/Sēremōnaþ	Wikipedia:Dagens händelser/Juni
Wikipǣdia:Gecorene gemynddagas/Æfterra Gēola	Wikipedia:Dagens händelser/Januari
Wikipǣdia:Gecorene gemynddagas/Hrēþmōnaþ	Wikipedia:Dagens händelser/Mars
Wikipǣdia:Gecorene gemynddagas/Þrimilcemōnaþ	Wikipedia:Dagens händelser/Maj
Wikipǣdia:Tutorial (Related site links)	Wikipedia:Kom ihåg
Bysen:Start date	Mall:Startdatum
Wikipǣdia:10 þing þe þu nāst ymbe Wicipǣdian	Wikipedia:10 saker du kanske inte visste om Wikipedia
Bysen:Brūcend cy-0	Mall:Användare cy-0
Bysen:Brūcend ang-2	Mall:Användare ang-2
Bysen:Brūcend ang-1	Mall:Användare ang-1
Bysen:Brūcend ang-3	Mall:Användare ang-3
Bysen:Italy-hist-stub	Mall:Historiestub-Italien
Bysen:Lang-kw	Mall:Lang-kw
Bysen:Eald-Rōm-stycce	Mall:Romstub
Bysen:Lang-sco	Mall:Lang-sco
Swǣfe	Schwaben
Wikipǣdia:Templates	Wikipedia:Mallar
Wikipǣdia:Deletion log	Wikipedia:Borttagningslogg
Hindberge	Hallon
Bysen:End	Mall:Avsluta
Bysen:Ice hockey team roster	Mall:Ishockey laguppställning
Bysen:Country flagairforce	Mall:Flygvapen/core
Þyrscrūc	Trollkors
Lorde	Lorde
Georgius Grantanbrycge Æþeling	Prins George av Cambridge
Scif-castenere	Byrå (möbel)
Module:Yesno	Modul:Yesno
Module:Arguments	Modul:Arguments
Syndrig:RecentChanges	Special:Senaste ändringar
Flocc:Byrig on Langbeardum	Kategori:Orter i Lombardiet
Flocc:Gestorfen in 1975	Kategori:Avlidna 1975
