Hĭ-ciŭ	Afrika
Nĭk-buōng	Japan
Nàng Mī-ciŭ	Sydamerika
Nò̤-ŭi	Norge
Ĭng-gáik-làng	England
Sŭ-gáik-làng	Skottland
Ŭi-ī-sê̤ṳ	Wales
Báe̤k Ái-ī-làng	Nordirland
Ái-ī-làng	Irland
Hungary	Ungern
Să̤-băng-ngà	Spanien
Mī-guók	USA
Bī-lé-sì	Belgien
Luxembourg	Luxemburg
Ṳ̄-dêu	Universum
Dê-giù	Jorden
Sĕng-mêng	Liv
Sī	Döden
Nè̤ng	Människa
Huăng-hī	Lycka
George Washington	George Washington
Wikidata	Wikidata
Hŭng-làng	Finland
Sôi-diēng	Sverige
Dăng-măk	Danmark
Pŏ̤-làng	Polen
Lithuania	Litauen
É-dâi-lé	Italien
Sô̤i-sê̤ṳ	Schweiz
Ó̤-dê-lé	Österrike
Hĭ-lé-nà̤	Grekland
Tū-ī-gì	Turkiet
Bì-ciū	Öl
Può-dò̤-ngà	Portugal
Ĕu-ciŭ	Europa
Ā-ciŭ	Asien
Báe̤k Mī-ciŭ	Nordamerika
Nàng-gĭk-ciŭ	Antarktis
Wikipedia	Wikipedia
Hò̤-làng	Nederländerna
Ĭng-gĕng	Penis
PHP	PHP
Niū-iók-chê	New York
Washington, D.C.	Washington, D.C.
Gô-gĭng-săng	San Francisco
Báik-lìng	Berlin
Los Angeles	Los Angeles
Diêng-nō̤	Dator
Sŭ-là̤-sié	Zürich
Barack Obama	Barack Obama
Uruguay	Uruguay
MediaWiki	Mediawiki
Lùng-dŭng	London
Bìng-guō	Äpple
Bă-là̤	Paris
Mĕ̤k-să̤-gŏ̤	Mexiko
Dâi-să̤-iòng	Atlanten
Tái-bìng-iòng	Stilla havet
California	Kalifornien
Boston	Boston
Lā̤-bái-ék	Måndag
Huōi-sĭng	Mars (planet)
Kenya	Kenya
Ethiopia	Etiopien
Gŭng-ciō (nguòng-siū)	Monark
Ghana	Ghana
Lā̤-bái-nê	Tisdag
Lā̤-bái-săng	Onsdag
Lā̤-bái-sé	Torsdag
Lā̤-bái-ngô	Fredag
Lā̤-bái-lĕ̤k	Lördag
Lā̤-bái-nĭk	Söndag
Săi (mà-kuŏ dông-ŭk)	Lejon
Huák-guók	Frankrike
Kēng	Hund
Ĭng-guók	Storbritannien
Mà	Katt
Dṳ̆ng-huà Ìng-mìng Gê̤ṳng-huò-guók	Kina
Huák-ngṳ̄	Franska
Wiktionary	Wiktionary
Ngṳ̀	Fiskar
Ciū	Alkoholdryck
Bă-să̤	Brasilien
Ngò̤-lò̤-sṳ̆	Ryssland
Hāi	Hav
Alabama	Alabama
Wikimedia	Wikimedia Foundation
Jimmy Wales	Jimmy Wales
Dáik-guók	Tyskland
Belarus	Vitryssland
Dáik-ngṳ̄	Tyska
Bĭng-dō̤	Island
Estonia	Estland
Tū-sĭng	Saturnus
Hĭ-gĭ	Flygplan
Ciéng-cĕng	Krig
1	1 (tal)
2	2 (tal)
3	3 (tal)
4	4 (tal)
5	5 (tal)
0	0 (tal)
George W. Bush	George W. Bush
Latvia	Lettland
Ukraine	Ukraina
Ciék-káik	Tjeckien
Slovakia	Slovakien
Slovenia	Slovenien
Moldova	Moldavien
Romania	Rumänien
Bulgaria	Bulgarien
Lò̤-mā	Rom
Macedonia Gê̤ṳng-huò-guók	Makedonien
Albania	Albanien
Croatia	Kroatien
Bosnia gâe̤ng Herzegovina	Bosnien och Hercegovina
Azerbaijan	Azerbajdzjan
Andorra	Andorra
Cyprus	Cypern
Georgia (guók-gă)	Georgien
Kazakhstan	Kazakstan
Malta	Malta
Monaco	Monaco
Montenegro	Montenegro
Vaticano	Vatikanstaten
San Marino	San Marino
Gū-bă	Kuba
Belize	Belize
Barbados	Barbados
Java	Java (programspråk)
Éng-dô-nà̤-să̤-ā	Indonesien
Tū-ī-gì-ngṳ̄	Turkiska
Nàng-hĭ	Sydafrika
Algeria	Algeriet
Wiki Dù-cṳ̆-guāng	Wikisource
Uzbekistan	Uzbekistan
Huà-să	Warszawa
Può-dò̤-ciū	Vin
Cūi	Vatten
Chà	Trä
Diêng-sê	Television
Chile	Chile
Ià-sŭ	Jesus
Galileo Galilei	Galileo Galilei
Cūi-sĭng	Merkurius
Lĭk-sṳ̄	Historia
Gĭng-sĭng	Venus
Ngṳ̄-ngiòng	Språk
Ái	Kärlek
Mŭk-sĭng	Jupiter
Ngṳ̀ng-ò̤	Vintergatan
Tiĕng-uòng-sĭng	Uranus
Hāi-uòng-sĭng	Neptunus
Tiĕng-ùng	Astronomi
Sĭng-gă-pŏ̤	Singapore
Kuŏ-hŏk	Vetenskap
Mìng-uòng-sĭng	Pluto
Ciŏng-lài	Framtid
Séng-mū Mā-lé-ā	Jungfru Maria
Liechtenstein	Liechtenstein
Adolf Hitler	Adolf Hitler
Dâ̤-nê-ché̤ṳ Sié-gái Dâi-ciéng	Andra världskriget
Wiki Gáu-kuŏ-cṳ̆	Wikibooks
Wiki Ngṳ̄-liŏh	Wikiquote
Wiki Dâi-hŏk	Wikiversity
Cṳ̆ng	Ur
Ubuntu	Ubuntu
Linux	Linux
Só-hŏk	Matematik
Lá-dĭng-ngṳ̄	Latin
Bahrain	Bahrain
Armenia	Armenien
Serbia	Serbien
Nguŏk-giù	Månen
Istanbul	Istanbul
Ó̤-ciŭ	Australien
Ŭk-lī	Fysik
Argentina	Argentina
Peru	Peru
Dièu-siēng Mìng-ciō-ciō-ngiê Ìng-mìng Gê̤ṳng-huò-guók	Nordkorea
Gāng-puŏ-câi	Kambodja
Gū-làng-gĭng	Koranen
Kṳ̄ng-lṳ̀ng	Dinosaurier
Ĭ-sṳ̆-làng-gáu	Islam
Lì	Päronsläktet
Lùng-lùng	Hjul
Huò-bìng	Fred
Nṳ̄-gái	Kvinna
Gū-chiŏng-kĕ̤ng	Analöppning
Nìng-mùng	Citron
Bă-ciĕu	Banan
Huă	Blomma
Napoléon Bonaparte	Napoleon I
Sĕng-lī	Fysiologi
Hèng-sĭng	Stjärna
Nĭk-tàu	Solen
Victor Hugo	Victor Hugo
Dâi-iòng-ciŭ	Oceanien
Tái-iòng-hiê	Solsystemet
Ngāi	Tänder
Kĭng	Väte
Wiki Gê̤ṳng-hiōng	Wikimedia Commons
Cṳ̆	Bok
Nĭk	Dygn
Dĕ̤ng Timor	Östtimor
Màng-buŏ	Natt
Nièng	År
Ó̤-sṳ̆-lṳ̆k	Oslo
Lī-sṳ̆-buōng	Lissabon
Táng	Kol
Dâng	Kväve
Iōng	Syre
Giàng-sĭng	Planet
Kleopatra 7-sié	Kleopatra VII av Egypten
Ĭng-ngŏk	Musik
É-dâi-lé-ngṳ̄	Italienska
Séng Peterburg	Sankt Petersburg
Chad	Tchad
Lé̤ṳ	Aluminium
Sĭng-să̤-làng	Nya Zeeland
Éng-dô	Indien
Tuvalu	Tuvalu
Tiék	Järn
Tonga	Tonga
Samoa	Samoa
Solomon Gùng-dō̤	Salomonöarna
Vanuatu	Vanuatu
Papua New Guinea	Papua Nya Guinea
William Shakespeare	William Shakespeare
Palau	Palau
Nauru	Nauru
Micronesia Lièng-băng	Mikronesiens federerade stater
Iòng (gĭng-sṳ̆k)	Bly
Marshall Gùng-dō̤	Marshallöarna
Kiribati	Kiribati
Mūng-gū	Mongoliet
Fiji	Fiji
Venezuela	Venezuela
Guók-cié chiông-gì	Schack
Genghis Khan	Djingis khan
Maine	Maine
Mā	Häst
Ū-ké	Vapen
Dông-ŭk	Djur
Suriname	Surinam
Paraguay	Paraguay
Guyana	Guyana
Ecuador	Ecuador
Colombia	Colombia
Hŭk-gáu	Buddhism
Bolivia	Bolivia
Dè̤ng	Koppar
Trinidad gâe̤ng Tobago	Trinidad och Tobago
Sĭk-ŭk	Växt
Séng Vincent gâe̤ng Grenadines	Saint Vincent och Grenadinerna
New Hampshire	New Hampshire
Séng Lucia	Saint Lucia
Séng Kitts gâe̤ng Nevis	Saint Kitts och Nevis
Cĭng-kṳ̄ng	Svampar
Jamaica	Jamaica
Grenada	Grenada
Massachusetts	Massachusetts
Guatemala	Guatemala
Bahamas	Bahamas
Connecticut	Connecticut
Giĕ	Tamhöna
Antigua gâe̤ng Barbuda	Antigua och Barbuda
Hawaii	Hawaii
Honduras	Honduras
Dominica	Dominica
Dominica Gê̤ṳng-huò-guók	Dominikanska republiken
Dṳ̆	Gris
Báe̤k-bĭng-iòng	Norra ishavet
Haiti	Haiti
El Salvador	El Salvador
Ĭ-lāng	Iran
Iraq	Irak
Alaska	Alaska
Costa Rica	Costa Rica
Ī-sáik-liĕk	Israel
Panama	Panama
Yemen	Jemen
Bâng-dŭk	Virus
Pŏ̤-làng-ngṳ̄	Polska
Jordan	Jordanien
Nicaragua	Nicaragua
Florida	Florida
Kyrgyzstan	Kirgizistan
Arizona	Arizona
Kuwait	Kuwait
Lō̤-kuŏ	Laos
Lebanon	Libanon
Oregon	Oregon
Maldives	Maldiverna
Mī-ciŭ	Amerika
Utah	Utah
Ngù	Nötkreatur
Mā-lài-să̤-ā	Malaysia
Miēng-diêng	Burma
Nepal	Nepal
Oman	Oman
Pakistan	Pakistan
Qatar	Qatar
Saudi Ā-lá-báik	Saudiarabien
Sri Lanka	Sri Lanka
Joseph Stalin	Josef Stalin
Syria	Syrien
Platon	Platon
Tajikistan	Tadzjikistan
Dṳ̆ng-huà Mìng-guók	Taiwan
Aristoteles	Aristoteles
Tái-guók	Thailand
Huōi-chiă	Tåg
Turkmenistan	Turkmenistan
Ā-lá-báik Lièng-hăk Dâi-gŭng-guók	Förenade Arabemiraten
Băh-gĭng	Platina
Uŏk-nàng	Vietnam
Dâi-hàng Mìng-guók	Sydkorea
Afghanistan	Afghanistan
Gĭng	Guld
Suez Ông-ò̤	Suezkanalen
Bangladesh	Bangladesh
Mali	Mali
Sokrates	Sokrates
Angola	Angola
Bhutan	Bhutan
Ùng-lài	Brunei
Tanzania	Tanzania
Cūi-ngṳ̀ng	Kvicksilver
Hĭ-lĭ-pĭng	Filippinerna
Dṳ̆ng-hĭ Gê̤ṳng-huò-guók	Centralafrikanska republiken
Isaac Newton	Isaac Newton
Albert Einstein	Albert Einstein
Uòng-sáik	Gul
Togo	Togo
Tunisia	Tunisien
Zambia	Zambia
Zimbabwe	Zimbabwe
Báe̤k-gĭng	Peking
Nàng Sudan	Sydsudan
Benin	Benin
Botswana	Botswana
Wiki Sĭng-ùng	Wikinews
Burkina Faso	Burkina Faso
Burundi	Burundi
Comoros	Komorerna
Congo Gê̤ṳng-huò-guók	Kongo-Brazzaville
Congo Mìng-ciō Gê̤ṳng-huò-guók	Kongo-Kinshasa
Djibouti	Djibouti
Chiáh-dô̤ Guinea	Ekvatorialguinea
Eritrea	Eritrea
Gabon	Gabon
Gambia	Gambia
Guinea	Guinea
Guinea-Bissau	Guinea-Bissau
Côte d'Ivoire	Elfenbenskusten
Cameroon	Kamerun
Cabo Verde	Kap Verde
Lesotho	Lesotho
Liberia	Liberia
Libya	Libyen
Madagascar	Madagaskar
Malawi	Malawi
Mauritania	Mauretanien
Mauritius	Mauritius
Morocco	Marocko
Mozambique	Moçambique
Namibia	Namibia
Niger	Niger
Nigeria	Nigeria
Charles Darwin	Charles Darwin
Uganda	Uganda
Rwanda	Rwanda
Séng Tomé gâe̤ng Príncipe	São Tomé och Príncipe
Senegal	Senegal
Seychelles	Seychellerna
Carl Linnaeus	Carl von Linné
Sierra Leone	Sierra Leone
Somalia	Somalia
Julius Caesar	Julius Caesar
Sudan	Sudan
Swaziland	Swaziland
Kê̤ṳng	Regnbåge
Lièng-hăk-guók	Förenta nationerna
Dê-cék	Geologi
Dê-lī	Geografi
Sĭng-câung	Hjärta
Puòi-hŭ	Hud
Ngàng-sáik	Färg
Làng-sáik	Blå
Ngṳ̀ng	Silver
Sék	Tenn
Michigan	Michigan
Illinois	Illinois
North Dakota	North Dakota
South Dakota	South Dakota
Montana	Montana
Wyoming	Wyoming
Idaho	Idaho
Washington	Washington (delstat)
Nevada	Nevada
Éng-dô-iòng	Indiska oceanen
Kosovo	Kosovo
Colorado	Colorado
分類:Hŭng-lôi	Kategori:Topp
Chicago	Chicago
Dĕ̤ng-tiĕng	Vinter
Chŭng-tiĕng	Vår
Hâ-tiĕng	Sommar
Chiŭ-tiĕng	Höst
Saddam Hussein	Saddam Hussein
Osama bin Laden	Usama bin Ladin
Să̤-băng-ngà-ngṳ̄	Spanska
Philadelphia	Philadelphia
Tĭ-tṳ̆	Spindlar
Guō-sĭk	Frukt
Cièng	Pengar
Virginia	Virginia
West Virginia	West Virginia
Huăng-ciĕu	Spanskpeppar
Niū-iók-ciŭ	New York (delstat)
Rhode Island	Rhode Island
Kŏng-tṳ̀ng	Insekter
Maryland	Maryland
Delaware	Delaware
Vladimir Lenin	Vladimir Lenin
Ohio	Ohio
Pennsylvania	Pennsylvania
Augustus	Augustus
Microsoft Windows	Microsoft Windows
New Jersey	New Jersey
Hŭng-làng-ngṳ̄	Finska
Indiana	Indiana
Ké-chiă	Bil
Georgia	Georgia
Texas	Texas
North Carolina	North Carolina
South Carolina	South Carolina
Manila	Manila
Dĕ̤ng-gĭng	Tokyo prefektur
Uòng-lì	Ananas
Mississippi	Mississippi
Tennessee	Tennessee
New Mexico	New Mexico
Ngà-diēng	Aten
Minnesota	Minnesota
Baghdad	Bagdad
Wisconsin	Wisconsin
Iowa	Iowa
Nebraska	Nebraska
Kansas	Kansas
Hŏng-giāng	Cigarett
Missouri	Missouri
Louisiana	Louisiana
Kentucky	Kentucky
Arkansas	Arkansas
Oklahoma	Oklahoma
Madonna	Madonna (artist)
Aceh	Aceh
Séng-gĭng	Bibeln
Phnom Penh	Phnom Penh
Hù Cé-mìng Chê	Ho Chi Minh-staden
Ò̤-nô̤i	Hanoi
Cĭng Ià-sŭ Gáu-huôi	The True Jesus Church
Ĭng-ngṳ̄	Engelska
Màng-gók	Bangkok
Kuala Lumpur	Kuala Lumpur
Bangka Belitung Gùng-dō̤	Bangka-Belitung
Dài-báe̤k	Taipei
Concepción	Concepción, Chile
Bengkulu	Bengkulu (provins)
Końskowola	Końskowola
Nê-iōng-huá-táng	Koldioxid
Jambi	Jambi (provins)
Siè	Ormar
Lampung	Lampung
Guŏng-sók	Ljusets hastighet
Riau	Riau
Riau Gùng-dō̤	Kepulauan Riau
Nàng Sumatra	Sumatera Selatan
Lò̤-mā Dá̤-guók	Romerska kejsardömet
Mì-niōng	Microsoft
Kó-lū-hŭ	Kurów
Huá-hŏk	Kemi
Sièng-sŏng	Saltsyra
Ôi-sĭng	Måne
Kă-giù	Fotboll
Să̤ Sumatra	Sumatera Barat
Mā-dáik-lī	Madrid
Michael Jackson	Michael Jackson
Cê̤ṳ-iù	Frihet
Cṳ̆-niòng-giāng	Flicka
Sék-nà̤	Sydney
Liŏh-sáik	Grön
È̤ng-sáik	Röd
Huōi	Eld
Sĭng Nàng Wales	New South Wales
Nile Ò̤	Nilen
Banten	Banten
Dṳ̆ng Jawa	Jawa Tengah
Chēng-chiū-sĭng	Komet
Dĕ̤ng Jawa	Jawa Timur
Jakarta	Jakarta
Ăng-kā-lá	Ankara
Să̤ Jawa	Jawa Barat
Yogyakarta	Yogyakarta (region)
Dṳ̆ng Kalimantan	Kalimantan Tengah
Dĕ̤ng Kalimantan	Kalimantan Timur
Nàng Kalimantan	Kalimantan Selatan
Hŏk-hâu	Skola
Să̤ Kalimantan	Kalimantan Barat
Dâi-hŏk	Universitet
Wikipedia:Să-buàng	Wikipedia:Sandlådan
Chió	Hus
Dê-dù	Karta
Ò̤	Flod
Osasco	Osasco
Chiĕng-lī-giáng	Teleskop
分類:Dài-uăng lĭk-sṳ̄	Kategori:Taiwans historia
Curitiba	Curitiba
Sĕng-lìng	Skog
分類:Uŏk-nàng lĭk-sṳ̄	Kategori:Vietnams historia
Iók-báik-cṳ̆	Job
Cĭng-ngiòng	Ordspråksboken
Kūng-cṳ̄	Konfucius
Hà	Tiofotade kräftdjur
分類:Só-hŏk	Kategori:Matematik
Bali	Bali
Ĕu-nguòng	Euro
Mī-gĭng	Amerikansk dollar
Dâi-lièu	Liaodynastin
Hòng-ciŭ	Hangzhou
Gĭ-dók-gáu	Kristendom
Dĕ̤ng Nusa Tenggara	Nusa Tenggara Timur
Să̤ Nusa Tenggara	Nusa Tenggara Barat
Dṳ̆ng Sulawesi	Sulawesi Tengah
Gĭng-guók	Jindynastin (1115–1234)
Gorontalo	Gorontalo (provins)
Báe̤k Sulawesi	Sulawesi Utara
Dĕ̤ng-nàng Sulawesi	Sulawesi Tenggara
Nàng Sulawesi	Sulawesi Selatan
Să̤ Sulawesi	Sulawesi Barat
Seattle	Seattle
Dêu	Ris
Maluku	Moluckerna (provins)
Báe̤k Maluku	Maluku Utara
Papua	Papua
Să̤ Papua	Papua Barat
Cēu	Fåglar
Siū-dŭ	Huvudstad
Può-dò̤-ngà-ngṳ̄	Portugisiska
Nguŏk	Månad
Uòng Hiêng-huàng	Huang Xianfan
Cōng	Diamant
Nĭk-buōng-ngṳ̄	Japanska
Báik-kuŏ-ciòng-cṳ̆	Uppslagsverk
Tàu Hiĕk	Portal:Huvudsida
模板:Ô-lī-kó̤	Mall:Bra
Saratov	Saratov
Làng-giù	Basket
Olympic Ông-dông-huôi	Olympiska spelen
Diòng-gĕ̤ng	Yangtze
Che Guevara	Che Guevara
Mò̤ Dĕk-dŭng	Mao Zedong
Să̤-ăng	Xi'an
Lá-sák	Lhasa
Séng-gău	Samlag
Ĭng-dô̤	Slida
Diék-hŏk	Filosofi
分類:Ché̤ṳk-káik chēng-dṳ̀	Kategori:Snabbraderingar
Gáung-kìng	Piano
Dà	Te
Marco Polo	Marco Polo
Hebe Camargo	Hebe Camargo
Gê̤ṳng-sāng-ciō-ngiê	Kommunism
Cṳ̆-buōng-ciō-ngiê	Kapitalism
Guók-gă	Land
Mìng-cŭk	Nation
Carthago	Karthago
Uōng-hiĕk liù-lāng-ké	Webbläsare
Siù-cūi	Simning
分類:Tiĕng-ùng	Kategori:Astronomi
Hŭk	Buddha (titel)
Lī Bĕk	Li Bai
Dù-cṳ̆-guāng	Bibliotek
Sĕng-tái	Ekologi
Céng-dê	Politik
Mìng-ciō	Demokrati
Cìng-dièu	Qindynastin
Nobel Ciōng	Nobelpriset
Cìng Sṳ̄-huòng	Qin Shi Huangdi
Dṳ̆ng-dĕ̤ng	Mellanöstern
Háng-dièu	Handynastin
Làu Băng	Liu Bang
Háng Ùng-dá̤	Han Wendi
Háng Gīng-dá̤	Han Jingdi
Háng Ū-dá̤	Han Wudi
Sĕng-ŭk	Organism
Rabindranath Tagore	Rabindranath Tagore
Háng Guŏng-ū-dá̤	Han Guangwudi
Gŭng-ciō-cié-dô	Monarki
Siâ-huôi-ciō-ngiê	Socialism
Cṳ̆ng-chói	Kyss
Nguòng-dièu	Yuandynastin
Nazi Dáik-guók	Nazityskland
Christopher Columbus	Christofer Columbus
Dâng Huò	Zheng He
Panama Ông-ò̤	Panamakanalen
Céng-dièu	Jindynastin (265–420)
Nàng-bĭng-iòng	Antarktiska oceanen
Uòng-ò̤	Gula floden
Sṳ̆-mā Ièng	Sima Yan
Ngê	Öra
Pé	Nos
Mĕ̤k-ciŭ	Öga
Hŭng-muòng	Stickmyggor
Săi-ngṳ̀	Hajar
Lŏk-dò̤	Kameler
Mā-ngiê	Myror
Sùi-dièu	Suidynastin
Hò̤-làng-ngṳ̄	Nederländska
Să̤-hâ	Xixia
Sóng-dièu	Songdynastin
Diêu Kuŏng-êng	Song Taizu
Sóng Hŭi-cŭng	Song Huizong
Ögedei	Ögedei
Möngke	Möngke
Kublai	Khubilai khan
Huă-chái	Blomkål
Giò (sĭk-ŭk)	Aubergine
Siók	Snö
Niè-giāng	Barn
Cā-tàu	Morgon
Hŭng-cṳ̆ng	Minut
Ngò̤-lò̤-sṳ̆-ngṳ̄	Ryska
Huák-lŭk	Juridik
Hièng-huák	Grundlag
Háng-ngṳ̄	Kinesiska
Sá̤-bàu	Cell
Háik	Blod
Hié (ké-guăng)	Lunga
Romania-ngṳ̄	Rumänska
Bulgaria-ngṳ̄	Bulgariska
Ṳ̄	Regn
Dê-cīng	Jordbävning
Cūi-căi	Översvämning
Hāi-lâung	Tsunami
Hùng	Moln
Hŭng-tăi	Tropisk cyklon
Hŭng	Vind
Georgia-ngṳ̄	Georgiska
Háng-cê	Kinesiska tecken
Dièu-siēng-cê	Hangul
Lá-dĭng cê-mō̤	Latinska alfabetet
Ùng-hŏk	Litteratur
分類:Ĭng-ngŏk	Kategori:Musik
分類:Ùng-hŏk	Kategori:Litteratur
È̤ng-làu-máe̤ng	Drömmar om röda gemak
Harry Potter	Harry Potter
Chiū-ìng	Onani
Siâ-huôi	Samhälle (sociologi)
Gáu-ṳ̆k	Bildning
Nàng-gái	Man
Ìng-guòng	Mänskliga rättigheter
Temür	Temür Khan
Gŭng-sê̤ṳ	Militär
Gă-pĭ	Kaffe
Săng	Berg
Sŏng Dṳ̆ng-săng	Sun Yat-sen
Hiŏng-gē̤ng	Hongkong
Miami	Miami
Hàng Ciéng	Koreakriget
Siū-ék	Seoul
Siông-hāi	Shanghai
Ùng-huá Dâi-gáik-mêng	Kulturrevolutionen
Chĭng-dièu	Qingdynastin
Uŏk-nàng Ciéng-cĕng	Vietnamkriget
Thomas Edison	Thomas Edison
Armenia-ngṳ̄	Armeniska
Ukraine-ngṳ̄	Ukrainska
HTML	HTML
Steven Spielberg	Steven Spielberg
Mŏ̤h-ngiòng	Mo Yan
Sôi-diēng-ngṳ̄	Svenska
Dăng-măk-ngṳ̄	Danska
Nò̤-ŭi-ngṳ̄	Norska
Luxembourg-ngṳ̄	Luxemburgiska
Ciék-káik-ngṳ̄	Tjeckiska
Karl Marx	Karl Marx
Nĕng-nĕng	Kvinnobröst
Guŏng	Ljus
Hĭ-lé-nà̤-ngṳ̄	Grekiska
Ái-ī-làng-ngṳ̄	Iriska
Kié-ngò̤	Pingviner
Pŏ̤-sṳ̆-ngṳ̄	Persiska
Cŭng-gáu	Religion
Hàng-guók-ngṳ̄	Koreanska
Cháung-sié-gé	Första Moseboken
Chók-Ăi-gĭk-gé	Andra Moseboken
Háng-ngṳ̄ Guăng-uâ	Mandarin (språk)
Uŏk-nàng-ngṳ̄	Vietnamesiska
Sigmund Freud	Sigmund Freud
Tái-guók-ngṳ̄	Thai
Mā-lài-ngṳ̄	Malajiska
Mūng-gū-ngṳ̄	Mongoliska
Bandar Seri Begawan	Bandar Seri Begawan
Hĭ-báik-lài-ngṳ̄	Hebreiska
Ŭi-ī-sê̤ṳ-ngṳ̄	Kymriska
Sŭ-gáik-làng-ngṳ̄	Skotsk gäliska
Vientiane	Vientiane
Lō̤-cṳ̄	Lao Zi
Găng-câung	Lever
Sṳ̆-mā Chiĕng	Sima Qian
Tó	Kaniner
Ciŏ Hĭ	Zhu Xi
Cìng-gāng	Känsla
Dâi-iòng	Ocean
Victoria Nṳ̄-uòng	Viktoria av Storbritannien
Sék-giă-mèu-nà̤	Buddha
Mŭk-hâng-mĕk-dáik	Muhammed
Hŭ-ngék	Andning
Ṳ̀-gă	Konfucianism
Bók-lō̤	Buken
Dô̤-gáu	Taoism
Chói-siĕk	Tunga
Dâiu-gáuk	Hals
Chói	Mun
Elizabeth 2-sié	Elizabeth II
Dòng-dièu	Tangdynastin
Dòng Gŏ̤-cū	Tang Gaozu
Dòng Tái-cŭng	Tang Taizong
Dòng Gŏ̤-cŭng	Tang Gaozong
Dòng Dṳ̆ng-cŭng	Tang Zhongzong
Dòng Iô-cŭng	Tang Ruizong
Ū Cáik-tiĕng	Wu Zetian
Dòng Hièng-cŭng	Tang Xuanzong
Dòng Sé̤ṳk-cŭng	Tang Suzong
Cê-mō̤	Bokstav
Siēu-hŏk	Grundskola
Mìng-dièu	Mingdynastin
Ciŏ Nguòng-ciŏng	Zhu Yuanzhang
Ronald Reagan	Ronald Reagan
Gióng-ùng Huòng-dá̤	Jianwen-kejsaren
Īng-lŏk Huòng-dá̤	Yongle-kejsaren
Hùng-hĭ Huòng-dá̤	Hongxi-kejsaren
Sŏng-dáik Huòng-dá̤	Xuande-kejsaren
Mìng Ĭng-cŭng	Zhengtong-kejsaren
Gīng-tái Huòng-dá̤	Jingtai-kejsaren
Sìng-huá Huòng-dá̤	Chenghua-kejsaren
Hùng-dé Huòng-dá̤	Hongzhi-kejsaren
Céng-dáik Huòng-dá̤	Zhengde-kejsaren
Gă-cêng Huòng-dá̤	Jiajing-kejsaren
Lè̤ng-kéng Huòng-dá̤	Longqing-kejsaren
Uâng-lĭk Huòng-dá̤	Wanli-kejsaren
Tái-chiŏng Huòng-dá̤	Taichang-kejsaren
Tiĕng-kiē Huòng-dá̤	Tianqi-kejsaren
Sùng-dĭng Huòng-dá̤	Chongzhen-kejsaren
Gĭng Céng-nĭk	Kim Jong Il
Nguòng-só ciŭ-gĭ-biēu	Periodiska systemet
Chăng-màng	Blindhet
Sá̤-kṳ̄ng	Bakterier
Chéu	Träd
Può-dò̤	Druva
Huăng-giāng-sṳ̀	Potatis
Tòng	Socker
Uòng-dâu	Sojaböna
Séng-sék	Information
Bó̤-cāi	Tidning
Diêng-uâ	Telefon
Ùng-huá	Kultur
Huáng-ngṳ̄	Sanskrit
Dâi-diòng	Tjocktarm
Siēu-diòng	Tunntarm
Ĭ-hŏk	Medicinsk vetenskap
Sièng	Salt
Huá-hŏk nguòng-só	Grundämne
Unix	Unix
Ùi-gì	Go (brädspel)
Káh-dièu-nó̤h	Leksak
Diêng-īng	Film
Gĭng-sṳ̆k	Metall
Kă-dăk-chiă	Cykel
Mièng-huă	Bomull
Sók-dô	Hastighet
Sì-găng	Tid
Cāi	Papper
Só-lâiu	Plast
Miêng-cék	Area
Gŭng-chióh	Meter
Iù-diĕng-bău	Majs
Duâi-măk	Korn
Dĕ̤ng-nàng-ā	Sydostasien
Sīng-iòng	Shenyang
Tṳ̀ng-kéng	Chongqing
Tiĕng-cĭng	Tianjin
Ū-háng	Wuhan
Gū Ăi-gĭk	Forntida Egypten
Gū Hĭ-lé-nà̤	Antikens Grekland
Hṳ̀ng	Björnar
Britney Spears	Britney Spears
Ngàng	Cancer
Măk	Vetesläktet
Cié-sē̤	Durrasläktet
Pó̤-sióng	Funktionsnedsättning
Lĭk-huák	Kalender
Sìng-gĭng-bâng	Psykisk störning
Gregorius Lĭk-huák	Gregorianska kalendern
Tutankhamun	Tutankhamon
Nguŏk-gĭng	Menstruation
Mà-chiók	Mahjong
Ông-ò̤	Kanal
Detroit	Detroit
Diòng-siàng	Kinesiska muren
Gĭng-cê-ták	Pyramid
Osman Dá̤-guók	Osmanska riket
Guók-nô̤i sĕng-sāng cūng-dĭk	Bruttonationalprodukt
Diêng	Elektricitet
Ché̤ṳng	Eldvapen
Lòng-gĭ-ché̤ṳng	Kulspruta
Sáung-buàng	Abakus
Tāng-káik	Stridsvagn
Chāu-muòi	Jordgubbe
Liĕk-chiĕ	Litchi
Ià-cī	Kokospalm
Tò̤	Persika
Cáung-ngṳ̄	Zhuang (språk)
Siŏng-ngṳ̄	Xiang (dialekt)
Mì-ngù-ī-ngṳ̄	Uiguriska
Lâung-gŏ̤	Kaka
Wiki Ŭk-cṳ̄ng	Wikispecies
Nĕng-dáe̤k	Behå
Ā-lá-báik-ngṳ̄	Arabiska
Cūng-lī	Premiärminister
Lù Ū-hièng	Roh Moo-hyun
Páuk Céng-hĭ	Park Chung-hee
Siĕng-ìng-ciōng	Kaktusväxter
Siŏh-tàu-lâung	Klapperstenar
Iòng-bék	Blyertspenna
Gă-sĭ	Möbel
Dó̤h	Bord
Ó̤-muòng	Macao
Liòng Cīng-ĭng	CY Leung
Iē-giāng	Stol
Hù Gīng-dò̤	Hu Jintao
Sĭk Gê̤ṳng-bìng	Xi Jinping
Dòng-gêng-lĕ̤k	Giraff
Chĭng-dáung	Shenzhen
Guōng-dĕ̤ng	Guangdong
Guōng-să̤	Guangxi
Sŭ-lièng	Sovjetunionen
Kiák-sióng-gĭ	Kamera
Kagoshima-gâing	Kagoshima prefektur
C ngṳ̄-ngiòng	C (programspråk)
Kă	Fot
Ciēng	Geckoödlor
Dô-dâing	Ödlor
Giĕng-tàu	Axel (kroppsdel)
Wikipedia:Bō̤-ciéng hō̤ ùng	Wikipedia:Utmärkta artiklar
模板:Link FA	Mall:Link FA
Sié-gái	Världen
Wikipedia:Duâi chéu â	Wikipedia:Bybrunnen
Busan	Pusan
Lèng-huă	Indisk lotus
Vermont	Vermont
Denver	Denver
Guōng-ciŭ	Guangzhou
Ciōng Gái-sĭk	Chiang Kai-shek
Gŏng Dĕk-mìng	Jiang Zemin
Ŭng Gă-bō̤	Wen Jiabao
Nàng-gĭng	Nanjing
Báe̤k-gĭng Dâi-hŏk	Pekinguniversitetet
Chĭng-huà Dâi-hŏk	Tsinghuauniversitetet
Ŭ-lū-mŭk-cà̤	Ürümqi
Gŏng-sŭ	Jiangsu
Ciék-gŏng	Zhejiang
Dâing Siēu-bìng	Deng Xiaoping
Lò̤-mā Gê̤ṳng-huò-guók	Romerska republiken
Câung-kṳ̆	Tibet
Să̤-câung	Autonoma regionen Tibet
Ciŭ Ŏng-lài	Zhou Enlai
Dṳ̆ng-guók Gê̤ṳng-sāng-dōng	Kinas kommunistiska parti
Chiū-gĭ	Mobiltelefoni
Dò̤-nēu	Struts
Kŏng-hĭ Huòng-dá̤	Kangxi-kejsaren
Dièu-siēng	Korea
Lī Káik-giòng	Li Keqiang
Gŏ̤ Hèng-giông	Gao Xingjian
Ciŏ Ṳ̀ng-gĭ	Zhu Rongji
Lī Bèng	Li Peng
Lòng	Varg
Bìng-iōng	Pyongyang
Sĭng-iók Séng-gĭng	Nya Testamentet
9	9 (tal)
Kiék	Skorpioner
Gièng-lè̤ng Huòng-dá̤	Qianlong-kejsaren
Dṳ̆ng-guók Dâi-lṳ̆k	Fastlandskina
Háik-lṳ̀ng-gĕ̤ng-sēng	Heilongjiang
Mā Ĭng-gāu	Ma Ying-jeou
Lè̤	Åsna
Wikipedia:Cék-liông ô-lī-kó̤ gì ùng-ciŏng	Wikipedia:Bra artiklar
Sé-chiŏng	Sichuan
Gô-iók Séng-gĭng	Gamla Testamentet
Séng-dáng-cáik	Jul
Săng-gáe̤k-hìng	Triangel
Muammar Gaddafi	Muammar al-Gaddafi
Lâu-hū	Tiger
Daejeon	Daejeon
Daegu	Daegu
Sié-cŭng Dĕk-biék Cê̤ṳ-dé-chê	Sejong City
Incheon	Inchon
Gyeonggi Dô̤	Gyeonggi
Bô-uăk-cáik	Påsk
Ò̤-báe̤k	Hebei
Bŏk Hĭ-lài	Bo Xilai
GNU Cê̤ṳ-iù Ùng-dáung Hṳ̄-kō̤-céng	GNU Free Documentation License
Uŏng Cĭng-ôi	Wang Jingwei
Dìng Cūi-biēng	Chen Shui-bian
Dài-uăng	Taiwan (ö)
À̤	Sko
Ngṳ̀ng-hòng	Bank
Lū Séng	Lu Xun
7	7 (tal)
8	8 (tal)
Lĕ̤k	Hjortdjur
Hù	Insjö
Sáung-tàu	Vitlök
Chái-guă	Gurka
Dō̤	Ö (landområde)
Băh-sáik	Vit
Ŭ-sáik	Svart
6	6 (tal)
Moshchena	Mosjtjena
Huăng-kê	Tomat
George H. W. Bush	George H.W. Bush
Paltoga	Paltoga
Quảng Bình	Quang Binh
Atlanta	Atlanta
Benito Mussolini	Benito Mussolini
Sṳ̀-diēng	Ordbok
Tàu	Huvud
Hiê-lìng-dóng	Wellington
Dâi Bók-liĕk-diĕng Dō̤	Storbritannien (ö)
Las Vegas	Las Vegas
10	10 (tal)
Alfred Nobel	Alfred Nobel
Tàu-sĕ̤	Kam
Guòng-lĭk	Makt
Mà-hùng-cēu	Ugglor
Dēng-cṳ̆ng	Timme
Ké-chiông	Meteorologi
Đà Nẵng	Da Nang
Káh-chiók	Skata
Làng-huă	Orkidéer
Gă-săk	Kackerlackor
Ngáuk-ngṳ̀	Krokodildjur
Lā-lì	Myrkottar
Nàng-muōi-sĭng	Lysmaskar
Holocene	Holocen
Hāi-báu	Öronlösa sälar
Bà̤-bá-cēu	Gärdsmyg
Ciáh-giāng	Pilfink
Niccolò Cusano Dâi-hŏk	Università degli Studi Niccolò Cusano
Long An	Long An
Thái Nguyên	Thai Nguyen (provins)
Herodotus	Herodotos
Othello	Othello
Nĭk-buōng-hāi	Japanska havet
Dĕ̤ng-ā	Östasien
Dĕ̤ng-ĕu	Östeuropa
Vĩnh Phúc	Vinh Phuc
Chĕ̤ng	Piplök
Liù-giù-guók	Kungariket Ryukyu
Dièu-siēng uòng-dièu	Joseon
Dâi-hàng Dá̤-guók	Kejsardömet Korea
Gŏ̤-gău-là̤	Koguryo
Bì-bà-dâu-giék	Fladdermöss
Báik-cá̤	Baekje
Sĭng-lò̤	Silla
Tàu-huók	Hår
Hàng Hĭ	Han Feizi
Uòng-dá̤	Huang-Di
Diéu-ngṳ̀-dài Liĕk-dō̤	Senkaku-öarna
Gê̤ṳng-huò-dōng (Mī-guók)	Republikanska partiet
Dṳ̆ng-guók	Kina (region)
Mìng-ciō-dōng (Mī-guók)	Demokratiska partiet
Cūi-tiák	Utter
Sìng-dŭ	Chengdu
Buò-gŭng-ĭng	Maskrossläktet
Tá	Medusa (zoologi)
Dâng-ciŭ	Zhengzhou
Cūng-tūng	President
Muāng-ciŭ-guók	Manchukuo
Só̤h	Tågvirke
Dṳ̆ng-guók Guók-mìng-dōng	Kuomintang
Hiăng-diê ciā-muói	Syskon
Ngâng	Svangås
Ĕng-gŏ̤	Papegojfåglar
Gă-huák	Addition
Dài-uăng-sēng	Taiwan (provins)
Dŏ̤	Kniv
Băng-mā	Zebror
Guók-cié biĕu-cūng cṳ̆-hô̤	ISBN
Đồng Nai	Dong Nai
Sóc Trăng	Soc Trang (provins)
Quảng Ngãi	Quang Ngai (provins)
Hà Tĩnh	Ha Tinh (provins)
Cà Mau	Ca Mau (provins)
Quảng Nam	Quang Nam
Bến Tre	Ben Tre (provins)
Khánh Hòa	Khanh Hoa
Káh-gă-ngṳ̄	Hakka (språk)
Sơn La	Son La (provins)
Huŏng-ngiòng	Dialekt
Lev Trotsky	Lev Trotskij
Quảng Ninh	Quang Ninh
Lạng Sơn	Lang Son (provins)
Bắc Ninh	Bac Ninh (provins)
Gáng-ngṳ̄	Gan (dialekt)
Mà-hṳ̀ng	Jättepanda
Muāng-ngṳ̄	Manchuiska
Chiū	Hand
Dô Hū	Du Fu
Gùng-dō̤	Ögrupp
Niŏh-niŏh	Blad
Bŭk-buó	Vattenfall
Yasser Arafat	Yassir Arafat
Câung-ngṳ̄	Tibetanska
Ngù-ngṳ̄	Wu (dialekt)
Tasmania	Tasmanien
Ì-cô̤	Tvål
Hŭk-săng	Foshan
Ciĕu-huò Tiĕng-huòng	Hirohito
Al-Qaeda	Al-Qaida
Mò̤-táuk-chiă	Motorcykel
Ò̤-mā	Flodhäst
Anastacia	Anastacia
Sĕk Gái	De tio budorden
Huă-báu	Leopard
Să̤-ngiù	Noshörningar
Lò̤-buàng	Kompass
Buáng-dō̤	Halvö
Sĭng-giŏng	Xinjiang
Mŭk-guă	Papaya
Mì-sĕng-só	Vitamin
Giáng	Spegel
Ciŭ-dièu	Zhoudynastin
Kāng-muòng-giāng	Fönster
Băh Gṳ̆ng	Vita huset
Gīng-chák	Polis
Báe̤k-hāi-dô̤	Hokkaido
Giŏng	Ingefära
Nobel Huò-bìng Ciōng	Nobels fredspris
Sáu	Hosta
Hák-chê	Nysning
Káung-mìng	Sömn
Gèng-hāi	Aralsjön
Dé̤ṳk	Bambu
Hù Cé-mìng	Ho Chi Minh
Hòa Bình	Hoa Binh (provins)
Sŭ Sék	Su Shi
Queensland	Queensland
Tù	Jord
Ù-huă-guō	Fikon
Hưng Yên	Hung Yen (provins)
Dòng-dô	Längd
Kon Tum	Kon Tum (provins)
Hậu Giang	Hau Giang
Máe̤ng	Dröm
Yên Bái	Yen Bai (provins)
Bắc Giang	Bac Giang (provins)
Thừa Thiên-Huế	Thua Thien-Hué
Bắc Kạn	Bac Kan (provins)
Lai Châu	Lai Chau (provins)
Hà Nam	Ha Nam
Lào Cai	Lao Cai (provins)
Mìng-dĕ̤ng-ngṳ̄	Mindong
Hannibal	Hannibal
Mìng-nàng-ngṳ̄	Minnan
Thanh Hóa	Thanh Hoa (provins)
Kiên Giang	Kien Giang
Quảng Trị	Quang Tri
Nghệ An	Nghe An
An Giang	An Giang
Tây Ninh	Tay Ninh (provins)
Phú Thọ	Phu Tho (provins)
Duâi-sĭng-sĭng	Gorillor
Trà Vinh	Tra Vinh (provins)
Bạc Liêu	Bac Lieu (provins)
Gia Lai	Gia Lai
Tiền Giang	Tien Giang
Bình Phước	Binh Phuoc
Đồng Tháp	Dong Thap
Thái Bình	Thai Binh (provins)
Hà Giang	Ha Giang (provins)
Đắk Lắk	Dak Lak
Cáung-cŭk	Zhuang
Bình Định	Binh Dinh
Lâm Đồng	Lam Dong
Đắk Nông	Dak Nong
Phú Yên	Phu Yen
Hải Dương	Hai Duong (provins)
Iók-hâng Hók Ĭng	Johannesevangeliet
Dài-uăng-uâ	Taiwanesiska
Muòng	Dörr
Chiēng-gák	Nagel
Cao Bằng	Cao Bang (provins)
Bình Dương	Binh Duong
Bình Thuận	Binh Thuan
Bà Rịa-Vũng Tàu	Ba Ria-Vung Tau
Ninh Bình	Ninh Binh (provins)
Ninh Thuận	Ninh Thuan
Nam Định	Nam Dinh (provins)
Điện Biên	Dien Bien
Sìng-lṳ̀ng	Jackie Chan
Méng	Ansikte
Ùng-ngiòng-ùng	Klassisk kinesiska
Gāng-lāng	Olivträd
Săng-ôi-ék-tā̤	Treenighetsläran
Sŏng-cṳ̄	Sun Zi
Sĭng-săng	Lärare
Cleveland	Cleveland
Dăk-lâi Lā-mà	Dalai lama
Huă-sĕng	Jordnöt
100	100 (tal)
Kă-kók-tàu	Knä
Hâing	Aprikos
Ngāng-giáng	Glasögon
Cê̤ṳ-lài-huōi	Tändsticka
Chê-diòng	Marknad (ekonomi)
Nàng Dṳ̆ng-guók Hāi	Sydkinesiska havet
Dièu-siēng Sié-cŭng	Sejong den store
Hăk-gĭng	Legering
Bĭng-siŏng	Kylskåp
Nobel Ùng-hŏk Ciōng	Nobelpriset i litteratur
Huăng-sṳ̀	Sötpotatis
Uòng-hāi	Gula havet
Akihito	Akihito
Newton ông-dông-hŏk dêng-lŭk	Newtons rörelselagar
Să̤-guă	Vattenmelon
Biobío Dâi-hŏk	Universidad del Bío-Bío
Huòng-dá̤	Kejsare
Ìng-mìng-bê	Renminbi
Tā̤-cék	Volym
Cèng-sáik	Orange
Gă-sĭ-huă	Verktyg
Ĭ-sĕng	Läkare
Iéng (cēu)	Svalor
Kó	Byxor
Lô-gă Hók Ĭng	Lukasevangeliet
Mìng-ciō-dōng	Demokratiska partiet (olika betydelser)
Ciŏng-tàu	Murtegel
Tiō-uòng	Ellips (matematik)
Sìng-huák	Multiplikation
Sé̤ṳ-dù Hèng-diông	Apostlagärningarna
Uòng-dô̤ Sĕk-nê Sĭng-cô̤	Zodiaken
Huá-siŏh	Fossil
Gēng-huák	Subtraktion
Cī-cī	Frö
Chiĕk	Krabbor
Gă-dŏ̤	Sax
Niêu	Urin
Ăng-hŭi	Anhui
Ngiăh	Panna (anatomi)
Sĭ-piĕng	Psaltaren
Chungcheong Báe̤k-dô̤	Nordchungcheong
Chungcheong Nàng-dô̤	Sydchungcheong
Gangwon Dô̤ (Dâi-hàng Mìng-guók)	Gangwon
Nô̤i Mūng-gū	Inre Mongoliet
Gĭng Nĭk-sìng	Kim Il Sung
Gyeongsang Nàng-dô̤	Sydgyeongsang
Gyeongsang Báe̤k-dô̤	Nordgyeongsang
Jeolla Báe̤k-dô̤	Nordjeolla
Jeolla Nàng-dô̤	Sydjeolla
Jeju Dĕk-biék Cê̤ṳ-dé-dô̤	Jeju
Huăng-cièng-giāng	Mynt
Bă-biĕk-ták	Babels torn
Ulsan	Ulsan
Gwangju	Gwangju
Chó	Ättika
Kangwŏn Dô̤ (Dièu-siēng Mìng-ciō-ciō-ngiê Ìng-mìng Gê̤ṳng-huò-guók)	Kangwon
Michael Jordan	Michael Jordan
Lé-ê-gé	Tredje Moseboken
Gṳ̆ng-gṳ̆ng	Rot
Bì-bà (cūi-guō)	Japansk mispel
Hamlet	Hamlet
Huà Guók-hŭng	Hua Guofeng
Sāng	Paraply
Làu Hiēu-pŏ̤	Liu Xiaobo
Hók-gióng	Fujian
Mūng-gū-cŭk	Mongoler
Mĕk-sê Liŏh	Uppenbarelseboken
Hièng-câung	Xuanzang
Gū-chiŏng	Stjärt
Mìng-chòng	Säng
Hāi-nàng	Hainan
Háng-ngṳ̄ Pĭng-ĭng	Pinyin
Uōng-dĕ̤ng	Fjärran Östern
Băh-gák	Klippduva
Găng-sé̤ṳk	Gansu
Taliban	Taliban
Huŏi-sáik	Grå
Sĭng-mêng-gé	Femte Moseboken
Sŭ-ciŭ	Suzhou
Ŭng-ciŭ	Wenzhou
Háng-cŭk	Hankineser
Nìng-pŏ̤	Ningbo
Chói-chiŭ	Skägg
Cāi-iêu	Drake (leksak)
Hăk-ī-bĭng	Harbin
Mā-kì	Iglar
1000	1000 (tal)
Mìng-só-gé	Fjärde Moseboken
Cáu-sèng	Kök
Hùng-nàng	Yunnan
Lō̤-uă	Corvus
Săng-dĕ̤ng	Shandong
È̤ng-ĕ̤ng	Enkelfotingar
Ò̤-nàng	Henan
Mì-mò̤	Ögonbryn
Bók-sài	Navel
Lièu-nìng	Liaoning
Hióng-liông	Vektor
Cretaceous	Krita (geologi)
Tochigi-gâing	Tochigi prefektur
Chói-mò̤-cēu	Alcedines
Dàu	Tärning
Cūi-nà̤	Cement
Gék-lìng	Jilin
Dĕ̤ng Dṳ̆ng-guók Hāi	Östkinesiska havet
Hāi-chĕk	Sjöröveri
Gūi	Spöke
Bóng-dó̤	Avfall
Hù-nàng	Hunan
Jurassic	Jura (period)
Chĭng-hāi	Qinghai
Mì-ngù-ī-cŭk	Uigurer
Ă-piéng	Opium
Chiū-cī	Fingerring
Hù-báe̤k	Hubei
Săng-să̤	Shanxi
Cĕ̤ng-sáik	Brun
Giòng-găng	Våldtäkt
Gói-ciŭ	Guizhou
Triassic	Trias
Sék-sáuk	Syrsor
Cāi-piéu	Sedel
SQL	Structured Query Language
Hù Sék	Hu Shi
Iók-cṳ̆-ā-gé	Josua (bok)
Cŏng-cṳ̄	Zhuang Zi
Cṳ̀-hĭ Tái-hâiu	Änkekejsarinnan Cixi
Kan Naoto	Naoto Kan
Miyagi-gâing	Miyagi prefektur
模板:Commons category	Mall:Commonscat
Lò̤-mā Cṳ̆	Romarbrevet
Pău-ŭk-siáng	Parabel (kurva)
Dô̤-dáik	Moral
Iwate-gâing	Iwate
Ĭ-siòng-chiă	Symaskin
Dièu-siēng Lò̤-dông-dōng	Koreas arbetarparti
Nàng-báe̤k-dièu	De sydliga och nordliga dynastierna
Pì-lĭk-bī Cṳ̆	Filipperbrevet
Ngā-gŏ-cṳ̆	Höga Visan
Mā-lăk-gĭ-cṳ̆	Malaki
模板:Taxobox	Mall:Taxobox
分類:Gŭng-ciō	Kategori:Monarker
Diŏng Ngiê-mèu	Zhang Yimou
模板:Dṳ̆ng-guók lĭk-sṳ̄	Mall:Kinas historia
Gĭng Céng-ŏng	Kim Jong-un
Liù-giù-ngṳ̄	Ryūkyū (språk)
Céng-ngṳ̄	Jin (dialekt)
Mìng-ngṳ̄	Min (språk)
Gŏng-să̤	Jiangxi
Nìng-hâ	Ningxia
Lùng-sùng	Drakbåt
Noda Yoshihiko	Yoshihiko Noda
Yingluck Shinawatra	Yingluck Shinawatra
Siŏh-gă-cŏng	Shijiazhuang
Ciŏ-hāi	Zhuhai
Sáng-tàu	Shantou
Dâng-gŏng	Zhanjiang
Mùi-ciŭ	Meizhou
Chĭng-uōng	Qingyuan
Dĕ̤ng-uāng	Dongguan
Dṳ̆ng-săng-chê	Zhongshan
Dièu-ciŭ	Chaozhou
Tàng-táik	Malartade fiskar
Gé̤ṳk-huă	Krysantemumsläktet
Sofie gì Sié-gái	Sofies värld
Ordovician	Ordovicium
Silurian	Silur
Hók-gióng-sēng (Dṳ̆ng-huà Mìng-guók)	Fujian (Taiwan)
Dāng-nòng	Gallblåsa
Devonian	Devon (period)
Hók-ciŭ	Fuzhou
Nàng-bìng	Nanping
Buò-dièng	Putian
Săng-mìng	Sanming
Ciòng-ciŭ	Quanzhou
Â-muòng	Xiamen
Ciŏng-ciŭ	Zhangzhou
Lṳ̀ng-ngàng	Longyan
Nìng-dáik	Ningde
Să̤-nìng	Xining
Să̤-iù-gé	Färden till Västern
Săng-guók Iēng-ngiê	Romansen om de tre kungadömena
Cūi-hū	Berättelser från träskmarkerna
Aomori-gâing	Aomori prefektur
Fukushima-gâing	Fukushima (prefektur)
Tái-nguòng	Taiyuan
Hải Phòng	Hai Phong
Dâi-lièng	Dalian
Hĭ-Pŏ̤ Ciéng-cĕng	Persiska krigen
Permian	Perm
Biēu-chĭng	Kusin
Cambrian	Kambrium
Iòng-ciók	Levande ljus
Chiba-gâing	Chiba prefektur
Pău	Pompelmus
Lô-dáik-gé	Ruts bok
Mà-hù	Egentliga trollsländor
Dáng-ī-lī	Daniels bok
Páuk-káik	Poker
Mô̤	Hatt
Gŏ̤-lìng-dŏ̤ Cièng Cṳ̆	Första Korinthierbrevet
Aichi-gâing	Aichi prefektur
Lī-ngṳ̀	Karp
Muāng-ciŭ	Manchuriet
Sê̤ṳ-sṳ-gé	Domarboken
Pŏ̤-lìng-chái	Spenat
Akita-gâing	Akita prefektur
Pièu-gĕng	Sked
Dê̤ṳ	Ätpinnar
Mĕ̤k-lê	Jasminsläktet
Gié-tiàng-chiă	Taxi
Â-hài	Haka
Gŭ	Fruktkropp
Ibaraki-gâing	Ibaraki prefektur
Siĕu-sŏng	Salpetersyra
Ngù-giāng-kó	Jeans
Bō̤-siŏh	Ädelsten
Lièu-că̤ Cé-ê	Liaozhai Zhiyi
Gáu-kuŏ-cṳ̆	Lärobok
Chāu-māng	Gräshoppor
Dâng Gĭng	Zheng Jing
Diòng-chŭng	Changchun
Milan Kundera	Milan Kundera
Lâung	Ägg (livsmedel)
Ū-ì-săng-chê	Wuyishan (stad)
Lĕ̤k-sé Sê̤ṳ-giông	Protesterna och massakern på Himmelska fridens torg
Diêu Ciē-iòng	Zhao Ziyang
Hù Iêu-băng	Hu Yaobang
Fukuda Yasuo	Yasuo Fukuda
Sṳ̀ng-chéu (Sṳ̀ng-báh)	Tallväxter
Gī-hò̤-chiă	Passare
Táng-sŏng	Kolsyra
Liòng-chióh	Linjal
Chăng-màng-chṳ̄	Mullvadsdjur
Dṳ̆ng-hâ Iâ cĭ Máe̤ng	En midsommarnattsdröm
Mā-kō̤ Hók Ĭng	Markusevangeliet
Kaesŏng	Kaesong
Hwanghae Báe̤k-dô̤	Norra Hwanghae
P'yŏng'an Báe̤k-dô̤	Norra P'yŏngan
Hamgyŏng Báe̤k-dô̤	Norra Hamgyong
Hamgyŏng Nàng-dô̤	Södra Hamgyong
P'yŏng'an Nàng-dô̤	Södra P'yŏngan
Namp'o	Nampo
Ryanggang Dô̤	Ryanggang
Sŭk-mī	Grötris
Nguòng-siĕu-uòng	Tangyuan (maträtt)
Gĭng-dŭ	Kyoto prefektur
Ōsaka-hū	Osaka prefektur
Cék-ngṳ̀	Guldfisk
Fukuoka-gâing	Fukuoka prefektur
Ehime-gâing	Ehime prefektur
Gŏ̤-lìng-dŏ̤, Hâiu Cṳ̆	Andra Korinthierbrevet
Gàu-ūng	Daggmask
Sā̤-ĭ-gĭ	Tvättmaskin
Gék	Småcitrus
Gé̤ṳ	Såg
Yamagata-gâing	Yamagata prefektur
Éu-dê-huòng	Barnträdgård
Dài-uăng Hāi-hiĕk	Taiwansundet
Lù-guói	Aloesläktet
Yamaguchi-gâing	Yamaguchi prefektur
Kanagawa-gâing	Kanagawa prefektur
Nagano-gâing	Nagano prefektur
Iĕng-huă	Fyrverkeri
Mì-pŏ̤-lù	Mikrovågsugn
Saitama-gâing	Saitama prefektur
Mie-gâing	Mie prefektur
Hĭ-báik-lài Cṳ̆	Hebreerbrevet
Gă-lăk-tái Cṳ̆	Galaterbrevet
Muàng-ngṳ̀	Ålartade fiskar
Céng-gŏng	Jinjiang, Quanzhou
Siŏng-dièu	Shangdynastin
Gunma-gâing	Gunma prefektur
Hyōgo-gâing	Hyogo prefektur
Miyazaki-gâing	Miyazaki prefektur
Kumamoto-gâing	Kumamoto prefektur
Ă-cì	Cikador
Koizumi Jun'ichirō	Junichiro Koizumi
Liĕk-uòng-gé-liŏk Siông	Första Kungaboken
Ī-sê̤ṳ-táik-cṳ̆	Esters bok
Diòng-dô-cṳ̆	Predikaren
Hatoyama Yukio	Yukio Hatoyama
Gŏ̤-lò̤-să̤ Cṳ̆	Kolosserbrevet
Ngā-gáuk Cṳ̆	Jakobsbrevet
Iók-hâng Ék Cṳ̆	Första Johannesbrevet
Pì-lé-muòng Cṳ̆	Filemonbrevet
Táik-sák-lò̤-nà̤-giă, Hâiu Cṳ̆	Andra Thessalonikerbrevet
Táik-sák-lò̤-nà̤-giă Cièng Cṳ̆	Första Thessalonikerbrevet
Bī-dáik Cièng Cṳ̆	Första Petrusbrevet
Bī-dáik Hâiu Cṳ̆	Andra Petrusbrevet
Tì-mò̤-tái Cièng Cṳ̆	Första Timotheosbrevet
Dòng-lòng	Bönsyrsor
Gifu-gâing	Gifu prefektur
Ishikawa-gâing	Ishikawa prefektur
Nara-gâing	Nara prefektur
Wakayama-gâing	Wakayama prefektur
Shizuoka-gâing	Shizuoka prefektur
Shiga-gâing	Shiga prefektur
Iók-hâng Nê Cṳ̆	Andra Johannesbrevet
Ī-suói-ā-cṳ̆	Jesaja
Iók-hâng Săng Cṳ̆	Tredje Johannesbrevet
Iù-dâi Cṳ̆	Judasbrevet
Tì-mò̤-tái Hâiu Cṳ̆	Andra Timotheosbrevet
Tì-dŏ̤ Cṳ̆	Titusbrevet
Nùng-mìng	Bonde
Ī-sê̤ṳ-lá-cṳ̆	Esra
Nà̤-hĭ-mī-cṳ̆	Nehemja
Iók-ngī-cṳ̆	Joel
Băh-lô	Silkeshäger
Chŭng-cáik	Kinesiskt nyår
Sō-siè	Nyckel
Abe Shinzō	Shinzo Abe
Asō Tarō	Taro Aso
Niigata-gâing	Niigata prefektur
Yamanashi-gâing	Yamanashi prefektur
Shimane-gâing	Shimane prefektur
Toyama-gâing	Toyama prefektur
Okayama-gâing	Okayama prefektur
Kă-tōi	Ben (kroppsdel)
Piăng	Rygg
Piĕ	Brev
Sáik-màng	Defekt färgseende
Carboniferous	Karbon
Fukui-gâing	Fukui prefektur
Ōita-gâing	Ōita prefektur
Tottori-gâing	Tottori prefektur
Nùng-lĭk	Kinesiska kalendern
Kōchi-gâing	Kochi prefektur
Uâng-iū īng-lĭk dêng-lŭk	Newtons gravitationslag
Chèng-gēng	Silkesfjäril
Dài-uăng Nĭk-buōng Sì-dâi	Taiwan under japanskt styre
Páuk Gê̤ṳng-hiê	Park Geun-hye
Dài-nàng	Tainan
Cĕng	Synål
Muāng-cŭk	Manchuer
Kìng-giāng	Tång (handverktyg)
Anna Karenina	Anna Karenina
Gáung-gṳ̆ng	Armeringsstål
Tiè-mà	Gråt
Swadesh hŏk-sĭng-sṳ̀ liĕk-biēu	Swadeshlista
Dŭng-nìng-guók	Kungadömet Tungning
Diāng	Kokkärl
Kă-cāi	Tå
Lāng	Saliv
Diò-să-hô	Kock
Bĭng-lòng	Betelpalm
Dâi-céng Tiĕng-huòng	Taishokejsaren
Băng-sièng Lā-mà	Panchen lama
Mŭk-gê̤ṳng	Frilandshibiskus
Muòi-huă	Ume (frukt)
Cĕ̤ng-chéu	Väderkvarnspalm
Muòi-kṳ̄ng	Mögel
Gĭng-cá̤	Ekonomi
Sĕ̤ng-săng-giāng	Tvillingar
Mĕ̤k-tiák	Ögonfrans
Nguòng-cṳ̄-bék	Kulspetspenna
Norodom Sihanouk	Norodom Sihanouk
Saga-gâing	Saga prefektur
Tokushima-gâing	Tokushima prefektur
Lòng-dâung	Bolmört
Lòi-sĭ-gā	Skruvmejsel
Kēng-muōi-dăi	Kolvhirs
Sĭk-sĭk	Vinge
Kagawa-gâing	Kagawa prefektur
Mū-dăng	Buskpion
Thaksin Shinawatra	Thaksin Shinawatra
Kê	Diospyros
Săng-guók (Dièu-siēng)	Koreas tre kungariken
Bék	Penna
Ŭng-dìng	Damm (stoft)
Huăng-siŏh-liù	Guava
Duâi-tàu-giáng	Förstoringsglas
Puái-dáu	Middag (tid)
Huōi-căi	Brand
Chiū-ló̤h	Handskar
Nagasaki-gâing	Nagasaki prefektur
Hâ-dièu	Xiadynastin
Cá̤-nàng	Jinan
Dṳ̆ng-guók Káung-nĭk Ciéng-cĕng	Andra kinesisk-japanska kriget
Sarawak	Sarawak
Hŭng-cūi	Fengshui
Chiéu	Skratt
Ngô̤-mâng gâe̤ng Piĕng-giéng	Stolthet och fördom
Oda Nobunaga	Oda Nobunaga
Dăng-hù	Koralldjur
Lī Sìng-uāng	Syngman Rhee
Iòng-bék-chó̤	Radergummi
Nàng-chiŏng	Nanchang
Tokugawa Ieyasu	Tokugawa Ieyasu
Bók-séu-gáung	Rostfritt stål
Sáu-chiū	Kvast
Dŭk-cài	Envälde
Kŭng-dièu	Luftkonditionering
Diòng-să	Changsha
Pèng	Målarfärg
Mìng-dê Tiĕng-huòng	Meiji
Kă-âu-dăng	Häl
Ŏ̤-bă-dī-ā-cṳ̆	Obadja
Itō Hirobumi	Hirobumi Ito
Nguŏh	Jade
Só-gé̤ṳ-kó guāng-lī hiê-tūng	Databashanterare
Dâu-hô	Tofu
Mì-hèu	Makaker
Mī-giă-cṳ̆	Mika
Bù-sák	Bodhisattva
Hăk-gĭ-cṳ̆	Haggaj
Ī-să̤-giék	Hesekiels bok
Chiū-biēu	Armbandsur
ASP.NET	ASP.NET
Iók-nā-cṳ̆	Jona
Sabah	Sabah
Ià-lé-mī-ăi-gŏ̤	Klagovisorna
Tái-gáng	Eunuck
Nàng-nìng	Nanning
Ê-só	Natriumglutamat
Nā-ŭng-cṳ̆	Nahum
Hăk-bă-gók-cṳ̆	Habackuk
Sák-gā-lé-ă-cṳ̆	Sakarja
Guók-gê̤ṳng Nô̤i-ciéng	Kinesiska inbördeskriget
Uŏk-nàng Gê̤ṳng-huò-guók	Sydvietnam
Chiĕu-chê	Snabbköp
Ciŏng Cṳ̄-ì	Zhang Ziyi
Lák-tàu	Håravfall
Gulliver Lṳ̄-hèng-gé	Gullivers resor
Gŏ̤-hṳ̀ng	Kaohsiung
Naha-chê	Naha
Buŏk-hāi	Bohai
Báh-chói	Gäspning
Hâung Ṳ̄	Xiang Yu
Putrajaya	Putrajaya
Kŏng-mìng	Kunming
Nĭk-guŏng-dĕng	Lysrör
Jane Eyre	Jane Eyre
Johor	Johor
Ngâung	Utvecklingsstörning
Huòi-cŭk	Hui (folk)
Làng-ciŭ	Lanzhou
Hŏ̤-să̤-cṳ̆	Hosea
Tiék-cĭng	Rost
Dĕ̤ng-kiĕ	Sepialiknande bläckfiskar
Lìng Cáik-sṳ̀	Lin Zexu
Săng-guók	De tre kungadömena
Chŭng-chiŭ Sì-dâi	Vår- och höstperioden
Ciéng-guók Sì-dâi	De stridande staterna
Puō-ngì	Puyi
Mā-lăk-gă	Malacka
Hăk-bùi	Hefei
Huák-lùng-gŭng	Falungong
Kelantan	Kelantan
Lŏk-iòng	Luoyang
Toyotomi Hideyoshi	Toyotomi Hideyoshi
Kana	Kana (skriftsystem)
Câung-cŭk	Tibetaner
Pulau Pinang	Pinang (delstat)
Hamasaki Ayumi	Ayumi Hamasaki
Să̤-huăng-ngā-cṳ̆	Sefanja
Dâi-nĭk-buōng Dá̤-guók	Japanska imperiet
Hṳ̆ng-nù	Xiongnu
Mâing-cṳ̄	Mencius
Kedah	Kedah
Perak	Perak
Hŏk-ôi	Examen
Gié-lìng	Guilin
Terengganu	Terengganu
Selangor	Selangor
Iòng (dông-ŭk)	Getdjur
Hāi-kāu	Haikou
Chāu-buōng sĭk-ŭk	Ört
Pahang	Pahang
Bă-là̤ Séng-mū-iêng (Siēu-siók)	Ringaren i Notre Dame
Chiông-gì	Xiangqi
Yun Chi-ho	Yun Chi-ho
Gói-iòng	Guiyang
Gáung-bék	Reservoarpenna
Ngù Dìng-iēng	Ngo Dinh Diem
Dĭng-hiŏng-kó̤	Ansjovisfiskar
Miêng	Nudlar
Hiêng-câi	Nutid
Lèng-gēng	Dimocarpus longan
Mì-lĕk-hŭk	Maitreya
Guăng-ĭng	Avalokiteshvara
Gēu-gī	Bocktörne
Lĕ̤k-dèu-gáuk	Revben
Ciŏng-bìng	Zhangping
Ciŏng-puō	Zhangpu
Ciéu-ăng	Zhao'an
Dâng Sìng-gŭng	Koxinga
Céng-huò	Zhenghe
Nguŏk-biāng	Månkaka
Ciŭ Īng-kŏng	Zhou Yongkang
Ciŭ-nìng	Zhouning
Cṳ̆-gák Liông	Zhuge Liang
Ció-ĭng Hù-hô̤	Zhuyin
Tù-kēng	Mullvadssyrsor
Dṳ̆ng-guók Ìng-mìng Gāi-huóng-gŭng	Folkets befrielsearmé
Sìng-ū Tiĕng-huòng	Jimmu
Kūng-chiók	Påfåglar
Ciē-chái	Nori
Dennis Rodman	Dennis Rodman
È̤ng-dà	Svart te
Cò̤ Chó̤	Cao Cao
Lièng-gŏng	Lianjiang, Fuzhou
Tài-tàu	Halshuggning
Cūi-ngù	Långhorningar
Hiŏng-siàng	Xiangcheng, Zhangzhou
Buŏi	Flygning
Ŭi-nà̤-sṳ̆ Sĕng-lī-nè̤ng	Köpmannen i Venedig
Ū-ì-săng	Wuyishan
Ŭ-sŭ-lī-gĕ̤ng	Ussuri
Dĕ̤ng-cé	Vintersolståndet
Tiĕng-huòng	Kejsaren av Japan
Kăi-hŭng	Kaifeng
Sĭng-dài-bê	Taiwanesisk dollar
Sák-mū-ngī-gé-hâiu-cṳ̆	Andra Samuelsboken
Lăk-dâi-cé-liŏk Hâ	Andra Krönikeboken
Liĕk-uòng-gé-liŏk Hâ	Andra Kungaboken
Mièu-cŭk	Miao (folk)
Nguòng Sié-kāi	Yuan Shikai
Gă-lṳ̀ng Huòng-dá̤	Gia Long
John Wesley	John Wesley
Siăh	Ätande
Perlis	Perlis
Negeri Sembilan	Negeri Sembilan
Labuan	Labuan
Lṳ̀ng	Kinesisk drake
Iòng-iù-gàu	Fotogenlampa
Cần Thơ	Can Tho
Ciĕng-bò̤	Champa
Uōng-dâi Cièng-tiàng	Lysande utsikter
Niōng-bēng	Innertak
Rasŏn	Rason
Guăng Ṳ̄	Guan Yu
Ŭ-gŭi	Sköldpaddor
Bō̤-dâi Huòng-dá̤	Bao Dai
Siê-iù	Sojasås
Ŭ-lṳ̀ng-dà	Oolong
Chái Ĭng-ùng	Tsai Ing-wen
Băh-cṳ̄ng-nè̤ng	Vit (hudfärg)
Ŏ̤-mì-tò̤-hŭk	Amitabha
Ciŭ Giĕk-lùng	Jay Chou
Orhan Pamuk	Orhan Pamuk
Hà-puō	Xiapu
Ngū-dâi Sĕk-guók	De fem dynastierna och De tio rikena
Cō̤	Jujubär
Tā̤-ṳ̆k	Idrott och hälsa
Dài-dṳ̆ng	Taichung
Làu Bê	Liu Bei
Gĭng-muòng	Kinmen
Sĭng-dé̤ṳk (chê)	Hsinchu
Gă-ngiê (chê)	Jiayi
Giĕ-lè̤ng	Chilung
Săi	Sai
Ngiè	Tamgås
Dièu-siēng Gŏ̤-cŭng	Gojong av Korea
Hók-chiăng	Fuqing
Gáuk-gáuk	Ben (skelett)
Diêng-tù	Batteri
Gê̤ṳ-gê̤ṳ	Krycka
Hù-lì-mà	Sibirisk eldmård
Gŏ̤-ák-guŏ	Tryckkokare
Chagang Dô̤	Chagang
Óng-chái	Sallatsipomea
Ké̤ṳk-siăh	Tiggeri
Sŏng-ngù	Östra Wu
Băh-cŭk	Bai (folk)
Mùi-liĕk	Meilie
Â-dáu	Eftermiddag
Huòng Tái-gĭk	Hung Taiji
Guŏng-sê̤ṳ Huòng-dá̤	Guangxu-kejsaren
Takeshi Kaneshiro	Takeshi Kaneshiro
Sông-dê Huòng-dá̤	Shunzhi-kejsaren
Nū-ī-hăk-cà̤	Nurhaci
Sŏng Guòng	Sun Quan
Cò̤ Pī	Cao Pi
Ciōng Gĭng-guók	Chiang Ching-kuo
Uòng Mì	Wang Wei
Lī Dĕng-hŭi	Lee Teng-hui
Ṳ̆ng-céng Huòng-dá̤	Yongzheng-kejsaren
Dùng-dê Huòng-dá̤	Tongzhi-kejsaren
Dŭng-huòng	Dunhuang
Să-mŏk	Erg (landform)
Hiŏng-iòng-guă	Sechium edule
Săng-ā	Sanya
Dài-uăng Mìng-ciō-guók	Republiken Taiwan (1895)
Sṳ̆k-háng	Shu Han
Cò̤-ngôi	Cao Wei
Hiŏng-gŭ	Shiitake
Mŭk-ngī	Judasöra
Sā̤-tŏng	Bad
Gă-kéng Huòng-dá̤	Jiaqing-kejsaren
Páuk Hièng-īng	Pak Hon-yong
Dô̤-guŏng Huòng-dá̤	Daoguang-kejsaren
Hièng-hŭng Huòng-dá̤	Xianfeng-kejsaren
Hùng Séu-ciòng	Hong Xiuquan
Gĭng-kiŏk	Pekingopera
Báik-guá	Bagua
Áng-pŭng	Ampulex compressa
Hŭng-sṳ̆k	Konvention
Bĭng-sĭng	Bing Xin
Biék	Lädersköldpaddor
Báik-nguŏk-cáik	Månfestivalen
Guŏng-Dṳ̆ng Huòng-dá̤	Nguyen Hue
Ngà̤ Táuk-sĭng	Watchman Nee
Liŏh-chiông-gĭ	Videobandspelare
Dâng-chái	Blåmusslor
Gā-cō̤	Loppor
Mā-tái Hók Ĭng	Matteusevangeliet
Sĕk-cê-gá	Kristet kors
Tè̤ng-chō̤	Larvsvamp
Ī-hók-sū Cṳ̆	Efesierbrevet
Uŏk-nàng Gê̤ṳng-sāng-dōng	Vietnams kommunistiska parti
10000	10000 (tal)
Kū-guă	Bittergurka
Mìng-miâng Huòng-dá̤	Minh Mang
Dĭk Ìng-giĕk	Dí Rénjié
Ì-cŭk	Yi (folk)
Dâing Lâ̤-gŭng	Teresa Teng
Mìng-sìng Huòng-hâiu	Min Myongsong
Sṳ̀ng-chéu (Hók-ciŭ chê-chéu)	Banyan
Sê̤ṳ-dáik Huòng-dá̤	Tu Duc
Cṳ̀-ciŏng	Kakel
Ngù Săng-gié	Wu Sangui
Gŏ̤ Dé-sêng	Gao Zhisheng
Huăng-giāng	Utländsk bakgrund
Tiăng-dŏng	Vardagsrum
Ók-dāu	Strykjärn
Liŏh-dà	Grönt te
Liŏh-dâu	Mungböna
Dièu-siēng-cŭk	Koreaner
Páuk Hông-ciŏ	Pak Pong-ju
Hŭk-dáng Dâi-hŏk	Fudanuniversitetet
Lêng Gié-hĕk	Ling Jihua
Hòng-ciŭ Să̤-hù	Xihu
Gă-săk-giāng	Stadsbil
Gái-chái	Sareptasenap
Siông-hāi Gău-tŭng Dâi-hŏk	Shanghai Jiao Tong-universitetet
Bù-sìng	Egentliga flugor
Ciū-ciòng	Jiuquan
Hŭ-huò-hô̤-dĕk	Hohhot
Hà-iù	Fisksås
Băh-ngiê	Termiter
Ngièng Hók	Yan Fu
Páu-diông	Smällare
Mā-cū (Dō̤)	Matsuöarna
Ăng-kă̤	Anxi
Să̤-cŏng	Kostym (dräkt)
Ìng-cṳ̄	Människosonen
Hiroshima-gâing	Hiroshima prefektur
Chiēng-cāi	Finger
Hwanghae Nàng-dô̤	Södra Hwanghae
Hók-tīng	Fuding
Siĕu-ciū	Baijiu
Dùng-cé	Kamrat (tilltalsord)
Hŭng-tiŭ	Cykelpump
Gióng-iòng	Jianyang, Nanping
Mìng-kă̤	Mingxi
Hùng-siĕu	Yunxiao
Káh-gă	Hakka
Bâng-ā	Mutism
Chék-nguŏk-buáng	Spökfesten
Hù-siŭ	Väderål
Huò-sĭng	Heshen
Tái-sông	Taishun
Chŏng-nàng	Cangnan
Ngṳ̀-uòng	Fiskbullar
Lìng Sĕng	Lin Sen
Buò-gì	Livistona chinensis
Cūi-giĕ	Hoplobatrachus rugulosus
Dìng Gēng	Tran Thai Tong
Dièu-siēng Buáng-dō̤ lĭk-sṳ̄	Koreas historia
Huá-huá	Tofsmajna
Lī Gŭng-ūng	Ly Thai To
Hók-gióng tū-làu	Fujian Tulou
Chĭng-mìng	Qingmingfestivalen
Nê-hù	Erhu
Pū-tŭng-uâ	Standardkinesiska
Siă-cŭk	She (folk)
Mē̤ng-giāng	Fjärilsmyggor
Mĭk-pŭng	Långtungebin
Okinawa-gâing	Okinawa prefektur
Diòng-lŏ̤h	Changle, Fuzhou
Nàng-ā	Sydasien
Guòng-lé	Rättighet
Gióng-nìng	Jianning
Gŭng-sĭ	Företag
Tŏng-diè-dáing	Badhus
Tì-kŭ	Spansk makrill
Ŭ-cṳ̄ng-nè̤ng	Svart (hudfärg)
Nàng-uŏk-guók	Nanyue
Chèng-chṳ̄	Sorkar
Kiŏng-cŭk	Qiang
Uòng-lièng	Coptis chinensis
Chèng	Odlingsmark
Bĭng-dê̤ṳ	Isglass
Wikipedia:Sū-iū ngṳ̄-ngiòng bēng-buōng gì Wikipedia	Wikipedia:Wikipedia på andra språk
Ngṳ̆k-huòng-dâi-dá̤	Jadekejsaren
À̤-liák	Tofflor
Lī-dièu	Lydynastin
Cé̤ṳk	Rissoppa
Dĕ̤ng-cáik	Dongjinal
Mìng-ciō Céng-buô-dōng	Demokratiska framstegspartiet
Ì-cô̤-hūng	Tvättmedel
Tĕng	Knivmussla
Pàng-hù Gùng-dō̤	Pescadorerna
Hāi-chŏng	Haicang
Muōi-sì	Vattenkastanj
Dĕ̤ng-săng	Dongshan, Zhangzhou
Cĭk-mī	Jimei
Dùng-ăng	Tong'an
Dài-gĕ̤ng	Taijiang, Fuzhou
Lṳ̀ng-hāi	Longhai
Siŏh-săi	Shishi, Quanzhou
Siòng-ăng	Xiang'an
Mìng-âu	Minhou
Siêu-ū	Shaowu
Ôi	Magsäck
Chŏng-săng	Cangshan, Fuzhou
Sibu	Sibu
Lū-bék	Kinabulbyl
Ciŭ Ū-uòng	Zhou Wu
Diòng-tái	Changtai
Diòng-tĭng	Changting
Cṳ̆-dó̤h	Skrivbord
Siàng-siŏng	Chengxiang
Chèng-lòi	Sumpsnäckor
Lī-siàng	Licheng, Quanzhou
Ciòng-gē̤ng	Quangang
Niŏh-hâ-ciŏ	Phyllanthus urinaria
Ĕ̤ng-ngiê	Tetramorium
Sô̤i	Sittande
Siĕu	Dizi
Mā-lái-iè	Heteropoda venatoria
Sêu-nìng	Shouning
Káh-dièu	Lek
Lŏk-gŏng	Luojiang, Quanzhou
Kŭ-chèng	Gutian
Dâi-dièng	Datian
Dáik-huá	Dehua
Hà-mà-chāu	Plantago asiatica
Là̤ Lé	Le Loi
Găng-chō̤	Glycyrrhiza uralensis
Huà-ăng	Hua'an
Nìng-huá	Ninghua
Iù-kă̤	Youxi
Chĭng-liù	Qingliu
Să-gâing	Sha
Lièng-siàng	Liancheng
Sông-chiŏng-gâing	Shunchang
Lò̤-nguòng	Luoyuan
Bìng-nàng	Pingnan, Ningde
Bìng-tàng	Pingtan
Nàng-ăng	Nan'an, Quanzhou
Dṳ̀-huák	Division (matematik)
Hù-lù	Flaskkurbits
Ciŏng-lŏk	Jiangle
Hù-lī	Huli, Xiamen
Īng-dêng	Yongding, Longyan
Sṳ̀ Cài-hâiu	Xu Caihou
Céng-ăng	Jin'an, Fuzhou
Gū-làu	Gulou, Fuzhou
Séu-sê̤ṳ	Xiuyu
Īng-chŭng	Yongchun
Ciĕu-siàng	Jiaocheng, Ningde
Siĕng-iù	Xianyou
Iòng-bìng-kṳ̆	Yanping
Sĭng-lò̤-kṳ̆	Xinluo
Puō-siàng	Pucheng, Nanping
Săng-nguòng	Sanyuan, Fujian
Hàng-gŏng	Hanjiang, Putian
Hŭng-dĕk	Fengze
Lié-siàng	Licheng, Putian
Siông-hòng-gâing	Shanghang
Sṳ̀ng-kă̤-gâing	Songxi
Ū-bìng	Wuping
Nàng-cêng	Nanjing, Zhangzhou
Lè̤ng-ê̤ṳ Tái-hâiu	Longyu
Hók-ăng	Fu'an
Mìng-chiăng	Minqing
Gióng-ĕu	Jian'ou
Mā-muōi	Mawei
Īng-tái	Yongtai
Lṳ̀ng-ùng	Longwen
Sṳ̆-mìng	Siming
Hiê-ăng	Hui'an
Bìng-huò	Pinghe
Tái-nìng	Taining
Guŏng-dĕk	Guangze
Īng-ăng	Yong'an
Ùng-dé̤ṳk	Fjädersparris
分類:Dáik-guók	Kategori:Tyskland
分類:É-dâi-lé	Kategori:Italien
分類:Mī-guók	Kategori:USA
分類:Ngò̤-lò̤-sṳ̆	Kategori:Ryssland
分類:Dṳ̆ng-guók	Kategori:Kina
分類:Nĭk-buōng	Kategori:Japan
分類:Ó̤-ciŭ	Kategori:Australien
Iĕk-cūi-ké	Värmevatten
分類:Éng-nà̤	Kategori:Indonesien
分類:Hàng-guók	Kategori:Sydkorea
分類:Tái-guók	Kategori:Thailand
分類:Uŏk-nàng	Kategori:Vietnam
分類:Buô-ṳ̄ dông-ŭk	Kategori:Däggdjur
分類:Bà-hèng dông-ŭk	Kategori:Kräldjur
分類:Cēu	Kategori:Fåglar
分類:Cĭng-kṳ̄ng	Kategori:Svampar
分類:Sĭk-ŭk	Kategori:Växter
分類:Ŭk-lī	Kategori:Fysik
分類:Huá-hŏk	Kategori:Kemi
分類:Lĭk-sṳ̄	Kategori:Historia
分類:Dê-lī	Kategori:Geografi
分類:Siâ-huôi	Kategori:Samhälle
分類:Cŭng-gáu	Kategori:Religion
分類:Tā̤-ṳ̆k	Kategori:Sport
分類:Kuŏ-hŏk	Kategori:Vetenskap
分類:Gióng-dé̤ṳk-ŭk	Kategori:Byggnader
Gū Lò̤-mā	Romerska riket
Liù-giāng	Corbiculidae
Cūi-kì	Sniglar
分類:Sĕng-tái	Kategori:Ekologi
Sák-mū-ngī-gé-cièng-cṳ̆	Första Samuelsboken
分類:Disambig	Kategori:Förgreningssidor
分類:Diék-hŏk	Kategori:Filosofi
分類:Sĭng-lī	Kategori:Psykologi
分類:Hŭk-gáu	Kategori:Buddhism
分類:Gĭ-dók-gáu	Kategori:Kristendom
分類:Ĭ-sṳ̆-làng-gáu	Kategori:Islam
分類:Iù-tái-gáu	Kategori:Judendom
Kiê	Stående
Mā-cū	Matsu
Dĭ-dă	Suona
Gùng	Kjol
Tuyên Quang	Tuyen Quang (provins)
Dà-gī	Soffbord
Iraq gâe̤ng Levant Ĭ-sṳ̆-làng-guók	Islamiska staten
Pàng-kì	Sesarmidae
Ì-ngṳ̄	Yi-språken
Tău-dò̤-nó̤h	Stöld
Ciĕ-muài	Sesam (växt)
Abu Bakr al-Baghdadi	Abu Bakr al-Baghdadi
分類:Ùng-huá	Kategori:Kultur
分類:Dê-cék	Kategori:Geologi
Dìng-dièu	Trandynastin
Wikipedia:Dŏng-nièng gĭng-dáng	Wikipedia:Dagens händelser
模板:Tái-iòng-hiê	Mall:Solsystemet
Gì-chái	Amaranthus tricolor
Ciē-sáik	Purpur
Gâng	Svettning
Sìng (bòng-hâ̤)	Scylla serrata
Ià-huò-huà	Jehova
Sók-lŭk	Fart
Duâi-tàu-chái	Majrova
Huăng-siông	Mango
分類:Dáik-guók ìng-ŭk	Kategori:Tyskar
分類:Mī-guók ìng-ŭk	Kategori:Amerikaner
分類:Iēng-uòng	Kategori:Skådespelare
分類:Ĭng-guók ìng-ŭk	Kategori:Britter
分類:Huák-guók ìng-ŭk	Kategori:Fransmän
模板:Chess diagram	Mall:Schack-pos
模板:Tl	Mall:Mall
分類:Guók-gă	Kategori:Världens länder
Wikipedia:Hèng-céng Ìng-uòng	Wikipedia:Administratörer
分類:Ìng-ŭk	Kategori:Personer
分類:Cék-ngiĕk	Kategori:Yrken
Wikipedia:Gĭ-ké-nè̤ng	Wikipedia:Robotar
分類:Sì-găng	Kategori:Tid
分類:Gĕ̤ng-tiàng	Kategori:Ingenjörsvetenskap
分類:Cài-lâiu	Kategori:Material
分類:Ĭ-hŏk	Kategori:Medicin
分類:Céng-dê	Kategori:Politik
分類:Gáu-ṳ̆k	Kategori:Utbildning
Ăi-gĭk	Egypten
模板:Bot	Mall:Bot
Gă-nā-dâi	Kanada
分類:Iù-hié	Kategori:Spel
分類:Ĕu-ciŭ guók-gă	Kategori:Europas länder
分類:Ĕu-ciŭ	Kategori:Europa
模板:Documentation	Mall:Dokumentation
分類:Ê̤ṳng-hô	Kategori:Användare efter språk
模板:Softredirect	Mall:Mjuk omdirigering
Wikipedia:維基數據	Wikipedia:Wikidata
模板:Chēng	Mall:Radera
分類:Ngṳ̄-ngiòng	Kategori:Språk
分類:Lĭk-huák	Kategori:Kalendrar
分類:Wikipedia	Kategori:Wikipedia
Wikipedia:Mò̤ hô-cáik sĭng-mìng	Wikipedia:Allmänt förbehåll
分類:未索引其頁面	Kategori:Icke-indexerade sidor
Dâi-chṳ̄	Känguru
模板:!	Mall:!
模板:!-	Mall:!-
模板:Smallcaps	Mall:Kapitäler
模板:Nowrap	Mall:Nowrap
Wikipedia:Ék-chiék Wikipedia dŭ găi-dŏng ô gì ùng	Wikipedia:Artiklar som bör finnas på Wikipedia
分類:Hĭ-ciŭ	Kategori:Afrika
模板:Wikisource	Mall:Wikisource
模板:Babel	Mall:Babel
模板:Commons	Mall:Commons
Wikipedia:列明來源	Wikipedia:Källhänvisningar
模板:Stub	Mall:Stub
模板:User eo-1	Mall:Användare eo-1
模板:User eo-3	Mall:Användare eo-3
模板:User de	Mall:Användare de
模板:User de-1	Mall:Användare de-1
模板:User es	Mall:Användare es
模板:User de-3	Mall:Användare de-3
模板:User en-3	Mall:Användare en-3
模板:User en-1	Mall:Användare en-1
模板:User en-2	Mall:Användare en-2
模板:User eo-2	Mall:Användare eo-2
模板:User en-4	Mall:Användare en-4
模板:User en	Mall:Användare en
模板:User de-2	Mall:Användare de-2
模板:User es-1	Mall:Användare es-1
模板:User fr-1	Mall:Användare fr-1
模板:User it-3	Mall:Användare it-3
模板:User fr-2	Mall:Användare fr-2
模板:User ja	Mall:Användare ja
模板:User ja-1	Mall:Användare ja-1
模板:User it-1	Mall:Användare it-1
模板:User fr	Mall:Användare fr
分類:Ā-ciŭ	Kategori:Asien
分類:Nàng Mī-ciŭ	Kategori:Sydamerika
分類:Mā-lài-să̤-ā	Kategori:Malaysia
模板:Mod	Mall:Mod
模板:SIL	Mall:Språk/kodlista
模板:User it	Mall:Användare it
模板:User es-2	Mall:Användare es-2
模板:Huăng-ngìng	Mall:Nybörjare
分類:Dièu-lâiu	Kategori:Smaktillsatser
分類:User fr-1	Kategori:Användare fr-1
模板:Image label	Mall:Image label
模板:Wiki gĕ̤ng-tiàng	Mall:Wikimedia Foundation
模板:Steady	Mall:Stabil
模板:Guók-gă	Mall:Landsfakta
模板:Cite journal	Mall:Tidskriftsref
模板:Infobox 公司	Mall:Företagsfakta
模板:Wikibooks	Mall:Wikibooks
模板:Hō̤ gì ùng-ciŏng	Mall:Utmärkt
分類:User en-4	Kategori:Användare en-4
分類:User en	Kategori:Användare en
分類:User zh	Kategori:Användare zh
分類:User zh-M	Kategori:Användare zh-N
分類:User en-2	Kategori:Användare en-2
模板:Infobox	Mall:Faktamall
模板:User eo	Mall:Användare eo
模板:User zh	Mall:Användare zh
分類:Gáuk-guók gì lĭk-sṳ̄	Kategori:Historia efter land
Wikipedia:Dŏng-nièng gĭng-dáng/09 nguŏk 23 hô̤	Mall:23 september
Wikipedia:Dŏng-nièng gĭng-dáng/09 nguŏk 22 hô̤	Mall:22 september
模板:Legend	Mall:Legend
Wikipedia:Dŏng-nièng gĭng-dáng/09 nguŏk 17 hô̤	Mall:17 september
Wikipedia:Dŏng-nièng gĭng-dáng/10 nguŏk 15 hô̤	Mall:15 oktober
模板:Cite web	Mall:Webbref
Wikipedia:Dŏng-nièng gĭng-dáng/09 nguŏk 28 hô̤	Mall:28 september
Wikipedia:Dŏng-nièng gĭng-dáng/10 nguŏk 22 hô̤	Mall:22 oktober
Wikipedia:Dŏng-nièng gĭng-dáng/11 nguŏk 2 hô̤	Mall:2 november
Wikipedia:Dŏng-nièng gĭng-dáng/11 nguŏk 9 hô̤	Mall:9 november
模板:Country data	Mall:Landsdata
Wikipedia:Dŏng-nièng gĭng-dáng/10 nguŏk 1 hô̤	Mall:1 oktober
Wikipedia:Dŏng-nièng gĭng-dáng/10 nguŏk 5 hô̤	Mall:5 oktober
Wikipedia:Dŏng-nièng gĭng-dáng/10 nguŏk 8 hô̤	Mall:8 oktober
分類:Īng-sĭk	Kategori:Mat och dryck
Wikipedia:Dŏng-nièng gĭng-dáng/10 nguŏk 6 hô̤	Mall:6 oktober
Wikipedia:Dŏng-nièng gĭng-dáng/10 nguŏk 17 hô̤	Mall:17 oktober
Wikipedia:Dŏng-nièng gĭng-dáng/10 nguŏk 2 hô̤	Mall:2 oktober
Wikipedia:Dŏng-nièng gĭng-dáng/09 nguŏk 16 hô̤	Mall:16 september
Wikipedia:Dŏng-nièng gĭng-dáng/09 nguŏk 19 hô̤	Mall:19 september
Wikipedia:Dŏng-nièng gĭng-dáng/10 nguŏk 25 hô̤	Mall:25 oktober
Wikipedia:Dŏng-nièng gĭng-dáng/11 nguŏk 10 hô̤	Mall:10 november
Wikipedia:Dŏng-nièng gĭng-dáng/10 nguŏk 21 hô̤	Mall:21 oktober
Wikipedia:Dŏng-nièng gĭng-dáng/09 nguŏk 15 hô̤	Mall:15 september
Wikipedia:Dŏng-nièng gĭng-dáng/09 nguŏk 4 hô̤	Mall:4 september
Wikipedia:Dŏng-nièng gĭng-dáng/09 nguŏk 8 hô̤	Mall:8 september
Wikipedia:Dŏng-nièng gĭng-dáng/10 nguŏk 4 hô̤	Mall:4 oktober
Wikipedia:Dŏng-nièng gĭng-dáng/09 nguŏk 1 hô̤	Mall:1 september
Wikipedia:Dŏng-nièng gĭng-dáng/09 nguŏk 6 hô̤	Mall:6 september
Wikipedia:Dŏng-nièng gĭng-dáng/09 nguŏk 25 hô̤	Mall:25 september
Wikipedia:Dŏng-nièng gĭng-dáng/09 nguŏk 10 hô̤	Mall:10 september
Wikipedia:Dŏng-nièng gĭng-dáng/09 nguŏk 26 hô̤	Mall:26 september
Wikipedia:Dŏng-nièng gĭng-dáng/09 nguŏk 20 hô̤	Mall:20 september
Wikipedia:Dŏng-nièng gĭng-dáng/11 nguŏk 4 hô̤	Mall:4 november
Wikipedia:Dŏng-nièng gĭng-dáng/09 nguŏk 30 hô̤	Mall:30 september
Wikipedia:Dŏng-nièng gĭng-dáng/10 nguŏk 7 hô̤	Mall:7 oktober
Wikipedia:Dŏng-nièng gĭng-dáng/10 nguŏk 19 hô̤	Mall:19 oktober
Wikipedia:Dŏng-nièng gĭng-dáng/09 nguŏk 27 hô̤	Mall:27 september
Wikipedia:Dŏng-nièng gĭng-dáng/09 nguŏk 11 hô̤	Mall:11 september
Wikipedia:Dŏng-nièng gĭng-dáng/11 nguŏk 8 hô̤	Mall:8 november
Wikipedia:Dŏng-nièng gĭng-dáng/11 nguŏk 1 hô̤	Mall:1 november
Wikipedia:Dŏng-nièng gĭng-dáng/11 nguŏk 7 hô̤	Mall:7 november
Wikipedia:Dŏng-nièng gĭng-dáng/10 nguŏk 11 hô̤	Mall:11 oktober
Wikipedia:Dŏng-nièng gĭng-dáng/11 nguŏk 3 hô̤	Mall:3 november
Wikipedia:Dŏng-nièng gĭng-dáng/10 nguŏk 20 hô̤	Mall:20 oktober
Wikipedia:Dŏng-nièng gĭng-dáng/10 nguŏk 16 hô̤	Mall:16 oktober
Wikipedia:Dŏng-nièng gĭng-dáng/10 nguŏk 14 hô̤	Mall:14 oktober
Wikipedia:Dŏng-nièng gĭng-dáng/10 nguŏk 18 hô̤	Mall:18 oktober
Wikipedia:Dŏng-nièng gĭng-dáng/10 nguŏk 24 hô̤	Mall:24 oktober
Wikipedia:Dŏng-nièng gĭng-dáng/10 nguŏk 3 hô̤	Mall:3 oktober
Wikipedia:Dŏng-nièng gĭng-dáng/09 nguŏk 7 hô̤	Mall:7 september
分類:Săng	Kategori:Berg
模板:IPA	Mall:IPA
分類:Céng-dê-gă	Kategori:Politiker
分類:Mī-ciŭ	Kategori:Amerika
分類:Gáuk-guók gì ìng-ŭk	Kategori:Personer efter nationalitet
模板:Wiki-huá	Mall:Ickewiki
分類:Gŭng-sê̤ṳ	Kategori:Militärväsen
模板:Increase	Mall:Öka
模板:Ciŭ-gĭ-biēu	Mall:Periodiska systemet navbox
模板:User nl	Mall:Användare nl-N
模板:Infobox 網站	Mall:Infobox webbplats
Wikipedia:Dŏng-nièng gĭng-dáng/10 nguŏk 12 hô̤	Mall:12 oktober
模板:Decrease	Mall:Minska
模板:User no-2	Mall:Användare no-2
模板:Image label end	Mall:Image label end
模板:Documentation subpage	Mall:Dokumentationssida
Wikipedia:Dŏng-nièng gĭng-dáng/11 nguŏk 5 hô̤	Mall:5 november
Wikipedia:Dŏng-nièng gĭng-dáng/10 nguŏk 13 hô̤	Mall:13 oktober
Wikipedia:Dŏng-nièng gĭng-dáng/09 nguŏk 3 hô̤	Mall:3 september
Wikipedia:Dŏng-nièng gĭng-dáng/09 nguŏk 24 hô̤	Mall:24 september
模板:Purge	Mall:Rensa
模板:Lang-la	Mall:Lang-la
分類:Cìng-gāng	Kategori:Känslor
模板:Dṳ̆ng-huà Ìng-mìng Gê̤ṳng-huò-guók Hèng-céng-kṳ̆	Mall:Kina
模板:Userpage	Mall:Wikipediaanvändare
模板:User	Mall:Anv-data
Wikipedia:Dŏng-nièng gĭng-dáng/09 nguŏk 12 hô̤	Mall:12 september
Wikipedia:Dŏng-nièng gĭng-dáng/09 nguŏk 2 hô̤	Mall:2 september
Wikipedia:Dŏng-nièng gĭng-dáng/11 nguŏk 6 hô̤	Mall:6 november
Wikipedia:Dŏng-nièng gĭng-dáng/09 nguŏk 18 hô̤	Mall:18 september
Wikipedia:Dŏng-nièng gĭng-dáng/10 nguŏk 10 hô̤	Mall:10 oktober
Wikipedia:Dŏng-nièng gĭng-dáng/10 nguŏk 9 hô̤	Mall:9 oktober
Wikipedia:Dŏng-nièng gĭng-dáng/10 nguŏk 23 hô̤	Mall:23 oktober
模板:Image label small	Mall:Image label small
模板:User fr-3	Mall:Användare fr-3
模板:Gô-dā̤ gì guók-gă	Mall:Historisk stat
分類:User ja-M	Kategori:Användare ja-N
模板:Gì-ngiê	Mall:Förgrening
分類:Dièu-siēng lĭk-sṳ̄	Kategori:Koreas historia
模板:Lang-grc	Mall:Lang-grc
模板:User ksh	Mall:Användare ksh
模板:User yue-3	Mall:Användare zh-yue-3
模板:AUS	Mall:AUS
模板:User yue-1	Mall:Användare zh-yue-1
模板:Lifetime	Mall:FD
分類:Sĕng-ŭk	Kategori:Organismer
Wikipedia:Dŏng-nièng gĭng-dáng/9 nguŏk	Wikipedia:Dagens händelser/September
Wikipedia:Dŏng-nièng gĭng-dáng/09 nguŏk 14 hô̤	Mall:14 september
Wikipedia:Dŏng-nièng gĭng-dáng/09 nguŏk 9 hô̤	Mall:9 september
Wikipedia:Dŏng-nièng gĭng-dáng/09 nguŏk 13 hô̤	Mall:13 september
Wikipedia:Dŏng-nièng gĭng-dáng/10 nguŏk	Wikipedia:Dagens händelser/Oktober
分類:User vi-3	Kategori:Användare vi-3
模板:User la-1	Mall:Användare la-1
分類:User fr	Kategori:Användare fr
分類:User ja	Kategori:Användare ja
分類:User la	Kategori:Användare la
分類:User fr-3	Kategori:Användare fr-3
分類:User it-3	Kategori:Användare it-3
分類:User ja-3	Kategori:Användare ja-3
分類:User fr-2	Kategori:Användare fr-2
分類:User it-2	Kategori:Användare it-2
分類:User ja-2	Kategori:Användare ja-2
分類:User la-2	Kategori:Användare la-2
分類:User ko-M	Kategori:Användare ko-N
分類:User fr-M	Kategori:Användare fr-N
分類:User it-M	Kategori:Användare it-N
分類:User nl-M	Kategori:Användare nl-N
模板:User yue	Mall:Användare zh-yue
分類:Ùng-cê	Kategori:Skrift
分類:Dô̤-gáu	Kategori:Taoism
分類:Dō̤	Kategori:Öar
分類:User de	Kategori:Användare de
分類:User de-2	Kategori:Användare de-2
分類:User de-3	Kategori:Användare de-3
分類:User de-M	Kategori:Användare de-N
分類:User en-3	Kategori:Användare en-3
分類:User en-M	Kategori:Användare en-N
分類:User es	Kategori:Användare es
分類:User es-1	Kategori:Användare es-1
分類:User es-2	Kategori:Användare es-2
分類:User es-3	Kategori:Användare es-3
分類:User es-M	Kategori:Användare es-N
分類:User it	Kategori:Användare it
分類:User it-1	Kategori:Användare it-1
分類:User ja-1	Kategori:Användare ja-1
分類:User ko	Kategori:Användare ko
分類:Mī-guók gì ciŭ	Kategori:USA:s delstater
分類:User ko-1	Kategori:Användare ko-1
分類:User ko-2	Kategori:Användare ko-2
分類:User ko-3	Kategori:Användare ko-3
分類:User ksh	Kategori:Användare ksh
分類:User ksh-M	Kategori:Användare ksh-N
分類:User la-1	Kategori:Användare la-1
Wikipedia:Dŏng-nièng gĭng-dáng/09 nguŏk 29 hô̤	Mall:29 september
分類:User la-3	Kategori:Användare la-3
分類:User la-M	Kategori:Användare la-N
Wikipedia:Dŏng-nièng gĭng-dáng/09 nguŏk 5 hô̤	Mall:5 september
模板:Distinguish	Mall:Förväxlas
分類:Huâng-cô̤i	Kategori:Brott
Sáik-mō̤	Djurlöss
分類:Séng-sék	Kategori:Informationsvetenskap
分類:Hāi	Kategori:Hav
Hŭng-siéng	Fläkt
分類:Guōng-dĕ̤ng	Kategori:Guangdong
分類:Hók-gióng	Kategori:Fujian
分類:Gĭng-cá̤	Kategori:Ekonomi
分類:Ciék-ciĕ dông-ŭk	Kategori:Leddjur
分類:Hĭ-ciŭ guók-gă	Kategori:Afrikas länder
分類:Gáuk-guók gì gáu-ṳ̆k	Kategori:Utbildning efter land
Wikipedia:Dŏng-nièng gĭng-dáng/11 nguŏk	Wikipedia:Dagens händelser/November
模板:User ja-2	Mall:Användare ja-2
分類:User vi	Kategori:Användare vi
分類:User vi-1	Kategori:Användare vi-1
分類:User vi-2	Kategori:Användare vi-2
分類:User vi-M	Kategori:Användare vi-N
分類:Ciék-gŏng	Kategori:Zhejiang
分類:Ĭng-ngŏk-gă	Kategori:Musiker
模板:Lang	Mall:Lang
Wikipedia:Dŏng-nièng gĭng-dáng/09 nguŏk 21 hô̤	Mall:21 september
分類:Hŏk-sŭk	Kategori:Academica
模板:Infobox Language/family-color	Mall:Språk/familj-färg
分類:Ò̤	Kategori:Vattendrag
模板:User la-2	Mall:Användare la-2
分類:Dâi-hàng Mìng-guók ìng-ŭk	Kategori:Sydkoreaner
分類:Sôi-diēng ìng-ŭk	Kategori:Svenskar
分類:Nĭk-buōng ìng-ŭk	Kategori:Japaner
分類:Dài-uăng ìng-ŭk	Kategori:Taiwaneser
分類:User nl	Kategori:Användare nl
分類:User zh-1	Kategori:Användare zh-1
分類:User zh-3	Kategori:Användare zh-3
分類:User zh-2	Kategori:Användare zh-2
分類:Cāi	Kategori:Papper
分類:Ông-ò̤	Kategori:Kanaler
分類:Uŏk-nàng ìng-ŭk	Kategori:Vietnameser
分類:Ngò̤-lò̤-sṳ̆ ìng-ŭk	Kategori:Ryssar
分類:Hiŏng-gē̤ng ìng-ŭk	Kategori:Personer från Hongkong
分類:Ciĕk-káik ìng-ŭk	Kategori:Tjecker
分類:Tái-guók ìng-ŭk	Kategori:Thailändare
分類:Sáng	Kategori:Efternamn
分類:Dièu-siēng Mìng-ciō-ciō-ngiê Ìng-mìng Gê̤ṳng-huò-guók	Kategori:Nordkorea
分類:Dṳ̆ng-guók ìng-ŭk	Kategori:Kineser
分類:Dièu-siēng	Kategori:Korea
分類:Dài-uăng	Kategori:Taiwan
分類:Dièu-siēng Mìng-ciō-ciō-ngiê Ìng-mìng Gê̤ṳng-huò-guók ìng-ŭk	Kategori:Nordkoreaner
分類:Hók-gióng-nè̤ng	Kategori:Personer från Fujian
分類:Dâi-iòng-ciŭ guók-gă	Kategori:Oceaniens länder
分類:Báe̤k Mī-ciŭ guók-gă	Kategori:Nordamerikas länder
分類:Ngṳ̀	Kategori:Fiskar
分類:Cūi-guō	Kategori:Frukter
分類:Niōng-tā̤ dông-ŭk	Kategori:Blötdjur
分類:Só-cê	Kategori:Talsystem
分類:Gióng-dé̤ṳk cài-lâiu	Kategori:Byggnadsmaterial
分類:Dông-ŭk	Kategori:Djur
分類:Ciáh-tùi dông-ŭk	Kategori:Ryggradsdjur
分類:Guòng-lé	Kategori:Rättigheter
分類:Ìng-guòng	Kategori:Mänskliga rättigheter
分類:Ū-ké	Kategori:Vapen
分類:Nàng Mī-ciŭ guók-gă	Kategori:Sydamerikas länder
分類:Gă-sĭ	Kategori:Möbler
分類:Ké-chiông	Kategori:Meteorologi
分類:Dṳ̆ng Mī-ciŭ	Kategori:Centralamerika
分類:Hiŏng-gē̤ng	Kategori:Hongkong
分類:Ĭ-siòng	Kategori:Kläder
分類:Cáik-nĭk	Kategori:Festivaler
分類:Kuàng-ciék dông-ŭk	Kategori:Ringmaskar
分類:Bâng	Kategori:Sjukdomar
分類:Kiŏng-diòng dông-ŭk	Kategori:Nässeldjur
分類:Gùng-dō̤	Kategori:Ögrupper
分類:Káh-dièu-nó̤h	Kategori:Leksaker
分類:Gă-dìng	Kategori:Familjeliv
分類:Dṳ̆ng-guók huòng-dá̤	Kategori:Kinesiska kejsare
分類:Huòng-dá̤	Kategori:Kejsare
分類:Nguòng-dièu huòng-dá̤	Kategori:Yuandynastins kejsare
分類:Chĭng-dièu huòng-dá̤	Kategori:Qingdynastins kejsare
分類:Báe̤k Mī-ciŭ	Kategori:Nordamerika
分類:Gŏ̤-chiū	Kategori:Sångare
分類:Hù	Kategori:Insjöar
分類:Só-hŏk-gă	Kategori:Matematiker
模板:Infobox ngṳ̄-ngiòng	Mall:Språk
分類:Dâi-iòng-ciŭ	Kategori:Oceanien
分類:Tiĕng-căi	Kategori:Naturkatastrofer
分類:Gô-dā̤ gì guók-gă	Kategori:Historiska länder och riken
Vĩnh Long	Vinh Long (provins)
Cāi-puŏi	Wellpapp
分類:Giông-kŏng	Kategori:Hälsa
Hâ-cé	Sommarsolståndet
分類:Sĕng-lī	Kategori:Fysiologi
Trojany	Trojany
模板:Infobox color	Mall:Färg infobox
分類:Ā-ciŭ guók-gă	Kategori:Asiens länder
模板:User yue-2	Mall:Användare zh-yue-2
模板:User la	Mall:Användare la
分類:Huák-lŭk	Kategori:Lagar
分類:Dṳ̆ng Mī-ciŭ guók-gă	Kategori:Centralamerikas länder
分類:Bēng-guòng	Kategori:Upphovsrätt
分類:Ôi-sĕng	Kategori:Hygien
分類:Hók-ciŭ-nè̤ng	Kategori:Personer från Fuzhou
分類:User cdo	Kategori:Användare cdo
分類:User cdo-M	Kategori:Användare cdo-N
模板:Image label begin	Mall:Image label begin
模板:User vi	Mall:Användare vi
分類:User en-1	Kategori:Användare en-1
分類:User de-1	Kategori:Användare de-1
分類:Gă-sĭ-huă	Kategori:Verktyg
Lăk-dâi-cé-liŏk Siông	Första Krönikeboken
分類:Mìng-cŭk	Kategori:Etniciteter
Wikipedia:失效鏈接	Wikipedia:Döda länkar
Liù-giù	Ryukyuöarna
Gŭng-ô-nguòng	Statsförvaltning
Hù-diĕk	Dagfjärilar
模板:Ping	Mall:Ping
模組:Arguments	Modul:Arguments
特殊:最近其改變	Special:Senaste ändringar
模組:HtmlBuilder	Modul:HtmlBuilder
模組:Coordinates	Modul:Coordinates
模組:Math	Modul:Math
模組:Infobox	Modul:Infobox
Ciá	Saccharum
