Mo'hetaneho'e	Afrika
Norway	Norge
Ireland (Republic)	Irland
Spain	Spanien
United States	USA
Poland	Polen
Lithuania	Litauen
Italy	Italien
Switzerland	Schweiz
Austria	Österrike
Turkey	Turkiet
Héesevo'tamahpe	Öl
Hóxovê-hooma	Europa
Asia	Asien
Wikipedia	Wikipedia
Netherlands	Nederländerna
Vášêtaëno	Washington, D.C.
San Francisco	San Francisco
Los Angeles	Los Angeles
Tséohketoetanóto	Dator
Netse Ôhmo'ôhtávaestse	Barack Obama
Má'xeme	Äpple
Paris	Paris
Mé'šeeséve'ho'évenó	Mexiko
California	Kalifornien
Péhpe'énanóse'hame	Lejon
France	Frankrike
Oeškese	Hund
United Kingdom	Storbritannien
China (People's Republic of China)	Kina
Manestôtse	Alkoholdryck
Russia	Ryssland
Ma'evé'ho'éno	Tyskland
Ame'hahtôtse'	Flygplan
Ukraine	Ukraina
Czechia	Tjeckien
Slovakia	Slovakien
Slovenia	Slovenien
Roma	Rom
Croatia	Kroatien
Wolfgang Amadeus Mozart	Wolfgang Amadeus Mozart
Mo'hetaneho'e hánêsóvóne	Sydafrika
Mahpe	Vatten
Chile	Chile
Serbia	Serbien
Taa'é-eše'he	Månen
Tsésáa-nanóhehane ame'hahtôtse	Ufo
Vé'ôhkêheóvemá'xeme	Citron
Vóhka'émene	Banan
Hotohke	Stjärna
Éše'he	Solen
Chihuahua	Chihuahua (delstat)
Tonga	Tonga
Nauru	Nauru
Mo'éhno'ha	Häst
Hova	Djur
Kokêhéaxa	Tamhöna
Arizona	Arizona
Amérika	Amerika
Utah	Utah
Republic of China	Taiwan
Ma'aataemeo'o	Tåg
Vietnam	Vietnam
Véhone-ma'kaata	Guld
Tanzania	Tanzania
Zambia	Zambia
Zimbabwe	Zimbabwe
Republic of the Congo	Kongo-Brazzaville
Democratic Republic of the Congo	Kongo-Kinshasa
Madagascar	Madagaskar
Malawi	Malawi
Namibia	Namibia
Julius Caesar	Julius Caesar
South Dakota	South Dakota
Ho'honáéšé'e	Montana
Wyoming	Wyoming
Nevada	Nevada
Colorado	Colorado
Tseohke-pano'ohe	Fruktkonserv
Category:Wikipedia content	Kategori:Topp
Chicago	Chicago
Mene	Frukt
Meškêso	Insekter
Amâho'hestôtse	Bil
Toháano'ého'ëva	Texas
Buenos Aires	Buenos Aires
Barcelona	Barcelona
Šéstotó'emeno	Ananas
Ma'xeé'ome'tää'e	Mississippifloden
Caracas	Caracas
Nebraska	Nebraska
Kansas	Kansas
Heévȧhetanéno	Oklahoma
Ma'heónemôxe'êstoo'o	Bibeln
Ho Chi Minh City	Ho Chi Minh-staden
Dong Hoi	Dong Hoi
Concepción	Concepción, Chile
Še'šenovôtse	Ormar
Madrid	Madrid
Santiago (Chile)	Santiago de Chile
Hévoetanâháve'ho'éotoa'e	Mjölkboskap
Mé'hahtsékósa	Tamget
Ho'ësta	Eld
Antofagasta	Antofagasta
Brazzaville	Brazzaville
Copiapó	Copiapó
Moxe'estonemaheo'o	Skola
Oomâhóoné-mâhéó'o	Hus
Ó'he'e	Flod
Eschweiler	Eschweiler
Dong Hoi Airport	Dong Hoi flygplats
Curitiba	Curitiba
Talca	Talca
Corbin Bleu	Corbin Bleu
Vôhe'so	Rede
Ve'kese	Fåglar
Almazán	Almazán
Va'ohtama	Portal:Huvudsida
Hohtsemo	Basket
Ho'honáá'e Tsé'amoo'êse	Klippiga bergen
Hóoma	Filt (textil)
Category:Candidates for speedy deletion	Kategori:Snabbraderingar
Véhpotséhohpe	Te
Axenôhonestôtse	Gitarr
Hotohke tséana'ôhtse	Meteoroid
Mâhtovoo'ôtse	Öra
Kosa	Tamfår
Pa'e'pa'onáhe	Kameler
Hésta'se	Snö
Ka'êškone	Barn
Kóhkonêhëö'o	Bröd
O'êhnémâhéó'o	Toalett
Nelson Mandela	Nelson Mandela
Vo'e	Moln
Ma'xêhevovetäso	Tromb
Mahpe hevovetäso	Tropisk cyklon
Category:Némenestôtse	Kategori:Musik
Mó'soonêó'he'e	Arkansas River
Ma'êhóóhe	Rödräv
Mo'ôhtávêhohpe	Kaffe
Matana	Mjölk
Bilbao	Bilbao
Sevilla	Sevilla
Valencia	Valencia
Vohkoohe	Kaniner
No'kéeho	Ekorrar
Ronald Reagan	Ronald Reagan
Ma'xetoeneško	Karlavagnen
Éškôseeséhotame	Svin
Hoohtsêstse	Träd
Hohpâháa'éheme	Druva
Háhnomápano'êhasëö	Honung
Aéstomemésêhestôtse	Potatis
Vé'keemahpe	Socker
Hóo'xevávôxe'êstoo'o	Tidning
Aseéestsestôtse	Telefon
Lugo	Lugo
Vóhpoma'ôhtse	Salt
Onéhavo'e	Trumma
Amo'a'óvâhtsestôtse	Cykel
Vóhpeeva	Bomull
Môxe'êstoo'o	Papper
Ová'kemâhaemenôtse	Majs
Náhkohe	Björnar
Hoéstoneéše'he	Kalender
E'kôsé'haseo'o	Crêpes
Hóxovôho'o	Bro
Jalisco	Jalisco
Hohpâhtsenámenôtse	Russin
Tsétóno	Glass
Vé'keekóhkonôhëö'o	Småkakor
Vé'keahonoo'o	Kaka
Asêséoneo'amestôtse	Slangbella
Tsé'ôhke -évo'sóévôse ka'êškóneho	Gym
Santiago de Compostela	Santiago de Compostela
Oviedo	Oviedo
Heškóvemata	Kaktusväxter
Hoohëö'o	Flagga
Táxemésêhestôtse	Bord
Heóvâhá'enëö'o	Brödrost
Táxe'êséestôtse	Stol
Tsêhe'êsenotováhe	Giraff
E'ôsé'hasëö'o	Degskrapa
Nuevo León	Nuevo León
Freddie Mercury	Freddie Mercury
Template:Link FA	Mall:Link FA
Denver	Denver
Austin (Texas)	Austin
Naa'émâhéó'o	Sjukhus
Sacramento	Sacramento
Vonomóhtâhestôtse	Acetylsalicylsyra
Hó'nehe	Varg
Henenéva'ôhease	Spetsstjärtad präriehöna
Bien Hoa	Bien Hoa
Nha Trang	Nha Trang
Breinigerberg	Breinigerberg
He'kone'éemâsono	Makaroner
Vung Tau	Vung Tau
Aruba	Aruba
Néške'ësta	Jordekorrar
Mo'kêhanôtse	Sko
Hestaahtsémeno	Vinbärssläktet
Váótséva	Hjortdjur
Má'ome	Is
Heškóvemâhöö'o	Gurka
Xaóenêhéstâhévo	Lök (art)
Moshchena	Mosjtjena
Paltoga	Paltoga
Mérida (Venezuela)	Mérida, Venezuela
Ho'ose	Kol (bränsle)
Vé'kêséhemêstaa'e	Ugglor
Ca Mau	Ca Mau
Poeso	Kattdjur
Curaçao	Curaçao
Tôhohko	Hammare (handverktyg)
Tâhpe'âséhahnoma	Humlor
He'haéheséeo'ôtse	Röllika
Vó'ho'kâsénoma'ne	Lysmaskar
Tsêhe'êsevotoná	Fasan
Sint Maarten	Sint Maarten
Heo'këso	Bisam
Héna'e	Kanadagås
Sósone'e	Shoshoner
Mâhóomoehá-vé'késo	Måsfåglar
Nanomóne-éšeëva	Stilleståndsdagen
Ôhtaenémâhéó'o	Hotell
Mâhpé-aénohe	Gråtrut
Hevavâhkema	Fjärilar
Méšenonetsénóne	Fladdermöss
Tsé-tó'hovane	Sandwich
Kingdom of the Netherlands	Kungariket Nederländerna
Heóvêstséávó'êstse	Maskrossläktet
Anonévee'tose	Vildmorot
Ónonevóneške	Präriehundar
Avril Lavigne	Avril Lavigne
Hoéstónéó'o	Miniräknare
Motšêške	Kniv
Nêškovávo'ha	Zebror
Vóhpenáhkohe	Isbjörn
Oaxaca	Oaxaca
Heóveamêške	Smör
Meo'o	Väg
Anastacia	Anastacia
Henenó'e	Rossläktet
Albuquerque	Albuquerque
Tequixquiac	Tequixquiac
Ma'xepóno'e	Oklahoma City
Nanóse'hame	Puma
Mâhpémo'éhe	Älg
Vo'kome-mâheo'o	Vita huset
Boise	Boise
Semo	Båt
Vóhkooheme	Fikon
Thanh Hoa	Thanh Hoa
Puerto Montt	Puerto Montt
Mo'otsenahkohe	Brunbjörn
Toóneohëö'o	Spik
Ma'aataéve'éxanéstotôtse	Glasögon
Campora San Giovanni	Campora San Giovanni
Tono'sëö'o	Kylskåp
Ka'énêhótame	Engelsk bulldogg
Éškôsénéhe	Greyhound
Nêxo'mévéhe	Vattenmelon
Vótâháéno tsénéma'ó'á'ha	Väderkvarn
Péhpe'éoeškëso	Pudel
Hóhkeehe	Möss
Heséeotséve'ho'e	Läkare
Ma'o'hoáá'e	Murtegel
Tó'too'he	Kungsörn
Môxe'a'xémâhéó'o	Biograf
Ma'xêheóvema'xemeno	Grapefrukt
Hohpe	Soppa
Hovéo'kôheo'	Paraply
Talcahuano	Talcahuano
Šéeše-stôtse	Säng
Ma'emonêškeho	Böna
Tsé-éškôsa'évetováto	Kon
Péhpe'épóéso	Perser (kattras)
Johnny Cash	Johnny Cash
Homôse-mâheo'o	Kök
Ma'xeamóvôhtó'hestôtse	Lastbil
Ókohke	Corvus
Háestôheóhtáhe	Enkelfotingar
Vótâháéno	Vattenbrunn
Hotóa'ôxhoo'êstse	Sitting Bull
Ma'kaataevé'késo	Kolibrier
Ma'xêhë'ne	Kalkoner
Ó'kôhóme	Prärievarg
Jim Morrison	Jim Morrison
Sonora	Sonora (delstat)
Guanajuato	Guanajuato (delstat)
Ma'kaatohko	Hink
Ována'xaetanohtôtse	Sinnesrobönen
Móxêšéne	Myntasläktet
Héne'enovâhétane	Student
Hahpenó'estôtse	Symaskin
Mo'ôhtameöhtsêstse	Afroamerikaner
Coahuila	Coahuila
Baja California	Baja California (delstat)
Ȧxeohōva	Malartade fiskar
Chiapas	Chiapas
Guerrero	Guerrero
Yucatán	Yucatán (delstat)
Colima	Colima (delstat)
Hovë'še	Wilsonbeckasin
Morelos	Morelos
Kémeöna	Dentalium
San Luis Potosí	San Luis Potosí (delstat)
Sóhkomevó'ho'kâsenestôtse	Levande ljus
Querétaro	Querétaro Arteaga
Michoacán	Michoacán de Ocampo
Durango	Durango (delstat)
Nayarit	Nayarit
Puebla	Puebla (delstat)
Aguascalientes	Aguascalientes (delstat)
Tamaulipas	Tamaulipas
Quintana Roo	Quintana Roo
Sinaloa	Sinaloa
Zacatecas	Zacatecas (delstat)
Alla Pugacheva	Alla Pugatjova
Hidalgo	Hidalgo (delstat)
Campeche	Campeche (delstat)
Tabasco	Tabasco (delstat)
Monterrey	Monterrey
Hóma'e	Amerikansk bäver
Ma'xeméstaa'e	Virginiauv
Tlaxcala	Tlaxcala (delstat)
Hotoa'e	Bisonoxe
Xäö'o	Skunkar
Grand Theft Auto: San Andreas	Grand Theft Auto: San Andreas
Háhkota	Gräshoppor
Môhtséheonetane	Apacher
É'koo'óhtotôtse	Kikare
Sena'kaneo'o	Cherokeser
Ho'óhomö'e	Sioux
Man o' War	Man O' War
Óova'e	Glimmer
Tsé-tónovo'eše ho'évohkôtse	T-benstek
Vétapâhaetó'eo'o	Kiowa
Šé'šenovotsétaneo'o	Comancher
Matšeškome	Tvättbjörn
Mo'ôhtáenáhkohe	Svartbjörn
Hohtâhé-noma'he	Guldfisk
Ho'éméhne	Daggmask
Vóaxáa'e	Vithövdad havsörn
Tónovâhonónestôtse	Stekpanna
Nêševâhá'eneo'o	Mikrovågsugn
Ame	Pemmikan
Vétaneo'hé'e	South Platte River
Tamena'éveéstse'he	T-shirt
Mohkave	Rödlo
Ta'ta'ôhëö'o	Nyckel
Grand Theft Auto	Grand Theft Auto (spelserie)
Vée'e	Tipi
Hóo'kôhévénéhe	Rain-in-the-Face
Vé'ho'êškóovo'hestôtse	Synål
He'konö'êstse	Buchloe dactyloides
Vétánó'êstse	Bredkaveldun
Oó'omêše	Rödek
Oó'xôseonéame	Jordnötssmör
Hóxâhtsenáesëö'o	Betsel
Tsé'amóneane	Stängsel
Onéma'ó'aneo'o	Nyckel (verktyg)
Vé'ôhkemahpe	Red River
Otá'tavö'êstse	Blålusern
Heóvemo'ôhta'e	Kålrot
Pachuca de Soto	Pachuca de Soto
Onéma'táo'aneo'o	Skruvmejsel
Motsé'eonôtse	Doftmyskgräs
Mótó'e	Rödask
Me'êškema	Asklönn
Hohnóhkâ-heséeo'ôtse	Ölandstok
Menôtse	Virginiahägg
Hetanemenôtse	Sen häggmispel
Hoóxe'e	Contortatall
Pó'po'êho'hémâhaemenôtse	Popcorn
Hoxo'ôhtséveotá'tavo'honáá'e	Turkos
Hevéesénoma'ne	Gädda
É'êxováhtóva	Billings, Montana
Vé'ho'éome	Tält
Vóhpâhtse-náhkohe	Grizzlybjörn
Hoeseonó'e	Madrass
Xamaesémo	Kanot
Môxéhéó'o	Kvast
Veracruz	Veracruz
Tootómôhéó'o	Luftkonditionering
Ho'êstásémo	Ångfartyg
Tséx-háenaotséstove	Spanska sjukan
Mo'éhe	Wapitihjort
Vóetséna'évôxe'êstónestôtse	Krita (bergart)
Heškóvoneanëö'o	Taggtråd
Hova'ó'xestôtse	Sadel
Vé'ho'éotóaho'évohkôtse	Nötkött
Hevá'xameško	Slev
Ma'xeamâho'hestôtse	Skåpbil
Banovci (Nijemci)	Banovci
Otá'tavâho'hé-vé'késo	Blåskrika
Mo'e'évetoo'o	Korg
Hoho	Armband
Mo'e'évôhkêha'e	Halmhatt
Âxeetoo'é'hasëö'o	Fiskekrok
Tsé'ôhke-énâhenéstove	Bensinstation
Ama'éno'hamémôxe'êstoo'o	Körkort
Nøtterøy	Nøtterøy kommun
Tôhé'kêsaéve'ho'éamo'eétâhestôtse	Rodeo
Háeohémahpe	Rapid City
Tooxo'hamëso	Shetlandsponny
Hesto'tono'kêhanôtse	Snöskor
Vé'keehoohtsêstse	Sockerlönn
Amóvôhtó'hestôtse	Pickup (fordon)
Hoóneanatóe-vó'ho'kâsénâhnestôtse	Fotogenlampa
Oómêsta'hasené-váótséva	Vitsvanshjort
Séavóneške	Skogsmurmeldjur
Ma'ëno	Sköldpaddor
Ma'evé'éso	Kardinaler
Nêhpo'aneo'o	Lås
Apaxco	Apaxco
Ma'háhko'e	Nordamerikansk grävling
Asêséeéstse'he	Tröja
Vé'ho'e	Vit (hudfärg)
Vó'ho'êho'hóvahtôtse	Ficklampa
Mo'ôhtávo'honáéva	Black Hills
Ôxa'ôhévo'kêhanôtse	Mockasiner
He'ohko	Fredspipa
Mo'ë'ha	Amerikansk skata
Sáhea'eo'o	Ojibwa
Oo'kó'êxovahtôtse	Gräsklippare
Kóhkonôheonané-mâhéó'o	Bageri
Hestóhkáhne	Paddleguaner
He'óonéma'ëno	Snappsköldpadda
Náhkôhevee'e	Devils Tower
Tsétsêhéstâhese	Cheyenner
Óoetaneo'o	Kråkindianer
Ne'potátse	Amerikansk gråhäger
Hoxomôho'haméstotôtse	Hö
Mo'éheo'hé'e	Yellowstonefloden
Ben Harper	Ben Harper
Mo'ôhtávêhahtátaneo'o	Svartfotsindianer
Tó'êsevêséhotoa'e	Texas longhorn
Amo'xestôtse	Camping
Ma'êšenévé'késo	Vandringstrast
Buffy Sainte-Marie	Buffy Sainte-Marie
A'o'tsémêstaa'e	Prärieuggla
Homenó'e	Ulmus americana
Ma'xemenó'e	Prunus americana
Vé'škee'e	Amerikansk asp
Mâhöhko	Nätmelon
Hesó'xôhéó'o	Strykjärn
Woqini	Roman Nose
Aésto'épeeneo'o	Mixer (köksmaskin)
Tsé-heše'émâheónese	Mandan
Vé'evêšéstótó'e	Röden
Hesó'xêšé'hóno	Bordsduk
Ma'xêhestâhtötse	Lyoner
Vóo'kooma	Rödhuvad hackspett
Ma'xemené-mahpe	Äppelmust
He'hemêšéonávo'ha	Appaloosa
Hetanevö'e	Arapaho
Aéstomevé'keemahpe	Sötningsmedel
Ma'xekôsáeho'honáéva	Bighorn Mountains
Éškôseeséma'ëno	Apalone spinifera
Meneo'hé'e	Platte River
Vó'aehno'xâhtóhonôtse	Leggings
Ama'éno'hamestôtse	Ratt
Mo'ôhtáevánó'êstse	Malörtsambrosia
Hóheeheo'o	Assiniboiner
Amêsema'ëno	Dossköldpaddor
Tahlequah, Heévâhetanéno	Tahlequah
Heovese'tahe	Bomullssvanskaniner
Ho'néhetane	Pawnee
Vóhka'éhemenékohkonôheo'o	Bananbröd
Háestôhe'šeméhe	Nordlig härmtrast
Môhtáevestôtse	Campingplats
Mâhaemenépénôhéó'o	Majsmjöl
Aenohe	Hökar
Otaesémenôtse	Svart valnöt
Hestáhpánó'e	Yucca glauca
Tsévó'névóvâtse	Brun (hästfärg)
Mo'e'éšé'hóno	Säckväv
Oo'kóhtâxétaneo'o	Osage
Tsêheta'éno'haméstotôtse	Hästutrustning
Mâhtä'soeo'hé'e	Green River (Utah)
Ma'xemâhoévé'ho'eno	Miles City
Óoetanéno	Crow Agency
He'konemâhoeve'ho'eno	Hardin, Montana
Vó'komêšéstótó'e	Berggran
Ho'xó'mâhoéve'ho'éno	Sheridan, Wyoming
Sonic The Hedgehog	Sonic the Hedgehog (spelserie)
Heóvôhkâho'hé-vé'késo	Gulbukad empid
Vó'omeoó'omêše	Quercus macrocarpa
Táxâhonoo'o	Majsbröd
Otaesétaneo'o	Nez Perce
Tsé'ôhkê-hóhta'hanéstove	Tingshus
Ónonevonêške-móxêšéne	Gatkamomill
A'kêstséahe	Kopparhuvud
Môxôhe'êstámenôtse	Prunus pumila
Mo'éhemóxêšéne	Anisisop
Mo'óhta'e	Psoralea esculenta
Mo'éhno'hamémâhéó'o	Ladugård
Honóxeäse	Västlig ängstrupial
Category:Ma'evé'ho'éno	Kategori:Tyskland
Category:Italy	Kategori:Italien
Category:Russia	Kategori:Ryssland
Category:Canada	Kategori:Kanada
Category:United Kingdom	Kategori:Storbritannien
Category:Spain	Kategori:Spanien
Category:Meško	Kategori:Mexiko
Category:Mo'hetaneho'e hánêsóvóne	Kategori:Sydafrika
Category:Egypt	Kategori:Egypten
Ó'óéséó'o	Klädstreck
Category:Austria	Kategori:Österrike
Category:Democratic Republic of the Congo	Kategori:Kongo-Kinshasa
Category:Poland	Kategori:Polen
Category:Switzerland	Kategori:Schweiz
Category:Tanzania	Kategori:Tanzania
Category:Ukraine	Kategori:Ukraina
Category:Vietnam	Kategori:Vietnam
Category:Ve'kêseho	Kategori:Fåglar
Category:Buildings	Kategori:Byggnader
Ma'ováhe	Konstantskimmel
Vé'ȯhkėheséeo'ȯtse	Lila temynta
Mé'konéseno'êhaseo'o	Hårnål
Ma'kestsêstse	Tältspik
Hesóva'kove	Oxfilé
Tonôhené-mâhéó'o	Smed
Mo'xôhtse	Pilhuvud
Tsé-nonomö'ta	Jell-O
Héstoomaestôtse	Sängkläder
Tsévovó'hásêstse	Skäck
Netse	Örnar
Sásêškóvéta	Nerodia sipedon
Sanápevóoma	Sarape
A'kêstséašé'šenovôtse	Kobra
Ireland	Irland (olika betydelser)
Tsé-amo'emanese	Partikongress
Ma'emenôtse	Shepherdia argentea
Séno'êhaseo'o	Hårspänne
Tó'êsemónêškeho	Haricots verts
Edmond debeaumarché	Edmond Debeaumarché
Ingrid Guimarães	Ingrid Guimarães
No'aneonó'e	Rhus glabra
Tsé-tšêške'óomoëha	Damm (vattenansamling)
Oo'kó'ôheo'o	Slåttermaskin
Category:Manȧhého'e	Kategori:Världens länder
Category:Héstanêheo'o	Kategori:Personer
Hotamó'êstse	Persicaria punctata
Mo'ôtáa-heséeo'ôtse	Lewisia rediviva
Egypt	Egypten
Tónovêšé'hóno	Kanvas
Template:Bot	Mall:Bot
Canada	Kanada
Category:Slovakia	Kategori:Slovakien
Category:Slovenia	Kategori:Slovenien
Category:Hóxovê-hooma	Kategori:Europa
Category:Wikipedia help	Kategori:Wikipedia:Hjälp
Template:Documentation	Mall:Dokumentation
Wikipedia:Community Portal	Wikipedia:Robotansökan
Template:Softredirect	Mall:Mjuk omdirigering
Template:Delete	Mall:Radera
Wikipedia:Statistics	Wikipedia:Statistik
Tóhtoo'éotá'tavö'êstse	Dalea purpurea
Template:!	Mall:!
Category:Mo'hetaneho'e	Kategori:Afrika
Template:Babel	Mall:Babel
Template:Stub	Mall:Stub
Template:User en-2	Mall:Användare en-2
Template:User en	Mall:Användare en
Category:Asia	Kategori:Asien
Category:Chile	Kategori:Chile
Category:Máhtáme	Kategori:Mat
Template:Mod	Mall:Mod
Template:User es-2	Mall:Användare es-2
Category:User en	Kategori:Användare en
Template:Template other	Mall:Mall annan
Category:Máhtáme naa tsémâhpév-oom	Kategori:Mat och dryck
Category:Vose	Kategori:Berg
Template:IPA	Mall:IPA
Category:Amérika	Kategori:Amerika
Wikipedia:Nospam	Wikipedia:Skyddade sidnamn
Template:Coord/link	Mall:Coord/link
Template:Coord	Mall:Coord
Category:Wyoming	Kategori:Wyoming
Category:User en-N	Kategori:Användare en-N
Mâ-htáeme	Djurlöss
Category:Mahpe	Kategori:Vatten
Category:Tsémâhpév-oom	Kategori:Drycker
Category:Heévȧhetanéno	Kategori:Oklahoma
Pano'êhasëö'o	Sockerlag
Category:Hoohtsêstse	Kategori:Träd
Vóhpó'êstse	Lithospermum ruderale
Mo'e'éhoo'he	Säck
Category:Nebraska	Kategori:Nebraska
Category:North Dakota	Kategori:North Dakota
Category:South Dakota	Kategori:South Dakota
Category:Idaho	Kategori:Idaho
Category:Alaska	Kategori:Alaska
Category:Oregon	Kategori:Oregon
Category:Kansas	Kategori:Kansas
Category:Colorado	Kategori:Colorado
Category:Toháano'ého'ëva	Kategori:Texas
Category:Šé'hóno	Kategori:Textilier
Category:Poeso	Kategori:Kattdjur
Category:Malawi	Kategori:Malawi
Category:Namibia	Kategori:Namibia
Category:Republic of the Congo	Kategori:Kongo-Brazzaville
Category:Ho'honáéšé'e	Kategori:Montana
Template:Citation/core	Mall:Citation/core
Category:Ó'he'e	Kategori:Vattendrag
Category:Zambia	Kategori:Zambia
Category:Zimbabwe	Kategori:Zimbabwe
Category:Nomá'ne	Kategori:Fiskar
Category:Énano'émâhtáme	Kategori:Grönsaker
Category:Mene	Kategori:Frukter
Ka'êškónâšé'šestôtse	Parnassia fimbriata
Category:Mo'éhno'häme	Kategori:Hästar
Category:Hovahne	Kategori:Djur
Category:Še'šenovôtse	Kategori:Ormar
Category:Hoohëö'o	Kategori:Flaggor
Category:Váótséva	Kategori:Hjortdjur
Anonévee'tose (énano'émâhtáme)	Morot
China	China
Trojany	Trojany
Category:Vášêtaëno	Kategori:Washington, D.C.
Category:Náhkohe	Kategori:Björnar
Hóxeeséeto'hamestôtse	Grimma
Special:RecentChanges	Special:Senaste ändringar
