非洲	Afrika
日本	Japan
南美洲	Sydamerika
Nò-vî	Norge
Sû-kak-làn	Skottland
Vî-ngì-sṳ̂	Wales
Pet Oi-ngì-làn	Nordirland
Hiûng-ngà-li	Ungern
Sî-pân-ngà	Spanien
Mî-koet	USA
Pí-li-sṳ̀	Belgien
Lù-sêm-pó	Luxemburg
Yî-chhiu	Universum
Thi-khiù	Jorden
Sâng-miang	Liv
Ngìn-lui	Människa
George Washington	George Washington
Fûn-làn	Finland
Shuì-tién	Sverige
Tan-ma̍k	Danmark
Pô-làn	Polen
Li̍p-thâu-vón	Litauen
Yi-thai-li	Italien
Shuì-sṳ	Schweiz
O-thi-li	Österrike
Hî-lia̍p	Grekland
Thú-ngí-khì	Turkiet
Phù-thò-ngà	Portugal
歐洲	Europa
亞洲	Asien
北美洲	Nordamerika
南極洲	Antarktis
Vì-kî Pak-khô	Wikipedia
Hò-làn	Nederländerna
Néu-yok-sṳ	New York
Fà-sṳ̀n-tun Kô-lùn-pí-â Thi̍t-khî	Washington, D.C.
Khiu-kîm-sân	San Francisco
Pak-lìm	Berlin
Lo̍k-chhám-kî	Los Angeles
Thien-nó	Dator
Mióng-chi-mióng-lu	Internet
Barack Obama	Barack Obama
Vû-lâ-kûi	Uruguay
Lùn-tûn	London
Phìn-kó	Äpple
Pâ-lì-sṳ	Paris
Â-pak-lâ-hón Lìm-khén	Abraham Lincoln
Google	Google
Me̍t-sî-kô	Mexiko
Thai-sî-yòng	Atlanten
Thai-phìn-yòng	Stilla havet
Kâ-li-fuk-nì-â	Kalifornien
Pô-sṳ-tun	Boston
Fó-sên	Mars (planet)
Âi-set-ngò-pí-â	Etiopien
Sṳ̂-é	Lejon
Fap-koet	Frankrike
Sṳ-kie-ngî	Esperanto
Kiéu-è	Hund
Yîn-koet	Storbritannien
Meu-é	Katt
中華人民共和國	Kina
Fap-ngî	Franska
Ǹg-è	Fiskar
Pâ-sî	Brasilien
François Hollande	François Hollande
Ngò-lò-sṳ̂	Ryssland
Kîn-ǹg	Valar
Chang-fông-hìn	Kvadrat
Tô-lùn-tô	Toronto
Â-lâ-pâ-mâ	Alabama
Québec-sén	Québec
Boeing 747	Boeing 747
Jimmy Wales	Jimmy Wales
Tet-koet	Tyskland
Pha̍k-ngò-lò-sṳ̂	Vitryssland
Tet-ngî	Tyska
Pên-tó	Island
Song-ti	Gud
Oi-sâ-nì-â	Estland
David Cameron	David Cameron
Thú-sên	Saturnus
Ku-thin-yi̍t Fî-kî	Flygplan
1	1 (tal)
2	2 (tal)
3	3 (tal)
4	4 (tal)
5	5 (tal)
George W. Bush	George W. Bush
Lâ-thot-vì-â	Lettland
Vû-khiet-làn	Ukraina
Tshia̍p-khiet	Tjeckien
Sṳ̂-lo̍k-vì-nì-â	Slovenien
Lò-mâ-nì-â	Rumänien
Pó-kâ-li-â	Bulgarien
Lò-mâ	Rom
Mâ-khì-tun	Makedonien
Â-ngì-pâ-nì-â	Albanien
Khiet-lò-âi-sî-â	Kroatien
Pô-sṳ-nì-â lâu Het-set-kô-vì-ná	Bosnien och Hercegovina
Â-set-pai-kiông	Azerbajdzjan
Set-phû-lu-sṳ̂	Cypern
Kak-lû-kit-â	Georgien
Hâ-sat-khiet-sṳ̂-thán	Kazakstan
Mí-li-thai	Malta
Mô-na̍p-kô	Monaco
Mùng-thi̍t-nui-kô-lò	Montenegro
Sṳn Mâ-li-nok	San Marino
Kú-pâ	Kuba
Eiffel Thiet-thap	Eiffeltornet
Yin-thu-nì-sî-â	Indonesien
Wolfgang Amadeus Mozart	Wolfgang Amadeus Mozart
Pi-tô-fûn	Ludwig van Beethoven
Thú-ngí-khì-ngî	Turkiska
Nàm-fî	Sydafrika
Vû-tsṳ̂-phe̍t-khiet-sṳ̂-thán	Uzbekistan
Pô-tsṳ-nàm	Poznań
Fà-sâ	Warszawa
Súi	Vatten
Thien-sṳ	Television
Chṳ-li	Chile
Yâ-sû	Jesus
Súi-sên	Merkurius
Li̍t-sṳ́	Historia
Phìn-kó Kûng-sṳ̂	Apple Inc.
Kîm-sên	Venus
Ngî-ngièn	Språk
Muk-sên	Jupiter
Thiên-vòng-sên	Uranus
Pu-lie̍t-thap-nì	Bretagne
Hói-vòng-sên	Neptunus
Thiên-vùn-ho̍k	Astronomi
Sîn-kâ-po	Singapore
Khô-ho̍k	Vetenskap
Montréal	Montréal
Lie̍t-kî-tûn-sṳ-tên	Liechtenstein
Kiam-khiâu	Cambridge
Thi-ngi-chhṳ Sṳ-kie Thai-chan	Andra världskriget
Cologne	Köln
Kak-tên-nì-â	Gdynia
Sṳ̍p-chhiet-chhiâng	Szczecin
Sṳ-ho̍k	Matematik
Lâ-tên-ngî	Latin
Pâ-lìm	Bahrain
Â-mî-nì-â	Armenien
Set-ngì-vì-â	Serbien
Ngie̍t-khiù	Månen
Àu-thai-li-â	Australien
Vu̍t-lî-ho̍k	Fysik
Â-kîn-thìn	Argentina
Pi-lû	Peru
Sâng-vu̍t-ho̍k	Biologi
Tsêu-siên Mìn-tsú Tsú-ngi Ngìn-mìn Khiung-fò-koet	Nordkorea
Kán-pu-chhài	Kambodja
Khiúng-liùng	Dinosaurier
Yî-sṳ̂-làn-kau	Islam
Lech Wałęsa	Lech Wałęsa
Lin-é	Hjul
Lyon	Lyon
Êu-chû Lièn-mèn	Europeiska unionen
Rhône-Alpes	Rhône-Alpes
Chhiòn-khiù Chṳ̂-sín Mióng	World Wide Web
Ńg-ngìn	Kvinna
Khiûng-tsiâu	Banan
Fâ	Blomma
Mâ-lî-â-na̍p-hói	Marianergraven
Chû-mu̍k-lòng-mâ-fûng	Mount Everest
Sàng-sṳ	Stad
Nâ-pho-lùn yit-sṳ	Napoleon I
Ngit-tèu	Solen
Pâ-sṳ-tet	Louis Pasteur
大洋洲	Oceanien
Thai-yòng Hì	Solsystemet
Pô-lò-tit-hói	Östersjön
Ngâ-chhṳ	Tänder
Khîn	Väte
Hoi (氦)	Helium
Angela Merkel	Angela Merkel
Lî	Litium
Phì	Beryllium
Si	Bok
Ngit	Dygn
Ngièn	År
Sṳ-ki	Sekel
Lò-tsṳ (Pô-làn)	Łódź
Khà-thok-vì-chṳ	Katowice
Ngie̍t-sû-fû	Rzeszów
Phìn	Bor
Thàn	Kol
Tham	Kväve
Yòng	Syre
Hàng-sên	Planet
Yîm-ngo̍k	Musik
Rennes	Rennes
Mo̍k-sṳ̂-khô	Moskva
Fuk	Fluor
Yi-thai-li-ngî	Italienska
Nái	Neon
Sṳn Pí-tet-páu	Sankt Petersburg
Na̍p	Natrium
北	Norr
Mî	Magnesium
Lî (鋁)	Aluminium
Néu Sî-làn	Nya Zeeland
南	Söder
Yin-thu	Indien
Si̍t	Kisel
Fap	Francium
Lìn	Fosfor
Thiet	Järn
Tûng-kâ	Tonga
西	Väster
Liù-vòng	Svavel
東	Öster
Liu̍k	Klor
Pâ-pu-â Néu-kí-nui-â	Papua Nya Guinea
Vî-lièn Sâ-sṳ-pí-â	William Shakespeare
Â (氬)	Argon
Kap	Kalium
Koi	Kalcium
Yèn	Bly
Mùng-kú-koet	Mongoliet
Khong (鈧)	Skandium
Thai	Titan
Genghis Khan	Djingis khan
Fàm	Vanadin
Mien-yîn	Maine
Kok	Krom
Mâ	Häst
Thûng-vu̍t	Djur
Sû-li-nàm	Surinam
Màng	Mangan
Pâ-lâ-kûi	Paraguay
Koi-â-nâ	Guyana
Ngi-su̍t	Konst
Lòi	Rhenium
Kô-lùn-pí-â	Colombia
Kû	Kobolt
Vû	Volfram
Ngiap (鎳)	Nickel
Fu̍t-kau	Buddhism
Pô-li-vì-â	Bolivia
Tshṳ̀-nì-tha̍t lâu Tô-pâ-kô	Trinidad och Tobago
Chhṳ̍t-vu̍t	Växt
Sîn	Zink
Néu Hàn-pu-ha	New Hampshire
Pí-â-vùi-sṳ̂-thok-khiet	Białystok
Ngà-mâi-kâ	Jamaica
Mà-sat-chû-set	Massachusetts
Drenthe-sén	Drenthe
Overijssel-sén	Overijssel
Kûa-thi-mâ-là	Guatemala
Gelderland-sén	Gelderland
Pâ-hâ-mâ	Bahamas
Không-nái-tí-khiet-chû	Connecticut
Kiê-é	Tamhöna
Ha-vî-yî	Hawaii
Fùng-tû-lâ-sṳ̂	Honduras
Tô-mí-nì-kâ	Dominica
Tô-mí-nì-kâ Khiung-fò-koet	Dominikanska republiken
Kâ-chû (Thung-vu̍t)	Gris
Hói-thi	Haiti
Sat-ngì-ngá-tô	El Salvador
Yî-lóng	Iran
Yî-là-khiet	Irak
Â-lâ-sṳ̂-kâ	Alaska
Kô-sṳ̂-tha̍t Lì-kâ	Costa Rica
Yî-set-lie̍t	Israel
Pâ-nâ-mâ	Panama
Ya̍p-mùn	Jemen
Phiang-thu̍k	Virus
Pô-làn-ngî	Polska
Yok-tan	Jordanien
Nì-kâ-lâ-kûa	Nicaragua
Fu-lò-lî-tha̍t	Florida
Kit-ngí-kit-sṳ̂-thán	Kirgizistan
Â-li-sông-ná	Arizona
Khô-vî-thi̍t	Kuwait
Liàu-koet	Laos
Lì-pâ-nun	Libanon
O-le̍t-kông	Oregon
Mâ-ngì-thoi-fû	Maldiverna
Yù-thâ	Utah
Mâ-lòi-sî-â	Malaysia
Mién-thien	Burma
Nì-pok	Nepal
Â-man	Oman
Pâ-kî-sṳ̂-thán	Pakistan
Khà-tha̍t	Qatar
Mióng-khiù	Tennis
Sâ-vû-thi Â-lâ-pak	Saudiarabien
Sṳ̂-lî-làn-khà	Sri Lanka
Si-li-â	Syrien
Kâ	Gallium
Thap-kit-khiet-sṳ̂-thán	Tadzjikistan
中華民國	Taiwan
YouTube	Youtube
Châ	Germanium
Thai-koet	Thailand
Sṳ̂n	Arsenik
Thú-khû-man-sṳ̂-thán	Turkmenistan
Abakan	Abakan
Sî	Selen
Yî	Iridium
Â-lâ-pak Lièn-ha̍p Thai-kûng-koet	Förenade Arabemiraten
Tshiù (溴)	Brom
Pha̍k (鉑)	Platina
Ye̍t-nàm	Vietnam
Thai-hòn Mìn-koet	Sydkorea
Khiet	Krypton
Â-fu-hon	Afghanistan
J. R. R. Tolkien	J.R.R. Tolkien
Lù	Rubidium
Kîm	Guld
Men-kâ-lâ-koet	Bangladesh
Ufa	Ufa
Ôn-kô-lâ	Angola
Vùn-lòi	Brunei
Kúng	Kvicksilver
Fî-li̍t-pîn	Filippinerna
Thò	Tallium
Ngie-sat-khiet Ngiù-tun	Isaac Newton
Albert Einstein	Albert Einstein
Sṳ̂	Strontium
Yet	Yttrium
Pit	Vismut
Vòng-set	Gul
Tsan-pí-â	Zambia
Sîn-pâ-pu-vî	Zimbabwe
北京	Peking
Tuva Khiung-fò-koet	Tuva
Pok-tshṳ-ngá-na̍p	Botswana
Pho (釙)	Polonium
Bayern	Bayern
Baden-Württemberg	Baden-Württemberg
Ngo (砈)	Astat
Lòi-sò-thok	Lesotho
Mâ-tha̍t-kâ-sṳ̂-kâ	Madagaskar
Mâ-là-vî	Malawi
Stuttgart	Stuttgart
Màu-li-thap-nì-â	Mauretanien
Pô-làn-ngìn	Polacker
Mo̍k-sông-pí-khiet	Moçambique
Na̍p-mí-pí-â	Namibia
Nai-khi̍p-li-â	Nigeria
Ko	Zirkonium
Nì	Niob
Yû-li-vû-sṳ̂ Khái-sat	Julius Caesar
Sṳ̂-vî-sṳ-làn	Swaziland
Muk	Molybden
Thap	Teknetium
Hamburg	Hamburg
Thoi-chhia	Metabolism
Miên-yi̍t Hì-thúng	Immunförsvar
Lièn-ha̍p-koet	Förenta nationerna
Sîm-chhong	Hjärta
Thèu-nó	Hjärna
Phì-fû	Hud
Ló	Rodium
Làm-set	Blå
Pâ	Palladium
Ngiùn	Silver
Kak	Kadmium
Yîn	Indium
Siak	Tenn
Yu	Uran
Thi (銻)	Antimon
Ti	Tellur
Pu	Plutonium
Tièn	Jod
Nai	Neptunium
Set	Cesium
Phù	Protaktinium
Pi	Barium
Thú	Torium
Kap (鉿)	Hafnium
Than (鉭)	Tantal
Luì	Radium
Tûng	Radon
Alsace	Alsace
Auvergne	Auvergne
Ôn-tet-là-pâng	Andhra Pradesh
Me̍t-hiet-kîn	Michigan
Burgundy	Bourgogne
Aquitaine	Aquitaine
Schleswig-Holstein	Schleswig-Holstein
Hâ Saxony	Niedersachsen
Pet Rhine-Westphalia	Nordrhein-Westfalen
Saxony	Sachsen
Yî-li-nò	Illinois
Thuringia	Thüringen
Saxony-Anhalt	Sachsen-Anhalt
Pet Tha̍t-khô-thâ	North Dakota
Brandenburg	Brandenburg
Bremen-chû	Bremen (delstat)
Nàm Tha̍t-khô-thâ	South Dakota
Mùng-thai-nâ	Montana
Fài-ngò-mìn	Wyoming
Yâ-lu-sat-lâng	Jerusalem
Oi-tha̍t-hòt	Idaho
Fà-sṳn-tun	Washington (delstat)
Lù (鑪)	Rutherfordium
Nui-fà-tha̍t	Nevada
Hàn (𨧀)	Dubnium
Hí (𨭎)	Seaborgium
Yin-thu-yòng	Indiska oceanen
Khô-sò-vok	Kosovo
Kâ-le̍t-pí-hói	Karibiska havet
Pô (𨨏)	Bohrium
Het (𨭆)	Hassium
Phan Kî-vùn	Ban Ki-moon
Ma̍k (䥑)	Meitnerium
Khô-lò-là-tô	Colorado
Tha̍t	Darmstadtium
Siau-pâng	Frédéric Chopin
Lùn	Röntgenium
Kô (鎶)	Copernicium
分類:Chú-yeu fûn-lui	Kategori:Topp
Chi-kâ-kô	Chicago
Arnhem	Arnhem
Tûng-kui	Vinter
Sî-pân-ngà-ngî	Spanska
Fî-là-thiet-fî	Philadelphia
Tî-tû	Spindlar
Kîm-tshièn	Pengar
Vì-kit-nì-â	Virginia
Sî Vì-kit-nì-â	West Virginia
Tshiâng-tséu	Spanskpeppar
Néu-yok-chû	New York (delstat)
Sṳ (鈰)	Cerium
Phú	Praseodym
Lò-tet-tó	Rhode Island
Ńg	Neodym
Khûn-chhùng	Insekter
Mâ-lî-làn	Maryland
Thi̍t-lâ-ngá	Delaware
Yû (銪)	Europium
Ngò-hài-ngò	Ohio
Vì-kit-ngì	Vergilius
Machiavelli	Niccolò Machiavelli
Pîn-sé-fap-nì-â	Pennsylvania
Uetersen	Uetersen
O-kú-sṳ̂-tû	Augustus
Néu Chhe̍t-sî-chû	New Jersey
Fûn-làn-ngî	Finska
Yin-thi-ôn-na̍p	Indiana
Vì-sṳ̂-pha-siên	Vespasianus
Thù-là-chṳ̂n	Trajanus
Hâ-tet-liòng	Hadrianus
Khièu-tshṳ-â	Georgia
Mâ-khù-sṳ̂ O-lie̍t-lî-vû-sṳ̂	Marcus Aurelius
Zagreb	Zagreb
Tet-khiet-sat-sṳ̂	Texas
Thai-mí-ngì-na̍p-tet-pâng	Tamil Nadu
Pet Khà-lò-lòi-na̍p	North Carolina
Nàm Khà-lò-lòi-na̍p	South Carolina
Loire-sén	Loire
Pâ-set-lò-nâ	Barcelona
Vòng-lî	Ananas
Me̍t-sî-sî-pí	Mississippi
Thièn-na̍p-sî	Tennessee
Néu Me̍t-sî-kô	New Mexico
Mìn-nì-sû-tha̍t	Minnesota
Vî-sṳ̂-không-sîn	Wisconsin
Oi-hò-fà	Iowa
Nui-pu-lâ-sṳ̂-kâ	Nebraska
Khâm-sat-sṳ̂	Kansas
Yin-thi-ngî	Hindi
Me̍t-sû-lî	Missouri
Lu-yi-sṳ̂-ôn-ná	Louisiana
Khén-thap-kî	Kentucky
Â-khén-set	Arkansas
Neil Armstrong	Neil Armstrong
O-khiet-lâ-hò-mâ	Oklahoma
Pet-hói	Nordsjön
Mo̍k-sṳ̂-khô-chû	Moskva oblast
Kiel	Kiel
Schwerin	Schwerin
Potsdam	Potsdam
Hanover	Hannover
Düsseldorf	Düsseldorf
Mainz	Mainz
Wiesbaden	Wiesbaden
Saarbrücken	Saarbrücken
Mu-nì-het	München
Erfurt	Erfurt
Dresden	Dresden
Kaliningrad-chû	Kaliningrad oblast
Murmansk-chû	Murmansk oblast
Kak-than-sṳ̂-khiet	Gdańsk
Fap-làn-khiet-fuk	Frankfurt am Main
Fut-lò-tshṳ-ngá-fû	Wrocław
Làn	Lantan
Ki (鉕)	Prometium
Sân	Samarium
Â-chhè Thi̍t-phe̍t Hàng-chṳn-khî	Aceh
Nga̍t (釓)	Gadolinium
Thi̍t (鋱)	Terbium
Tit (鏑)	Dysprosium
Sṳn-kîn	Bibeln
Fó	Holmium
Ngí (鉺)	Erbium
Tiû	Tulium
Yi	Ytterbium
Liu	Lutetium
Hò-nui-sṳ	Hanoi
Chṳ̂n Yâ-sû Kau-fi	The True Jesus Church
Yîn-ngî	Engelska
Màn-kuk	Bangkok
Kit-lùng-po	Kuala Lumpur
Pâng-kâ Vú-lî-thung-sén	Bangka-Belitung
Thòi-pet-sṳ	Taipei
Mî (鋂)	Americium
Arkhangelsk-chû	Archangelsk oblast
Khiu̍k	Curium
Thùng-hói-sṳ	Dong Hoi
Concepción	Concepción, Chile
Pet (鉳)	Berkelium
Khà (鉲)	Californium
Mìn-kú-lû-sén	Bengkulu (provins)
Oi	Einsteinium
Fi	Fermium
Mùn	Mendelevium
Na	Nobelium
Ontario-sén	Ontario
Lò	Lawrencium
Karelia Khiung-fò-koet	Karelska republiken
Końskowola	Końskowola
2002-ngièn	2002
2008-ngièn	2008
Charles de Gaulle	Charles de Gaulle
Cham-pî-sén	Jambi (provins)
Komi Khiung-fò-koet	Komi (delrepublik)
Nâm-póng-sén	Lampung
Pet Sû-mùn-tap-lia̍p-sén	Sumatera Utara
Syktyvkar	Syktyvkar
Québec-sṳ	Québec (stad)
Nenets Chhṳ-chhṳ-khî	Nentsien
Liàu-nui-sén	Riau
Leningrad-chû	Leningrad oblast
Pskov-chû	Pskov oblast
Liàu-nui Khiùn-tó-sén	Kepulauan Riau
Nizhny Novgorod-chû	Nizjnij Novgorod oblast
Nàm Sû-mùn-tap-lia̍p-sén	Sumatera Selatan
Lò-mâ Ti-koet	Romerska kejsardömet
Mì-ngiôn Kûng-sṳ̂	Microsoft
Tver-chû	Tver oblast
Khù-lû-fû	Kurów
Fa-ho̍k	Kemi
Smolensk-chû	Smolensk oblast
Yaroslavl-chû	Jaroslavl oblast
Kostroma-chû	Kostroma oblast
Ivanovo-chû	Ivanovo oblast
Arnold Schwarzenegger	Arnold Schwarzenegger
Chiuk-khiù	Fotboll
Ryazan-chû	Rjazan oblast
IPhone	Iphone
Sî Sû-mùn-tap-lia̍p-sén	Sumatera Barat
Tula-chû	Tula oblast
IPad	Ipad
Mâ-tet-lî	Madrid
Bryansk-chû	Brjansk oblast
Michael Jackson	Michael Jackson
Kaluga-chû	Kaluga oblast
Loire-Atlantique-sén	Loire-Atlantique
Ain-sén	Ain
Allier-sén	Allier (departement)
Khâm-phì-là	Canberra
Sông Alpes-sén	Hautes-Alpes
Oryol-chû	Orjol oblast
Sit-nì	Sydney
Alpes-de-Haute-Provence-sén	Alpes-de-Haute-Provence
Liu̍k-set	Grön
Alpes-Maritimes-sén	Alpes-Maritimes
Hâ-tet-sùn-hò	Hudsonfloden
Me̍t-ngì-pún	Melbourne
Fùng-set	Röd
Ardèche-sén	Ardèche
Jena	Jena
Kursk-chû	Kursk oblast
Ariège-sén	Ariège
Aude-sén	Aude
Aveyron-sén	Aveyron
Sîn Nàm Vî-ngì-sṳ̂-chû	New South Wales
Bouches-du-Rhône-sén	Bouches-du-Rhône
Àu-thai-li-â Sú-tû Liâng-thi	Australian Capital Territory
Cantal-sén	Cantal
Belgorod-chû	Belgorod oblast
Côte-d'Or-sén	Côte-d’Or
Côtes-d'Armor-sén	Côtes-d'Armor
Drôme-sén	Drôme
Finistère-sén	Finistère
Voronezh-chû	Voronezj oblast
Sû-mùn-tap-lia̍p	Sumatra
Lipetsk-chû	Lipetsk oblast
Van-tan-sén	Banten
Chûng Cháu-ôa-sén	Jawa Tengah
Fùi-sên	Komet
Rostov-chû	Rostov oblast
Tûng Cháu-ôa-sén	Jawa Timur
Ngâ-kâ-tha̍t Sú-tû Thi̍t-khî	Jakarta
Sî Cháu-ôa-sén	Jawa Barat
Adygea Khiung-fò-koet	Adygeiska republiken
Ngit-ngiâ Thi-fông Thi̍t-khî	Yogyakarta (region)
Gera	Gera (stad)
Maykop	Majkop
Cháu-ôa-tó	Java
Kâ-lî-man-tân-chû	Kalimantan
Séu Sùn-thâ Khiùn-tó	Små Sundaöarna
Sû-lâ-vî-sî-tó	Sulawesi
Mô-lu̍k-kâ Khiùn-tó	Moluckerna
Chûng Kâ-lî-man-tân-sén	Kalimantan Tengah
Tûng Kâ-lî-man-tân-sén	Kalimantan Timur
Nàm Kâ-lî-man-tân-sén	Kalimantan Selatan
Kâ-li-sî-â	Galicien
Sî Kâ-lî-man-tân-sén	Kalimantan Barat
Thai-ho̍k	Universitet
Pretoria	Pretoria
Chok-khiù	Bordtennis
Â-sṳ̂-thù-lî-â-sṳ̂	Asturien
Wikipedia:Sandbox	Wikipedia:Sandlådan
Astrakhan-chû	Astrachan oblast
Kham-thap-pu-lî-â	Kantabrien
Kalmykia Khiung-fò-koet	Kalmuckien
Weimar	Weimar
Osasco	Osasco
Â-là-kung	Aragonien
Kak-là-sṳ̂-kô	Glasgow
Thùng-hói Kî-chhòng	Dong Hoi flygplats
Vú-lîn-ngièn Fûng-kín Miàng-sṳn-khî	Wulingyuan
分類:Thòi-vân li̍t-sṳ́	Kategori:Taiwans historia
Curitiba	Curitiba
Chloë Grace Moretz	Chloë Grace Moretz
Khûng-chṳ́	Konfucius
Corbin Bleu	Corbin Bleu
分類:Sṳ-ho̍k	Kategori:Matematik
分類:Ngìn-kûng ngî-ngièn	Kategori:Konstgjorda språk
Pâ-lî-sén	Bali
Mî-kîm	Amerikansk dollar
Thi-chûng-hói	Medelhavet
Hông-chû-sṳ	Hangzhou
Kî-tuk-kau	Kristendom
Tûng Nú-sâ Tên-kâ-là-sén	Nusa Tenggara Timur
Sî Nú-sâ Tên-kâ-là-sén	Nusa Tenggara Barat
Chûng Sû-lâ-vî-sî-sén	Sulawesi Tengah
Kô-lùn-tá-lo̍k-sén	Gorontalo (provins)
Pet Sû-lâ-vî-sî-sén	Sulawesi Utara
Tûng-nàm Sû-lâ-vî-sî-sén	Sulawesi Tenggara
Nàm Sû-lâ-vî-sî-sén	Sulawesi Selatan
Sî Sû-lâ-vî-sî-sén	Sulawesi Barat
Vò-é	Ris
Mâ-lû-kú-sén	Moluckerna (provins)
Pet Mâ-lû-kú-sén	Maluku Utara
Pâ-pu-â-sén	Papua
Sî Pâ-pu-â-sén	Papua Barat
Dagestan Khiung-fò-koet	Dagestan
Sú-tû	Huvudstad
Monzón	Monzón
Phù-thò-ngà-ngî	Portugisiska
Ngie̍t	Månad
Mustafa Kemal Atatürk	Mustafa Kemal Atatürk
Makhachkala	Machatjkala
Chechnya Khiung-fò-koet	Tjetjenien
Grozny	Groznyj
Almazán	Almazán
Vòng Hien-fàm	Huang Xianfan
Ingushetia Khiung-fò-koet	Ingusjien
Magas	Magas
Pet Ossetia–Alania Khiung-fò-koet	Nordossetien
Kabardino-Balkaria Khiung-fò-koet	Kabardinien-Balkarien
Tson-sa̍k	Diamant
Bill Gates	Bill Gates
Ngi̍t-ngî	Japanska
Pak-khô-chhiòn-sû	Uppslagsverk
頭頁	Portal:Huvudsida
Karachay-Cherkessia Khiung-fò-koet	Karatjajen-Tjerkessien
Saratov	Saratov
Saratov-chû	Saratov oblast
Orenburg-chû	Orenburg oblast
Mordovia Khiung-fò-koet	Mordvinien
Saransk	Saransk
Yâ-khiù	Baseboll
Làm-khiù	Basket
Kirov-chû	Kirov oblast
Udmurtia Khiung-fò-koet	Udmurtien
Sî-pak-li-â	Sibirien
Mari El Khiung-fò-koet	Marij El
Yoshkar-Ola	Josjkar-Ola
Stellenbosch	Stellenbosch
Sverdlovsk-chû	Sverdlovsk oblast
Cape Town	Kapstaden
Chuvash Khiung-fò-koet	Tjuvasjien
Durban	Durban
Cheboksary	Tjeboksary
Tat-tat-sṳ̂-thán Khiung-fò-koet	Tatarstan
Penza-chû	Penza oblast
Là-fî-ngì	Rafael (konstnär)
Pí-tet Lû-pún-sṳ̂	Peter Paul Rubens
Ulyanovsk-chû	Uljanovsk oblast
Gung-gung-hi-tsaa	Buss
Kâ-thai-lò-nì-â	Katalonien
Bashkortostan Khiung-fò-koet	Basjkirien
Chelyabinsk-chû	Tjeljabinsk oblast
Pâ-lùn-sî-â Chhṳ-chhṳ-khî	Valencia (autonom region)
Khà-sṳ̂-tì-li-â lâu Lòi-ngong	Kastilien och León
Kurgan-chû	Kurgan oblast
Mô Chhe̍t-tûng	Mao Zedong
Tyumen-chû	Tiumen oblast
Omsk-chû	Omsk oblast
Thai-mí-ngì-ngî	Tamil
Chet-ho̍k	Filosofi
分類:Candidates for speedy deletion	Kategori:Snabbraderingar
Altai Khiung-fò-koet	Altajrepubliken
Kòng-khìm	Piano
Gorno-Altaysk	Gorno-Altajsk
Kemerovo-chû	Kemerovo oblast
Hebe Camargo	Hebe Camargo
Chṳ̂-pún chú-ngi	Kapitalism
Koet-kâ	Land
Mìn-chhu̍k	Nation
Khanty-Mansi Chhṳ-chhṳ-khî	Chantien-Mansien
Yamalo-Nenets Chhṳ-chhṳ-khî	Jamalo-Nentsien
Montpellier	Montpellier
分類:Thiên-vùn-ho̍k	Kategori:Astronomi
Khakassia Khiung-fò-koet	Chakassien
Irkutsk-chû	Irkutsk oblast
Sakha Khiung-fò-koet	Sacha
Khiet-lò-âi-sî-â-ngî	Kroatiska
Hon-pó	Hamburgare
Buryatia Khiung-fò-koet	Burjatien
Vû-làn Vû-tet	Ulan-Ude
Amur-chû	Amur oblast
Ngi-sṳ̍p Sṳ-ki	1900-talet
Gotha	Gotha
Dijon	Dijon
Kâ-thai-lò-nì-â-ngî	Katalanska
Nordhausen	Nordhausen
Kit-lò-na̍p-sén	Girona
Eisenach	Eisenach
Se-pâu Sâng-vu̍t-ho̍k	Cellbiologi
Sṳ-kie Ngiùn-hòng Si̍p-thòn	Världsbanken
A-la-pak Liên-mên	Arabförbundet
Mìn-tsú Tsú-ngi	Demokrati
Chhîn-chhèu (秦朝)	Qindynastin
Pet Thai-sî-yòng Kûng-yok Chû-chṳt	Nato
Chhìn Sṳ Fòng	Qin Shi Huangdi
Hon-chhèu	Handynastin
Hon Vú-ti Liù Chha̍t	Han Wudi
Sâng-vu̍t	Organism
Kiûn-chú-chṳ	Monarki
Khiung-fò-koet	Republik
Yí-mô-khiù	Badminton
Ngièn-chhèu	Yuandynastin
Nazi Tet-koet	Nazityskland
Yù-thai-ngìn	Judar
Chang Fò	Zheng He
Chìn-chhèu	Jindynastin (265–420)
Ngí	Öra
Phi	Nos
Ngién	Öga
Mûn-é	Stickmyggor
Mièn-yòng	Tamfår
Lo̍k-thò	Kameler
Phú-nen thung-vu̍t	Däggdjur
Ngie-kûng	Myror
Hò-làn-ngî	Nederländska
Fà-thi̍t Thit-sṳ-nì Kûng-sṳ̂	Walt Disney Company
Thot-yong Fu̍t-thông Fu̍t-son	DNA
Khiô	Aubergine
Siet	Snö
Â-pâ	Fader
Fûn	Minut
Yù-thai Chhṳ-chhṳ-chû	Judiska autonoma länet
Ngò-lò-sṳ̂-ngî	Ryska
Tûng-nàm-â Koet-kâ Lièn-mèn	Association of Southeast Asian Nations
Sakhalin-chû	Sachalin oblast
Mien-pâu	Bröd
Sṳ-kie Mo-yi Chû-chṳt	Världshandelsorganisationen
漢語	Kinesiska
Se-pâu	Cell
Hiet-yi̍t	Blod
Hi	Lunga
Lò-mâ-nì-â-ngî	Rumänska
Pó-kâ-li-â-ngî	Bulgariska
Magadan-chû	Magadan oblast
Chhṳ-yèn Khô-ho̍k	Naturvetenskap
Het-chhe̍t Mìn	Akira Kurosawa
Franklin D. Roosevelt	Franklin D. Roosevelt
Thi-khiù Khô-ho̍k	Geovetenskap
Sa̍k-thèu	Bergart
Yùn	Moln
Kí-hò-ho̍k	Geometri
Tet-lu-kú-ngî	Telugu
Thai-hì-chhèn	Atmosfär
Kak-lû-kit-â-ngî	Georgiska
Kîn-chi-ho̍k	Nationalekonomi
Pîn-kóng	Pangkal Pinang
漢字	Kinesiska tecken
Sî-lî-ngì Sṳ-mû	Kyrilliska alfabetet
Lâ-tên sṳ-mû	Latinska alfabetet
Vùn-ho̍k	Litteratur
分類:Fap-koet	Kategori:Frankrike
分類:Yîm-ngo̍k	Kategori:Musik
分類:Vùn-ho̍k	Kategori:Litteratur
La̍p-pá	Trumpet
Â-li̍t-sân-thai sâm-sṳ	Alexander den store
Kiûn-sṳ-thán-tên Yit-sṳ	Konstantin den store
Set-lû-sṳ thai-ti	Kyros II
Vùn-mìn	Civilisation
Kau-yuk	Bildning
Kâ-thìn	Familj
Nàm-ngìn	Man
Fûn-yîn	Äktenskap
Kiûn-sṳ	Militär
Kâ-pî	Kaffe
Ngiù-nen	Mjölk
Sûn Chûng-sân	Sun Yat-sen
Â-yuk-vòng	Ashoka
香港	Hongkong
Thai-yîn Ti-koet	Brittiska imperiet
Sú-ngì	Seoul
Kâm-nái-thit Koet-chi Kî-chhòng	John F. Kennedy International Airport
上海	Shanghai
Lùn-tûn Hî-sṳ̂-lu Kî-chhòng	London-Heathrow flygplats
Lùn-tûn Kak-vet Kî-chhòng	Gatwick flygplats
Set-vì-li-â	Sevilla
Chhîn-chhèu	Qingdynastin
Â-ngì-pâ-nì-â-ngî	Albanska
Pâ-sṳ̂-khiet-ngî	Baskiska
Â-lâ-kung-ngî	Aragonska
Yîn-koet Hòng-khûng	British Airways
Â-mî-nì-â-ngî	Armeniska
Vû-khiet-làn-ngî	Ukrainska
Pâ-lùn-sî-â	Valencia
Shuì-tién-ngî	Svenska
Tan-ma̍k-ngî	Danska
Nò-vî-ngî	Norska
Kô-thi̍t-fu̍t-lòi-tet Vî-liâm Lòi-pu-nì-tsṳ	Gottfried Wilhelm von Leibniz
Tshia̍p-khiet-ngî	Tjeckiska
Sṳ̂-lo̍k-phat-khiet-ngî	Slovakiska
Sṳ̂-lo̍k-vì-nì-â-ngî	Slovenska
Hiûng-ngà-li-ngî	Ungerska
Oi-sâ-nì-â-ngî	Estniska
Là-thot-vì-â-ngî	Lettiska
Li̍p-thâu-vón-ngî	Litauiska
Pha̍k-ngò-lò-sṳ̂-ngî	Vitryska
Kui-mí-thi̍t-lî Mùn-tet-lie̍t-fû	Dmitrij Mendelejev
Ngièn-chṳ́	Atom
Lâ-set-fuk	Ernest Rutherford
Hî-lia̍p-ngî	Grekiska
Oi-ngì-làn-ngî	Iriska
Pô-sṳ̂-ngî	Persiska
Chûng-kau	Religion
Chêu-sién-ngî	Koreanska
Chhóng-sṳ-ki	Första Moseboken
Kóng-tûng-fa	Kantonesiska
Chhut-âi-khi̍p-ki	Andra Moseboken
Ye̍t-nàm-ngî	Vietnamesiska
Pó-lò	Paulus
Kô-mièn-ngî	Khmer (språk)
Thai-ngî	Thai
Mâ-lòi-ngî	Malajiska
Yin-nì-ngî	Indonesiska
Mùng-kú-ngî	Mongoliska
Hâ-sat-khiet-ngî	Kazakiska
Vû-tsṳ̂-phe̍t-khiet-ngî	Uzbekiska
Thú-khù-màn-ngî	Turkmeniska
Yù-thai-kau	Judendom
Hî-pak-lói-ngî	Hebreiska
Â-set-pai-kiông-ngî	Azerbajdzjanska
Mâ-khì-tun-ngî	Makedonska
Set-ngì-vì-â-ngî	Serbiska
Set-ngì-vì-â Khiet-lò-thi-â-ngî	Serbokroatiska
Pô-sṳ-nì-â-ngî	Bosniska
Kâ-lî-sî-â-ngî	Galiciska
Vî-ngì-sṳ̂-ngî	Kymriska
Sû-kak-làn Koi-ngì-ngî	Skotsk gäliska
Siak-khiet-kau	Sikhism
John Maynard Keynes	John Maynard Keynes
Lufthansa Hòng-khûng	Lufthansa
Ló-chṳ́	Lao Zi
Kôn-chhóng	Lever
Shìn	Njure
Thu-é	Kaniner
Sṳ̀n-kîn Ne-thúng	Nervsystemet
Sîm-lî-ho̍k	Psykologi
Sṳt-kâ-mèu-nì	Buddha
Mâ-tên Lu-tet	Martin Luther
Yî-kâ	Konfucianism
Thiên-chú-kau	Romersk-katolska kyrkan
Tho-kau	Taoism
Chit-siói	Ryggmärg
Sa̍t	Tunga
Yî-tshóng	Bukspottkörtel
Hèu-thèu	Struphuvud
Fuk-khiet-làn khiùn-tó	Falklandsöarna
Vàng-kak-mo̍k	Mellangärde
Elizabeth Ngi-sṳ	Elizabeth II
Thòng-chhèu	Tangdynastin
John F. Kennedy	John F. Kennedy
Mìn-chhèu	Mingdynastin
Dwight D. Eisenhower	Dwight D. Eisenhower
Ronald Reagan	Ronald Reagan
Sat-là-kô-sat	Zaragoza
Kîm Tsang-ngit	Kim Jong Il
Ngièn-su Chû-khì-péu	Periodiska systemet
Chû-su̍k	Svin
Mariano Rajoy	Mariano Rajoy
Se-khiûn	Bakterier
Phù-thò	Druva
Phûng-thòng	Honung
Thông	Socker
Vòng-theu	Sojaböna
Kûng-chhàng-ho̍k	Ingenjörsvetenskap
Vùn-fa	Kultur
Fan-vun	Sanskrit
Sùn-fàn Hì-thúng	Hjärt- och kärlsystemet
Sôn	Syra
Yî-ho̍k	Medicinsk vetenskap
Néu-Yok Sṳ-kie Mo-yi Chûng-sîm	World Trade Center
Hâ Màn-hâ-tun	Lower Manhattan
Yàm	Salt
分類:Pâ-sî	Kategori:Brasilien
Màn-hâ-tun	Manhattan
Ngièn-su	Grundämne
Kâ-suk-thu	Acceleration
Li̍t	Kraft
Kú	Trumma
Tsṳt-liông	Massa
Thien-yáng	Film
Kîm-su̍k	Metall
Nùng-ngia̍p	Jordbruk
Sâng-yîm	Ljud
Sṳ̀-kiên	Tid
Mien-chit	Area
Kûng-kîn	Kilogram
Kûng-tshak	Meter
Miéu	Sekund
Pâu-siuk	Majs
Kûng-sṳ̂n	Liter
Fà-ngì-kiê	Wall Street
Tûng-nàm-â	Sydostasien
Tshùng-khin	Chongqing
Thiên-tsîn	Tianjin
Vú-hon-sṳ	Wuhan
Kú Hî-lia̍p	Antikens Grekland
Thomas Jefferson	Thomas Jefferson
Vùi-sṳ̂-khà	Huesca
Tychy	Tychy
Pu-lie̍t-thap-nì-ngî	Bretonska
Lóng	Dövhet
Chhi̍t-phiang	Sjukdom
Khien-không	Hälsa
Màn-tó-ngî	Manx (språk)
Chhiâng-môi-su	Penicillin
Nantes	Nantes
Pot-thâm-fó	Tuberkulos
Mà-chiông	Mahjong
Detroit	Detroit
Van-lî Tshòng-sàng	Kinesiska muren
Gard-sén	Gard
Gers-sén	Gers
Sông Garonne-sén	Haute-Garonne
Sṳ̀n-sṳn Lò-mâ Ti-koet	Tysk-romerska riket
Ille-et-Vilaine-sén	Ille-et-Vilaine
Isère-sén	Isère
Chûng-kau Kói-kiet	Reformationen
Sông Loire-sén	Haute-Loire
Lot-sén	Lot (departement)
Lozère-sén	Lozère
Maine-et-Loire-sén	Maine-et-Loire
Nì-pu-kap-nì-sat ngi-sṳ	Nebukadnessar II
Mayenne-sén	Mayenne
Morbihan-sén	Morbihan
Nièvre-sén	Nièvre
Nord-sén	Nord
Calais Hói-hia̍p-sén	Pas-de-Calais
Puy-de-Dôme-sén	Puy-de-Dôme
Sông Pyrénées-sén	Hautes-Pyrénées
Pyrénées-Orientales-sén	Pyrénées-Orientales
Hâ Rhin-sén	Bas-Rhin
Sông Rhin-sén	Haut-Rhin
Saône-et-Loire-sén	Saône-et-Loire
Sarthe-sén	Sarthe
Sông Savoie-sén	Haute-Savoie
Tarn-sén	Tarn
Tarn-et-Garonne-sén	Tarn-et-Garonne
Var-sén	Var (departement)
Vaucluse-sén	Vaucluse
Vendée-sén	Vendée
Yonne-sén	Yonne
Yî-pí-li-â Pan-tó	Pyreneiska halvön
Lai-kî	Litchi
Yâ-è	Kokospalm
Sa̍k-liù	Granatäpple
Chong-fa	Zhuang (språk)
Na̍p-ngá-thi̍t-ngî	Nahuatl
Mí-nàm-kâ-pó-ngî	Minangkabau
Mirandés-ngî	Mirandesiska
Harvard Thai-ho̍k	Harvard University
Néu-yok Chṳn-khèn Kâu-yi-só	New York Stock Exchange
Lie̍t-yî-tha̍t-sén	Lleida (provins)
Â-lâ-pak-ngî	Arabiska
Kiú-chiu	Kyushu
Si-koet	Shikoku
O-khiet-ngî	Occitanska
Nàm-fî Hò-làn-ngî	Afrikaans
Lí Mìn-pok	Lee Myung-bak
Lû Vú-hién	Roh Moo-hyun
Kâ Mà-chiok	Gråsparv
Kô-thiet	Hongkongs tunnelbana
澳門	Macao
Suhl	Suhl
Mühlhausen	Mühlhausen, Thüringen
Sâ-thièn-khî	Sha Tin
Fù Kím-Thàu	Hu Jintao
Si̍p Khiûn-phìn	Xi Jinping
Chhòng-kiáng-lu̍k	Giraff
Phì-âi-mùng-thi̍t-ngî	Piemontesiska
Thap-là-kô-na̍p	Tarragona
Provence-Alpes-Côte d'Azur	Provence-Alpes-Côte d'Azur
Chhṳ̂m-chun-sṳ	Shenzhen
Kóng-tûng	Guangdong
Kóng-sî Chong-chhu̍k Chhṳ-chhṳ-khî	Guangxi
Mô-kài	Sagan om ringen
Hiông-kóng Thai-ho̍k	University of Hong Kong
Badajoz	Badajoz
Lu̍k-yì-tó-yen	Kagoshima prefektur
Kiok	Fot
Sit-thit	Ödlor
Altenburg	Altenburg
Kiên	Axel (kroppsdel)
Midi-Pyrénées	Midi-Pyrénées
模板:Link FA	Mall:Link FA
Wikipedia:Chhâm-siòng	Wikipedia:Bybrunnen
Fu-mùng-thi̍t	Vermont
Hiû-sṳ̂-tûn	Houston
Kóng-chiu-sṳ	Guangzhou
Chiông Kie-sa̍k	Chiang Kai-shek
Vûn Kâ-pó	Wen Jiabao
Nàm-kîn-sṳ	Nanjing
Phiang-yèn	Sjukhus
Kông-sû	Jiangsu
Chet-kông-sén	Zhejiang
Thèn Séu-phìn	Deng Xiaoping
Pet-phu Calais Hói-hia̍p	Nord-Pas-de-Calais
Pays de la Loire	Pays de la Loire
Languedoc-Roussillon	Languedoc-Roussillon
Thiap-sat-lò-nì-kâ	Thessaloniki
西藏自治區	Autonoma regionen Tibet
Hàng-thung Thien-fa	Mobiltelefoni
Thò-niâu	Struts
Manchester	Manchester
Pu-lû-khiet-lìm	Brooklyn
Fòng-heu-khî	Queens
Liùng-yìn-sṳ	Yongin
Lòng	Varg
Mâ-lòi Pan-tó	Malackahalvön
Sîn-yok Sṳn-kîn	Nya Testamentet
Fan-lóng-thap-cham-sṳ	Phan Rang-Thap Cham
9	9 (tal)
Zung-gok Thaai-liuk	Fastlandskina
Het-liùng-kông	Heilongjiang
Mâ Yîn-kiú	Ma Ying-jeou
Piên-fò-sṳ	Bien Hoa
Hiông-kóng-tó	Hongkongön
Ngà-tsông-sṳ	Nha Trang
Podolsk	Podolsk
Pô-tô Lì-kok Thu̍k-li̍p-tóng	Puertoricanska självständighetspartiet
Lì-è	Åsna
Si-chhôn-sén	Sichuan
Khiu-yok Sṳn-kîn	Gamla Testamentet
Sṳn-tan-chiet	Jul
Lò-màn Ngî-chhu̍k	Romanska språk
Sâm-kok-hìn	Triangel
Steve Jobs	Steve Jobs
Yin-Êu Ngî-ne	Indoeuropeiska språk
Breinigerberg	Breinigerberg
Lo-fú	Tiger
Fù-ôn Khà-lo̍k-sṳ̂ Yit-sṳ	Juan Carlos I av Spanien
Súi-ngièn-sṳ	Suwon
Sâm-sên Si̍p-thòn	Samsung
Louis Couturat	Louis Couturat
Thai-thièn Kóng-vet-sṳ	Daejeon
Kîn-ki-tho	Gyeonggi
Sṳ̂-khâm-tit-nâ-vì-â	Skandinavien
Fu̍k-fa̍t-chiet	Påsk
Thien-nó Khô-ho̍k	Datavetenskap
Koet-chi Yîm-phiêu	Internationella fonetiska alfabetet
Hò-pet	Hebei
Phú-lìm-sṳ̂-tun Thai-ho̍k	Princeton University
Fôn-hìn-muk	Storkfåglar
Chhṳ̀n Súi-pién	Chen Shui-bian
台灣	Taiwan (ö)
Chṳ-fi-hîn Sú-kî	Smarttelefon
Sa̍k-yù	Petroleum
Hài-è	Sko
Ngiùn-hòng	Bank
Ngièn-lun Chhṳ-yù	Yttrandefrihet
Oi-ngì-làn	Irland (ö)
Cheshire	Cheshire
Cumbria	Cumbria
Lancashire	Lancashire
Northumberland	Northumberland
Tyne and Wear	Tyne and Wear
County Durham	Durham (grevskap)
Pet Yorkshire	North Yorkshire
Lincolnshire	Lincolnshire
Nottinghamshire	Nottinghamshire
Derbyshire	Derbyshire
Merseyside	Merseyside
Leicestershire	Leicestershire
Rutland	Rutland
Lû-sùn	Lu Xun
Northamptonshire	Northamptonshire
Devon	Devon, England
Oxfordshire	Oxfordshire
Wiltshire	Wiltshire
Hampshire	Hampshire
Buckinghamshire	Buckinghamshire
Surrey	Surrey
West Sussex	West Sussex
East Sussex	East Sussex
Kent	Kent (grevskap)
Thai Lùn-tûn	Storlondon
7	7 (tal)
8	8 (tal)
Lu̍k-é	Hjortdjur
Pên	Is
Chú ke Khì-tó-vùn	Herrens bön
Ngìn-lui-ho̍k	Antropologi
Fùng-hói	Röda havet
Oi-tên-páu	Edinburgh
Pha̍k-set	Vit
Marseille	Marseille
Thai-chhûng-thèu	Lök (art)
6	6 (tal)
Kôn-fông ngî-ngièn	Officiellt språk
Kháu-kú-ho̍k	Arkeologi
George H. W. Bush	George H.W. Bush
Pâ-ngì-kòn pan-tó	Balkanhalvön
Dmitry Medvedev	Dmitrij Medvedev
Entrena	Entrena
Sîn-kau	Protestantism
Selena	Selena Quintanilla
Mî-koet Thai-khûng Chúng-shu	NASA
Thai Put-lie̍t-tiên-tó	Storbritannien (ö)
Pâ-le̍t-sṳ̂-thán	Palestina
10	10 (tal)
Lila Downs	Lila Downs
Lia̍p-pau	Gepard
Cleveland (Yîn-koet)	Cleveland, England
Liverpool	Liverpool
Bremen	Bremen
Sîn Nò-vî-ngî	Nynorska
Meu-thèu-tiâu	Ugglor
Sṳ̀	Timme
Fap-lò-ngî	Färöiska
Kîm-eu-sṳ	Ca Mau
Meu-khô	Kattdjur
Koet-chi Thai-khûng Chhàm	Internationella rymdstationen
Tà-la-sṳ	Da Lat
Tat-tat-ngî	Tatariska
Tshûng-liông	Tyngd
Tsûng-su	Dadelpalm
Fan-tshiet-sṳ	Phan Thiet
Sî Fut-lî-sî-ngî	Frisiska
Séu Vòng-chṳ́	Lille prinsen
Phiàng-fông kûng-tshak	Kvadratmeter
Fó-yam-chhùng	Lysmaskar
Li̍p-fông kûng-tshak	Kubikmeter
Fàn-chiet-thûng-vu̍t-mùn	Ringmaskar
Chhú-khô	Råttdjur
Lû-sêm-nì-â-ngî	Rusinska
Ede (Hò-làn)	Ede (kommun)
Fú-kîn	Späckhuggare
Sâ-thi̍t-fut-lî-sî-ngî	Saterfrisiska
Liû-khiù-koet	Kungariket Ryukyu
Pet-fut-lî-sî-â-ngî	Nordfrisiska
Â-mê-ha̍p-lâ-ngî	Amhariska
蝠婆	Fladdermöss
Tarnobrzeg	Tarnobrzeg
Vòng Ti	Huang-Di
Tiau-ǹg-thòi Lie̍t-yí	Senkaku-öarna
Khiung-fò-tóng (Mî-koet)	Republikanska partiet
Â-sṳ̂-thù-lî-â-sṳ̂-ngî	Asturiska
中國	Kina (region)
O-thi-li Pâ-vî-li-â-ngî	Bayerska
Mìn-chú-tóng (Mî-koet)	Demokratiska partiet
Sàng-tû-sṳ	Chengdu
Âi-sṳ̂-thi̍t-lùi-mâ-thu-lâ-ngî	Extremaduriska
Séu-su mìn-chhu̍k	Minoritet
Pô-lòi-kú	Pleiku
Â-ha̍p-sṳ̂-vòng	Achas
Chûng-chû-sṳ	Chungju
Yî-liàu Ví-sâng	Sjukvård
Yòng-suk-yen	Yangshuo
Khiet-là-khô-fû	Kraków
臺灣省	Taiwan (provins)
Pet-kîn Sú-tû Koet-chi Kî-chhòng	Pekings internationella flygplats
Sîn-kâ-po Hòng-khûng Kûng-sṳ̂	Singapore Airlines
Thien-nó Thôn-chhèn Só-mèu	Datortomografi
Vî-nî-sṳ̂-ngî	Venetianska
Vì-phú-sêm-ngî	Vepsiska
Fu̍t-lò-ngî	Võru (språk)
Pân-mâ	Zebror
Valery Leontiev	Valerij Leontiev
Khô-sî-kâ-ngî	Korsikanska
Buryat-ngî	Burjatiska
Sùn-tho-chûng	Metodism
Mông-kiê-sṳ	Mong Cai
Suk-vú-ngî	Cebuano
Chavacano-ngî	Chavacano
Tha̍t-lò-phî-thû Ngî-hì	Dravidiska språk
Ló-kiê-sṳ	Lao Cai
客家語	Hakka (språk)
Pet-nèn-sṳ	Bac Ninh
Liòng-sân-sṳ	Lang Son
Hiuk-tsin-sṳ	Soc Trang
Liùng-chhôn-sṳ	Long Xuyen
Mî-tshiu-sṳ	My Tho
Fut-liù-li-ngî	Friuliska
Pâng-mî-tsuk	Buon Ma Thuot
Kàm-ngî	Gan (dialekt)
Pok-vu̍t-kón	Museum
Yin-thu Yî-lóng Ngî-chhu̍k	Indoiranska språk
Thai-yùng-meu	Jättepanda
Kalmyk-ngî	Kalmuckiska
Mân-ngî	Manchuiska
Kû-li̍p ngî-ngièn	Isolatspråk
Kit-là-kî-ngî	Gilaki
Khà-sû-pí-ngî	Kasjubiska
Karachay-Balkar-ngî	Karatjajbalkariska
Lùn-pâ-tí-ngî	Lombardiska
Sú	Hand
Thu fú	Du Fu
O-lî-â-ngî	Oriya
Ngìn-khiéu	Befolkning
Nò-man-thi-ngî	Normandiska
Pâng-â-sî-nâm-ngî	Pangasinan
Nèn-phìn-sṳ	Ninh Binh
Pet-sat-mí-ngî	Nordsamiska
O-set-thôi-ngî	Ossetiska
Sî-sî-lî-ngî	Sicilianska
Sat-tên-nî-â-ngî	Sardiska
Nì-ngá-ngì-ngî	Newari
Valparaíso	Valparaíso
Kóng-ngi-sṳ	Quang Ngai
Hò-tshin-sṳ	Ha Tinh
Yên-yèn	Skådespelare
Thap-kâ-lo̍k-ngî	Tagalog
Thùng	Brons
Vlaams-ngî	Flamländska
Fà-liùng-ngî	Vallonska
Sú-ngî	Teckenspråk
Międzyrzec Podlaski	Międzyrzec Podlaski
Phiêu-chún Chhông-ngî	Tibetanska
Ngá-shuì-ngá-shuì-ngî	Waray-waray
N̂g-ngî	Wu (dialekt)
Woodrow Wilson	Woodrow Wilson
Fu̍t-sân-sṳ	Foshan
Ngiù-chîn Thai-ho̍k	Oxfords universitet
Sṳ̍p-thiàu Kie-min	De tio budorden
Yok-hon-nì-sṳ̂-páu	Johannesburg
Kî-tuk Kau-fi	Kyrkan
Pau-é	Leopard
Sîn-kiông	Xinjiang
Muk-kôa	Papaya
Pu-lî-sṳ̂-pân	Brisbane
Â-mî-ngî	Amis
Vî-liâm Lùn-khìm	Wilhelm Röntgen
Chû-chhèu	Zhoudynastin
Ido-ngî	Ido
Brad Pitt	Brad Pitt
Pa̍k-kiûng	Vita huset
Tha̍t-mâ-thai-ngî	Dalmatiska
Tat-tat-chhu̍k	Tatarer
Kô-liáng-sṳ	Cao Lanh
Thai-fán-sṳ	Osaka
Kiam-khiâu Thai-ho̍k	Universitetet i Cambridge
Kûng-khín	Hektar
Sé-lî	Dop
Pông-hâ	Astma
Chuk	Bambu
Fù Tsṳ-mìn	Ho Chi Minh
Thièn-piên-fú	Dien Bien Phu
Khûn-sṳ-làn-chû	Queensland
Ha-liùng-sṳ	Ha Long
Kûi-yìn-sṳ	Qui Nhon
Mìn-nì-â-pô-li-sṳ̂	Minneapolis
Li̍t-ka-sṳ	Rach Gia
Li-kú-lî-â-ngî	Liguriska (romanskt språk)
Phô-lò-chû	Borneo
Vù-fâ-kó	Fikon
Sun-fa-sṳ	Hué
Tshòng-thu	Längd
Sṳ̂-chhù-chṳ̂-lu	Sidenvägen
Hói-yòng-sṳ	Hai Duong
Mô-li-ngî	Maori
Mên-tûng-ngî	Mindong
Tô-se-pâu sâng-vu̍t	Flercellig organism
Hîn-ôn-sṳ	Hung Yen
Mên-nàm-ngî	Minnan
Tshiên-ngièn	Millennium
Ho̍k-miàng	Binomial nomenklatur
Vì-tô-li-â-chû	Victoria, Australien
Chong-chhu̍k	Zhuang
Pet-kông	Bac Giang
Aung San Suu Kyi翁山蘇姬	Aung San Suu Kyi
Yok-hon-fuk-yîm	Johannesevangeliet
William Vòng-chṳ́	Prins William, hertig av Cambridge
Chhṳ̀n Kóng-sâng	Jackie Chan
12	12 (tal)
Vok-là-phú-khiet-ngî	Volapük
Toshiro Mifune	Toshiro Mifune
Kám-lám-su	Olivträd
Só-lò-mùn-vòng	Salomo
O-khiet-làn	Auckland
Chhṳ̍t-sien	Rät linje
11	11 (tal)
13	13 (tal)
Sûn-chṳ́	Sun Zi
Sṳn-lìn	Den Helige Ande
Lû-pu-lìm	Lublin
Thì-thèu	Jordnöt
100	100 (tal)
Tshit-thèu	Knä
Tô-piên-hìn	Polygon
Nàm Chûng-koet Hói	Sydkinesiska havet
Campora San Giovanni	Campora San Giovanni
Pien-set-liùng	Kameleonter
Bloemfontein	Bloemfontein
Ngiam-set-thí	Kromosom
O-khiet-làn Vùn-fap Ho̍k-káu	Auckland Grammar School
Ngióng-kông	Rangoon
Ma̍k-tông-lò Kûng-sṳ̂	McDonald’s
1000000	Miljon
Meu-miàng-sṳ	Maoming
Liú-chiu-sṳ	Liuzhou
Pet-pan-khiù	Norra halvklotet
Ló-chhú	Möss
Thí-tsit	Volym
Het-tsṳ̂	Hertz
Pak-pân-khiet	Burbank, Kalifornien
Sien-lia̍p-thí	Mitokondrie
Yî-sên	Läkare
Ki-sa̍k-chhṳn	Stonehenge
Chúng-thí Kîn-chi-ho̍k	Makroekonomi
Lu-kâ-fuk-yîm	Lukasevangeliet
Sîn Kí-nui-â	Nya Guinea
Sṳ́-thù-hàng-chhon	Apostlagärningarna
Mô-hái	Krabbor
PH	PH
Khì-tó	Bön
Ôn-fui-sén	Anhui
Chûng-chhîn Pet-tho	Nordchungcheong
Chûng-chhîn Nàm-tho	Sydchungcheong
Kông-ngièn-tho (Hôn-koet)	Gangwon
Nui Mùng-kú	Inre Mongoliet
Kîm Ngit-sṳ̀n	Kim Il Sung
Pí-tet-kô-sṳ̍p	Bydgoszcz
Nottingham	Nottingham
Thai-ví-vòng	Kung David
Li-vi-ki	Tredje Moseboken
Sṳ̂-thán-fuk Thai-ho̍k	Stanford University
Fuk-kian	Fujian
Kûng-khiet	Gram
Mùng-kú-tshu̍k	Mongoler
Khí-sṳ-liu̍k	Uppenbarelseboken
Kong-lîn-sṳ	Gangneung
Kiê-liùng-sṳ	Gyeryong
Kô-yòng-sṳ	Goyang
Kûng-chû-sṳ	Gongju
Kó-chhôn-sṳ	Gwacheon
Kông-mìn-sṳ	Gwangmyeong
Kóng-chû-sṳ (Hôn-koet)	Gwangju, Gyeonggi
Kiú-lî-sṳ	Guri
Kiûn-phú-sṳ	Gunpo
Kîm-phú-sṳ	Gimpo
Nàm-yòng-chû-sṳ	Namyangju
Lun-sân-sṳ	Nonsan
Thông-chîn-sṳ (Hôn-koet)	Dangjin
Tûng-theu-chhôn-sṳ	Dongducheon
Tûng-hói-sṳ (Hôn-koet)	Donghae
Pó-nèn-sṳ	Boryeong
Fu-chhôn-sṳ	Bucheon
Sâm-chit-sṳ	Samcheok
Shuì-sân-sṳ	Seosan
Sàng-nàm-sṳ	Seongnam
Suk-chhó-sṳ	Sokcho
Sṳ́-hîn-sṳ	Siheung
Ngà-sân-sṳ	Asan
Ôn-sân-sṳ	Ansan
Ôn-sàng-sṳ (Hôn-koet)	Anseong
Ôn-yông-sṳ	Anyang, Sydkorea
Yòng-chû-sṳ	Yangju
Vû-sân-sṳ	Osan
Ngièn-chû-sṳ	Wonju
Ngi-vòng-sṳ	Uiwang
Ngi-chṳn-fú-sṳ	Uijeongbu
Li-chhôn-sṳ (Hôn-koet)	Icheon
Thî-chhôn-sṳ	Jecheon
Thiên-ôn-sṳ	Cheonan
Chhîn-chû-sṳ	Cheongju
Chhûn-chhôn-sṳ	Chuncheon
Thai-pha̍k-sṳ	Taebaek
Po-chû-sṳ	Paju
Phìn-tshe̍t-sṳ	Pyeongtaek
Phàu-chhôn-sṳ	Pocheon
Hò-nàm-sṳ	Hanam
Fà-sàng-sṳ	Hwaseong
Buckingham Kiûng	Buckingham Palace
Hói-nàm	Hainan
Yén-tûng	Fjärran Östern
Ngiên-kiu	Forskning
Kâm-suk	Gansu
Pha̍k Se-pâu	Vit blodkropp
York	York
Tsiú	Armbågsled
Sṳ̂n-min-ki	Femte Moseboken
Sû-chû-sṳ	Suzhou
Vûn-chû-sṳ	Wenzhou
Windsor Sàng-páu	Windsor Castle
Hòn-chhu̍k	Hankineser
Nèn-pô-sṳ	Ningbo
Tet-koet-ngìn	Tyskar
Ko-men	Allergi
Fù-khì	Iglar
Kîm-yùng	Finans
1000	1000 (tal)
Mìn-su-ki	Fjärde Moseboken
Liu̍k Khiet-vùn	Kevin Rudd
Ngo̍k-ǹg	Krokodiler
Yùn-nàm	Yunnan
Vû-â	Corvus
Plymouth	Plymouth
Sân-tûng	Shandong
Pí	Arm
Derby-sṳ	Derby, Storbritannien
Thàn-khîn Fa-ha̍p-vu̍t	Kolväte
Hò-nàm	Henan
Montehermoso	Montehermoso
Liâu-nèn	Liaoning
El Cid	El Cid
Jim Morrison	Jim Morrison
Kóng-khiéu	Hamn
Thòi-vân Thò-yèn Koet-chi Kî-chhòng	Taiwan Taoyuan Internationella Flygplats
Kit-lìm	Jilin
Fù-nàm	Hunan
Chhiâng-hói	Qinghai
Vì-ngâ-ngì-tshu̍k	Uigurer
Rhône-sén	Rhône (departement)
Koet-kâ Kûng-yèn	Nationalpark
Pâ-lì Charles-de-Gaulle Koet-chi Kî-chhòng	Paris-Charles de Gaulle-flygplatsen
Chṳ̂-sán	Tillgång
O-le̍t-liòng	Aurelianus
Fù-pet	Hubei
Sân-sî	Shanxi
Hòng-khûng Kûng-sṳ̂	Flygföretag
Hò-khiéu-vân	Estuarium
Chûng-set	Brun
Kui-chû	Guizhou
Berkelland	Berkelland
Chûng-khi Sṳ̀n-kîn Ne-thúng	Centrala nervsystemet
Yî-fut-só	Efesos
Ôn-tha̍t-màn Hói	Andamansjön
Yok-sû-â-ki	Josua (bok)
Sî-pet Yîn-kak-làn	Nordvästra England
Shám-sî-sén	Shaanxi
Tûng-pet Yîn-kak-làn	Nordöstra England
Tûng Midlands	East Midlands
Tûng Yîn-kak-làn	Östra England
Tûng-nàm Yîn-kak-làn	Sydöstra England
Sî-nàm Yîn-kak-làn	Sydvästra England
模板:Commonscat	Mall:Commonscat
Sî Midlands	West Midlands (region)
Yorkshire lâu Humber	Yorkshire och Humber
Kòn Se-pâu	Stamcell
Lò-mâ-sû	Romarbrevet
Mâ-liuk-kap Hói-hia̍p	Malackasundet
Yù-thai Vòng-koet	Juda rike
Fî-yí Mî-koet Het-ngìn	Afroamerikaner
Mà-sat-chû-set Lî-kûng Ho̍k-yen	Massachusetts Institute of Technology
Pô-sṳ-tun Thai-ho̍k	Boston University
Yâ-lû Thai-ho̍k	Yale University
Nàm-pet-chêu	De sydliga och nordliga dynastierna
Fûn-lî	Bröllop
Pan Chúng-thúng-chṳ	Semipresidentialism
Kâ-phìn-khiùn	Gapyeong
Fâi-sân-khiùn	Goesan
Kím-sân-khiùn	Geumsan
Tan-yòng-khiùn (Hôn-koet)	Danyang, Sydkorea
Po-ên-khiùn	Boeun
Fù-yì-khiùn	Buyeo
Sû-chhôn-khiùn	Seocheon
Yòng-phìn-khiùn	Yangpyeong
Lî-chû-sṳ	Yeoju
Liên-chhôn-khiùn	Yeoncheon
Yún-thùng-khiùn	Yeongdong
Lî-sân-khiùn	Yesan
Vok-chhôn-khiùn	Okcheon
Yîm-sàng-khiùn	Eumseong
Chên-phiàng-khiùn	Jeungpyeong
Chṳ́n-chhôn-khiùn	Jincheon
Chhiâng-yòng-khiùn	Cheongyang
Thai-ôn-khiùn	Taean
Fùng-sàng-khiùn	Hongseong
Ên-phìn-sṳ	Eunpyeong-gu
Fî-li̍p-pí-sû	Filipperbrevet
Thiên-koet Pat-fuk	Saligprisningarna
Mî-koet Lièn-pâng Chún-phi Ne-thúng	Federal Reserve System
Kúai-é	Stjärtlösa groddjur
Hâ Sî-lî-sî-â-sén	Nedre Schlesiens vojvodskap
Khù-â-vì - Pô-mî-là-nì-â-sén	Kujavien-Pommerns vojvodskap
Lû-pu-lìm-sén	Lublins vojvodskap
Lû-pu-sṳ̂-khà-sén	Lubusz vojvodskap
Lò-tsṳ-sén	Łódź vojvodskap
Séu Pô-làn-sén	Lillpolens vojvodskap
Mâ-tsó-fû-sá-sén	Masoviens vojvodskap
O-pô-lòi-sén	Opole vojvodskap
Khak-ngì-pâ-yèn-sân-sén	Nedre Karpaternas vojvodskap
Pô-tet-là-chhia-sén	Podlasiens vojvodskap
Pô-mî-là-nì-â-sén	Pommerns vojvodskap
Sî-lî-sî-â-sén	Schlesiens vojvodskap
Sṳn-sṳ̍p-sṳ-sén	Święty Krzyż vojvodskap
Sî Pô-mî-là-nì-â-sén	Västpommerns vojvodskap
Pâ-lùn-sî-â-sén	Valencia (provins)
Sat-là-kô-sat-sén	Zaragoza (provins)
Vùi-sṳ̂-khà-sén	Huesca (provins)
Sok-lî-â-sén	Soria (provins)
Hien-thoi Khì-chhâ	Hyundai Motor Company
Kîm Tsang-ên	Kim Jong-un
Kông-sî	Jiangxi
Wernher von Braun	Wernher von Braun
Nèn-ha	Ningxia
Lí Hién-liùng	Lee Hsien Loong
Kîm-fà-sṳ	Jinhua
Thòi-chû-sṳ	Taizhou, Zhejiang
Phòng-châ-phú-ngî	Punjabi
Phú-sṳ̍p-thok-ngî	Pashto
Yâ-chû	Vildsvin
Chû-hói-sṳ	Zhuhai
Sân-thèu-sṳ	Shantou
Shâu-kûan-sṳ	Shaoguan
Kông-mùn-sṳ	Jiangmen
Chhám-kông-sṳ	Zhanjiang
Shàu-khin-sṳ	Zhaoqing
Fi-chiu-sṳ	Huizhou
Mòi-chiu-sṳ	Meizhou
San-mî-sṳ	Shanwei
Hò-ngièn-sṳ	Heyuan
Yòng-kông-sṳ	Yangjiang
Chhîn-yén-sṳ	Qingyuan
Tûng-kôn-sṳ	Dongguan
Chûng-sân-sṳ	Zhongshan
Chhèu-chiu-sṳ	Chaozhou
Mâ-liuk-kap-sṳ	Malacka (stad)
Khiâu-chhṳ-sṳ	George Town, Pinang
Sṳn-chhôn-lî	Nattvard
Fuk-chiu-sṳ	Fuzhou
Nàm-phìn-sṳ	Nanping
Phû-thièn-sṳ	Putian
Sâm-mìn-sṳ	Sanming
Tshièn-chiu-sṳ	Quanzhou
Hà-mûn-sṳ	Xiamen
Chông-chiu-sṳ	Zhangzhou
Liùng-ngâm-sṳ	Longyan
Nèn-tet-sṳ	Ningde
Sî-pak-li-â Fú	Sibirisk tiger
Buren	Buren
Yáng-chhiong Chín-thôn-ho̍k	Radiologi
Rumia	Rumia
Kluczbork	Kluczbork
La̍p-tsuk	Levande ljus
Hiet-chiong	Blodplasma
Southampton	Southampton
Lu-tet-ki	Ruts bok
Hâ-sat-khiet-chhu̍k	Kazaker
Yòng-mî	Egentliga trollsländor
Chit-fûn-ho̍k	Integral
Kô-lìm-tô-chhièn-sû	Första Korinthierbrevet
Sî-pân-ngà Ti-koet	Spanska imperiet
Pha̍k-yùn-khî (Kóng-chiu-sṳ)	Baiyun, Guangzhou
Sṳ-sṳ̂-ki	Domarboken
Po-lîn-chhòi	Spenat
Pâ-set-lò-nâ-sén	Barcelona (provins)
Liuk-piên-hìn	Hexagon
Thòi-pet 101	Taipei 101
Lùn-tûn Thap-khiâu	Tower Bridge
Siù-li Yún-kòn-sien-chhùng	Caenorhabditis elegans
O-pô-lòi	Opole
Sopot	Sopot
Â-sṳ̂-thù-lî-â-sṳ̂-sén Chhṳ̍t-hot-sṳ	Kommuner (concejos) i Asturien
Kám-lám-yù	Olivolja
Chim-sin-fi	Baptism
Lie̍t-yî-tha̍t-sén Chhṳ̍t-hot-sṳ	Kommuner i Lleidaprovinsen
Vú-yî-sân-sṳ	Wuyishan (stad)
Set-vì-li-â-sén	Sevilla (provins)
Thap-là-kô-na̍p-sén	Tarragona (provins)
Provence-sén	Provence
Kî-hài Kûng-chhàng	Maskinteknik
Apeldoorn	Apeldoorn
Lìm-pó-ngî	Limburgiska
Khái-ngì-chhái	Kielce
Bytom	Bytom
Ôn-sit-ngit	Sabbat
Khìm-sṳ̂-thok-khok-ngá	Częstochowa
Zabrze	Zabrze
Ôn-sit-ngit-fi	Sjundedagsadventisterna
Jean Michel Jarre	Jean Michel Jarre
Thai Pô-làn Thi-khî Kô-yî-fû	Gorzów Wielkopolski
Là-tô-mê	Radom
Lo̍k-chham-ki-yen	Los Angeles County
Słupsk	Słupsk
Sosnowiec	Sosnowiec
Gliwice	Gliwice
Yo̍k-sṳ̂	Apotekare
Hi-kôn Yì-chhṳ̍t	Transplantation
Pâ-lùn-sî-â-sén Chhṳ̍t-hot-sṳ	Kommuner i Valenciaprovinsen
Bielsko-Biała	Bielsko-Biała
Rybnik	Rybnik
Tân-fu̍t Se-pâu	Monocyt
Mâ-khó-fuk-yîm	Markusevangeliet
Ruda Śląska	Ruda Śląska
Yok-thán-vòng	Jotam
Nò-mí	Grötris
Kîn-tû-fú	Kyoto prefektur
Kau-su	Professor
Thai-fán-fú	Osaka prefektur
Fuk-kông-yen	Fukuoka prefektur
Oi-yèn-yen	Ehime prefektur
Kô-lìm-tô-heu-sû	Andra Korinthierbrevet
Khien-mî	Kroppsbyggning
Chhùng-hièn	Daggmask
Port Elizabeth	Port Elizabeth
Kimberley (Nàm-fî)	Kimberley, Sydafrika
Yok-sâ-fap-vòng	Josafat
Thòi-vân Hói-hia̍p	Taiwansundet
Sî Khôi-phú-sén	Västra Kapprovinsen
Yamaguchi-yen	Yamaguchi prefektur
Khiâu-chhṳ Sâm-sṳ	Georg III av Storbritannien
Chûng-koet Thi-fông	Chugoku
Mî-koet Thu̍k-li̍p Siên-ngièn	USA:s självständighetsförklaring
Sâm-tshûng-yen	Mie prefektur
Yù-mu̍k mìn-chhu̍k	Nomader
Hiông-pak-su	Cedersläktet
Hî-pak-lòi-sû	Hebreerbrevet
Kâ-lâ-thai-sû	Galaterbrevet
Màn-é	Ålartade fiskar
Sông-chhèu	Shangdynastin
Thai-thúi	Lår
Pîn-khù-yen	Hyogo prefektur
Kiûng-khì-yen	Miyazaki prefektur
Yùng-pún-yen	Kumamoto prefektur
Fò-phìn-sṳ	Hoa Binh (stad)
Stamford Raffles	Thomas Stamford Raffles
Sha̍m-é	Cikador
Tûng Khôi-phú-sén	Östra Kapprovinsen
Fap-koet Hòng-khûng	Air France
Lie̍t-vòng-ki-song	Första Kungaboken
Kô-lò-sî-sû	Kolosserbrevet
Ngâ-kok-sû	Jakobsbrevet
Yok-hon-yit-sû	Första Johannesbrevet
Fî-li-mùn-sû	Filemonbrevet
Thiap-sat-lò-nì-kâ-heu-sû	Andra Thessalonikerbrevet
Thiap-sat-lò-nì-kâ-chhièn-sû	Första Thessalonikerbrevet
Pí-tet-chhièn-sû	Första Petrusbrevet
Thì-mô-thai-chhièn-sû	Första Timotheosbrevet
Lí Kông-yeu	Lee Kuan Yew
Chṳ̂-kâ-kô Thai-ho̍k	University of Chicago
Tsṳ̂-fo-yen	Shiga prefektur
Mu-nì-het Kî-chhòng	Flughafen München Franz Josef Strauss
Yok-hon-ngi-sû	Andra Johannesbrevet
Thì-mô-thai-heu-sû	Andra Timotheosbrevet
Thì-tô-sû	Titusbrevet
Yî-sṳ̂-lâ-ki	Esra
Nì-hî-mí-ki	Nehemja
Pietersburg	Polokwane
Séu Pha̍k-Lù	Silkeshäger
Chhòn-ngiam-phiang	Infektionssjukdom
Kôn-yàm	Hepatit
Chhûn-chiet	Kinesiskt nyår
Shinzō Abe	Shinzo Abe
Mpumalanga-sén	Mpumalanga
Pet Khôi-phú-sén	Norra Kapprovinsen
Tó-kîn-yen	Shimane prefektur
Kông-sân-yen	Okayama prefektur
Gauteng-sén	Gauteng
Thung-fûng	Gikt
Thai-fûn-yen	Ōita prefektur
Tiâu-tshí-yen	Tottori prefektur
Nùng-la̍k	Kinesiska kalendern
Kô-tî-yen	Kochi prefektur
Pha̍k-hèu	Difteri
Exeter	Exeter
Saint Lawrence-hò	Saint Lawrencefloden
Limpopo-sén	Limpopoprovinsen
Kô-tén Kau-yuk	Högre utbildning
Â-pí	Kota Kinabalu
Ngi̍t-pún thúng-tshṳ sṳ̀-thoi (Thòi-vân)	Taiwan under japanskt styre
Phok Kiún-fi	Park Geun-hye
Lévis	Lévis
Thòi-fûng	Tyfon
Thòi-nàm-sṳ	Tainan
Laval (Québec)	Laval, Québec
Mâ-lòi Pô-lî-nì-sî-â Ngî-chhu̍k	Malajo-polynesiska språk
Fên-yòng-sṳ	Hengyang
Pet-lûn-khî	Beilun
Mân-chiu-tshu̍k	Manchuer
Zambrów	Zambrów
Doetinchem	Doetinchem
Zamość	Zamość
Malbork	Malbork
Groesbeek	Groesbeek
Mì-chit-fûn-ho̍k	Infinitesimalkalkyl
Mì-fûn	Differentialkalkyl
Ngo̍k-yòng-sṳ	Yueyang
BP	BP
Sú-thiàu	Pommes frites
Kiok-tsṳ́	Tå
Vî-liâm Â-li̍t-sân-thai (Hò-làn)	Willem-Alexander av Nederländerna
Krasnystaw	Krasnystaw
Sî-fù-khî (Hông-chû-sṳ)	Xihu, Hangzhou
Vì-tô-li-â Kóng	Victoria Harbour
Sî-kung-khî	Sai Kung
Mâ-nâ-sî-vòng	Manasse (kung)
Kî-kîm-fi	Stiftelse
A-hîn Kôn-yàm	Hepatit A
Yù-tsiâm-vong-khî	Yau Tsim Mong
Fûng-sái	Kaki
Tshṳ̍t-tshòng	Ändtarm
Chhṳ-yù Pâng-sén	Fristatsprovinsen
Tsó-fo-yen	Saga prefektur
Tet-tó-yen	Tokushima prefektur
Sî-pân-ngà-ngìn	Spanjorer
Fu̍t-chhṳ̂ Khiung-chṳn Sṳ̀n-siong	Magnetisk resonanstomografi
Hiông-tshon-yen	Kagawa prefektur
Reading, Berkshire	Reading
Kâ-chû Lî-kûng Ho̍k-yen	California Institute of Technology
Vì-ngì-tshṳ-páu Thai-ho̍k	Würzburgs universitet
Êu-kí-lî-tet Kí-hò	Euklidisk geometri
Si̍t-kuk	Silicon Valley
Barneveld	Barneveld
Khiu Tha̍t-sîn	Thaksin Shinawatra
Thòi-sân-sṳ	Taishan, Jiangmen
Lièn-phìn-yen	Lianping
Kîm-kôa	Pumpa
Thai Sùn-thâ Khiùn-tó	Stora Sundaöarna
Elburg	Elburg
Doesburg	Doesburg
Sî-pet-sén	Nordvästprovinsen, Sydafrika
Sien-thon	Linjestycke
Vûn-tai	Tempererat klimat
Thai-khi̍t-khièn	Taijiquan
Kiok-khwá	Vrist
Pân-kiêu-é	Turturduva
Tshòng-khì-yen	Nagasaki prefektur
Hà-chhèu	Xiadynastin
Chû-vì Sṳ̀n-kîn Ne-thúng	Perifera nervsystemet
Lùn-tûn Thai-ho̍k	University of London
Kip-sú	Serie (matematik)
Nelspruit	Nelspruit
Sâ-là-ye̍t-chû	Sarawak
Â-chû Thai-phìn-yòng Kîn-tsi Ha̍p-tsok Fi-ngi	Asia-Pacific Economic Cooperation
Kôan-chiet-yàm	Ledinflammation
Geldermalsen	Geldermalsen
Chûng-la̍k-sṳ	Zhongli
Montauban	Montauban
Chhòng-sâ-sṳ	Changsha
Thai Put-lie̍t-tiên lâu Oi-ngì-làn Lièn-ha̍p Vòng-koet	Förenade kungariket Storbritannien och Irland
Kiok-kiên	Häl
Kûng-fûn	Centimeter
Lièn-ha̍p Hòng-khûng	United Airlines
Yen-thèu	Svalg
Khi̍t-han (Sú-ho̍k)	Gränsvärde
Theu-fú	Tofu
Phù-sat	Bodhisattva
Chóng-ló Kau-fi	Presbyterianism
Nai-mí	Nanometer
Pâ-chûng-sṳ	Bazhong
Fu̍t-kông-yen	Fogang
Sâ-pâ-chû	Sabah
Nàm-nèn-sṳ	Nanning
Ngâ-li-ôn-ngìn	Arier
Yù-sṳn-mî-thi Koet-kâ Kûng-yèn	Yosemite nationalpark
Chhiâng-set	Cyan
Ho̍k-yen	Fakultet
Kô-hiùng-sṳ	Kaohsiung
Pet-mî Chhṳ-yù Mo-yi Hia̍p-ngi	North American Free Trade Agreement
Sû-kak-làn-ngìn	Skottar
Rustenburg	Rustenburg
Yen-tsong-fui	Konsert
Yù-fu̍t-chû	Johor
Ngò-lò-sṳ̂ Lièn-pâng Chhṳ̍t-hot-sṳ	Rysslands federala städer
Fì-tshu̍k	Hui (folk)
Sha̍k-sṳ	Master (anglosaxisk examen)
Preston, Lancashire	Preston
Sî-tí-kâ-vòng	Sidkia
Sâm-koet	De tre kungadömena
Chhûn-chhiû Sṳ̀-khì	Vår- och höstperioden
Chan-koet Sṳ̀-khì	De stridande staterna
Mâ-liuk-kap-chû	Malacka
Pietermaritzburg	Pietermaritzburg
Sú-vón	Handled
Kit-làn-tan-chû	Kelantan
Tshông-tshu̍k	Tibetaner
Pîn-sàng-chû	Pinang (delstat)
Blackburn	Blackburn
Chûng-sin Pha̍k-hiet-khiû	Neutrofil granulocyt
Pâng-kâ-tó	Bangka
Phìn-chhông-khiùn	Pyeongchang
Thai-koet Koet-chi Hòng-khûng Kûng-sṳ̂	Thai Airways International
Thai Ngi̍t-pún Ti-koet	Japanska imperiet
Hiûng-nù	Xiongnu
Phit-li̍t-chû	Perak
Lùn-tûn Ti-koet Ho̍k-yen	Imperial College London
Tsen-sàng-sṳ	Zengcheng
Kui-lìm-sṳ	Guilin
Siet-làn-ngô-chû	Selangor
Tui-kok-sien	Diagonal
Fi-li-phi Liuk-sṳ	Felipe VI av Spanien
Kûng-tún	Ton (metriskt)
Phàng-hên-chû	Pahang
中國象棋	Xiangqi
Pit-sṳn-hak	Pizza Hut
Yim-suk Siáu-tsṳ́	Sonic the Hedgehog (figur)
Ngo̍k-vûn-khiet-tshu̍k	Evenker
Kiu-ên	Frälsning
Nàm-kîn Thai-thù-sat	Nanjingmassakern
Yún Chṳ-Hau	Yun Chi-ho
Phì-mí	Pikometer
Chûng-koet 2010-ngièn Sông-hói Sṳ-kie Pok-lám-fi	Expo 2010
Ngiù-ngiuk	Nötkött
Carlisle, Cumbria	Carlisle
Sandomierz	Sandomierz
Ngit-tèu-kông	Solljus
Khwon-kûan-tsiet	Höftled
Fûn-kî-hon-khiûn	Mykobakterier
Chàu-yòng-sṳ	Shaoyang
Hién-mì-kiang	Mikroskop
Chông-phìn-sṳ	Zhangping
Chông-kâ-kie-sṳ	Zhangjiajie
Tsàu-ôn-yen	Zhao'an
Chṳ Sṳ̀n-kûng	Koxinga
Tsṳn-fò-yen	Zhenghe
Chṳ́n-hói-khî (Nèn-pô-sṳ)	Zhenhai
Tsû-nèn-yen	Zhouning
Chon-hiuk	Gaoyao (Xiadynastin)
Chu-chû-sṳ	Zhuzhou
Nàm-sâ-khî	Nansha
McGill Thai-ho̍k	McGill University
Sâm-fòng Ńg-ti	Tre härskare och fem kejsare
Sanok	Sanok
Tsṳ́-kîm-yen	Zijin
Mâ-tshâ	Häststridsvagn
Milton Keynes	Milton Keynes
Â-mî-tshu̍k	Amisfolket
Ên-tién	Nåd (teologi)
Hiong-sàng-khî	Xiangcheng, Zhangzhou
Hî-lìn-tên-khî	London Borough of Hillingdon
Chṳ̂-yòng-sṳ	Ziyang
Sṳ̀n-chhùng	Imago
Chang Thien-chṳ́ Fat-sa Kie-son-kî Thôn-chhèn Só-mèu	Positronemissionstomografi
Przemyśl	Przemyśl
Chhiòn-khiû Sàng-sṳ	Världsstad
Pî-mí	Femtometer
Burnley	Burnley
Tûng Lùn-tûn, Tûng Khôi-phú-sén	East London, Sydafrika
Sat-mû-ngí-ki-ha	Andra Samuelsboken
Li̍t-thoi-chṳ-ha	Andra Krönikeboken
Lie̍t-vòng-ki-ha	Andra Kungaboken
Biała Podlaska	Biała Podlaska
Mèu-tshu̍k	Miao (folk)
Pet-hói-sṳ	Beihai, Guangxi
Mafikeng	Mafikeng
Mí-sâ-yên Khiùn-tó	Visayaöarna
Lò-pô-ôn-vòng	Rehabeam
Slough	Slough
Chho̍k-sṳ̂-lia̍p	Centromer
Tûng-hò, Néu-yok-sṳ	East River
Chhêu-fông-hìn	Hyperkub
Sêm-mî-làn-chû	Negeri Sembilan
Brzeg	Brzeg
Fidel Valdez Ramos	Fidel Ramos
Łomża	Łomża
Siong-thâm-sṳ	Xiangtan
Thûng-tshu̍k	Dong (folkslag)
Pak-fo Kûng-sṳ̂	Varuhus
騷靈現象	Poltergeist
Na̍p-sî-tshu̍k	Nakhi
Outaouais	Outaouais
Kuî-é	Sköldpaddor
Pak-sâ-sat	Belsassar
Tshièn-pí	Underarm
Yî-set-lie̍t Vòng-koet	Kungariket Israel
Sîn-sân-sṳ	Johor Baharu
Khiu-kîm-sân Vân	San Francisco Bay
Li Mâ-teu	Matteo Ricci
Tshài Yîn-vùn	Tsai Ing-wen
Chełm	Chełm
Pha̍k-ngìn	Vit (hudfärg)
Â-ha̍p-vòng	Achav
Suwałki	Suwałki
Sî-làn-ngî	Zeeländska
Epe	Epe
Maidenhead	Maidenhead
Chû Khiet-lùn	Jay Chou
Kiú-liùng	Kowloon
Nâ-pô-nì-tha̍t	Nabonidus
Hâ-phú-yen	Xiapu
Ngie-mí-li-ôn Lò-mâ-nok-ngî	Emiliano-romagnolo
Hî-sî-kâ-vòng	Hiskia
Thòi-chûng-sṳ	Taichung
IPhone 4S	Iphone 4S
Jędrzejów	Jędrzejów
Kîm-mùn-yen	Kinmen
Sîn-chuk-sṳ	Hsinchu
Kâ-ngi-sṳ	Jiayi
Kî-lùng-sṳ	Chilung
Busko-Zdrój	Busko-Zdrój
Àu-thai-li-â Ngièn	Australisk dollar
Thùng-lû-yen	Tonglu, Hangzhou
Fuk-tshîn-sṳ	Fuqing
Chṳ́-khiâu-khiùn	Cau Giay
Hon-ho̍k	Sinologi
Yî-pó-sṳ	Ipoh
Ná-pô-pha-lâ-sâ-ngì	Nabopolassar
Â-pí-ngâ-vòng	Aviam
Sûn N̂g	Östra Wu
Pha̍k-chhu̍k	Bai (folk)
Aalten	Aalten
Xuxa	Xuxa
Hajnówka	Hajnówka
Hâu-kông-khî	Haojiang
Yòng-sân-yen	Yangshan
IPhone 4	Iphone 4
Tûng-Chû	Östra Zhoudynastin
Mâ-lòi-sî-â Hòng-khûng	Malaysia Airlines
Chûng-sî-khî (Hiông-kóng)	Centrala och västra Hongkong
Mí-nâ-hien-vòng	Menachem
Â-ha̍p-chhia-vòng (Yî-set-lie̍t)	Achasja (kung i Israel)
Â-ha̍p-chhia-vòng (Yù-thai)	Achasja (kung i Juda)
Yok-làn-vòng (Yù-thai)	Joram
Â-sat-li-ngâ	Ussia
Peter Nalitch	Pjotr Nalitj
Yâ-lò-pô-ôn yit-sṳ	Jerobeam
Am-li-vòng	Omri
Nâ-tap-vòng	Nadav
Pâ-sâ-vòng	Basha
Yâ-fu-vòng	Jehu
Yok-sî-â-vòng	Josia
Yok-â-sṳ̂-vòng (Yù-thai)	Joash
Sîm-li-vòng	Simri
Yâ-lò-pô-ôn ngi-sṳ	Jerobeam II
Â-mâ-chhia-vòng	Amasja
N̂g Chok-tùng	Goh Chok Tong
Â-sat-vòng	Asa (kung)
Â-mùn-vòng	Amon (kung)
Chong Koet-yùng（Chong Fat-chûng）	Leslie Cheung
Lí Tên-Fî	Lee Teng-hui
Yî-lâ-vòng	Ela
Yok-ngâ-kin-vòng	Kung Jojakim
Hò-se-â-vòng	Hosea (kung)
Yok-ngâ-kîn-vòng	Jojakin
Biłgoraj	Biłgoraj
Puławy	Puławy
Chuk Hon	Shu Han
Chhâu Ngùi	Cao Wei
Abitibi-Témiscamingue	Abitibi-Témiscamingue
Mò-tóng-sit	Partilös
Iwakuni-sṳ	Iwakuni
Kâu-thûng kûng-khí	Transportmedel
Phok Hièn-yún	Pak Hon-yong
Yok-ha̍p-sṳ̂-vòng	Joachas
Fùng Siù-chhiòn	Hong Xiuquan
Yok-â-sṳ̂-vòng (Yî-set-lie̍t)	Joash (kung i Israel)
Yok-làn-vòng (Yî-set-lie̍t)	Joram (kung i Israel)
Pí-kâ-vòng	Pekach
Sâ-liùng-vòng	Shallum
Pí-kâ-hot-vòng	Pekachja
Fùng Puk-kím Kiê	Guldfasan
Yok-ha̍p-sṳ-vòng	Joahas
Łapy	Łapy
Sin-ngióng	Brud
Pâ-set-fi	Baselmissionsällskapet
Mî-yî-mî-fi	Methodist Episcopal Church
Hagi-sṳ	Hagi (stad)
Wong Hi-zi	Wang Xizhi
Meu-nàm-khî	Maonan, Maoming
Chûng-chhiû-chiet	Månfestivalen
Fùng-theu	Azukiböna
Łęczna	Łęczna
Pô-sṳ̂ Ti-koet	Akemenider
Nagato-sṳ	Nagato (stad)
Sî-lìm-yen	Xilin, Baise
Mâ-thai-fuk-yîm	Matteusevangeliet
Sṳ̍p-sṳ-ka	Kristet kors
Â-chû Hòng-khûng	AirAsia
Yî-fut-só-sû	Efesierbrevet
Sòng-tet-sṳ	Changde
Yit-yòng-sṳ	Yiyang
Chhim-chû-sṳ	Chenzhou
Tshî Kông-khí	Xu Guangqi
Súi-nèn-sṳ	Suining
Nui-kông-sṳ	Neijiang
Tha̍t-chû-sṳ	Dazhou
Ngá-ôn-sṳ	Ya'an
10000	10000 (tal)
Fú-kûa	Bittergurka
Fún-fùng-set	Rosa (färg)
Nâ-sat-le̍t	Nasaret
Yî-tshu̍k	Yi (folk)
Â-thâ-li-ngâ	Atalja
Augustów	Augustów
Windsor, Berkshire	Windsor, Berkshire
Kô Khô-kî	Högteknologi
Tai Tet-sâng	Hudson Taylor
Tczew	Tczew
Hâ-nì-tshu̍k	Hanifolket
Fù-chṳ-mìn-sṳ Kî-chhòng	Tan Son Nhat internationella flygplats
Hien-thoi Accent	Hyundai Accent
Hien-thoi Sonata	Hyundai Sonata
Hien-thoi Elantra	Hyundai Elantra
Hien-thoi Equus	Hyundai Centennial
Vû-tsṳ-phe̍t-khiet-chhu̍k	Uzbeker
Thap-kit-khiet-tshu̍k	Tadzjiker
Wal-Mart Kûng-sṳ̂	Walmart
Yùn-tôn yun-son	Datormoln
Ńg-sùn-chiet Yun-thung	Pentekostalism
Liu̍k-theu	Mungböna
Chêu-siên-chhu̍k	Koreaner
Khúa-ngì-khiet-tsṳ-tshu̍k	Kirgizer
Sông-hói Ha̍p-tsok Tsû-tsṳt	Shanghai Co-operation Organisation
Reus	Reus
Hien-thoi Santa Fe	Hyundai Santa Fe
Het-mien Phî-lù	Koreaskedstork
Sṳ̀n-chheu-fi	Assemblies of God
Fâ-tû-khî	Huadu
Sâ-â-nàm	Shah Alam
Kit-lùng-po Koet-chi Kî-chhòng	Kuala Lumpur International Airport
Ngiu̍k-Sân	Yushan
Hōfu-sṳ	Hōfu
Thai-yí-sân	Lantau
Starogard Gdański	Starogard Gdański
Sîn-chhèu	Wang Mangs interregnum
Mauricie	Mauricie
Vû-yìn	Egentliga flugor
Tha̍t-mâ-thai	Dalmatien
Witwatersrand Thai-ho̍k	University of the Witwatersrand
Hò-tûng-sṳ	Ha Dong
Mâ-lî-sûn	Robert Morrison
Fû-lùn-pi-ngì-sṳ	Hulunbuir
Ǹg-chiu-sṳ	Wuzhou
Fòng-sàng-kóng-sṳ	Fangchenggang
Khîm-chiu-sṳ	Qinzhou
Kui-kóng-sṳ	Guigang
Ngiu̍k-lìm-sṳ	Yulin, Guangxi
Pak-set-sṳ	Baise, Guangxi
Fo-chiu-sṳ	Hezhou
Hò-chhṳ̀-sṳ	Hechi
Lòi-pîn-sṳ	Laibin
Fuk-thièn-khî	Futian
Chhùng-chó-sṳ	Chongzuo
Thú-kâ-tshu̍k	Tujia
Lai-vân-khî	Liwan
Siau-sân-khî	Xiaoshan
Fûng-khôi-yen	Fengkai
Sîn-kie	Nya territorierna
Khôi-phìn-sṳ	Kaiping
Mo-yi	Handel
Thí-lîn-sṳ	Liling
Ôn-hâi-yen	Anxi
Duiven	Duiven
Yo̍k-ho̍k	Farmaci
Fi-yòng-khî	Huiyang
Kóng-tó-yen	Hiroshima prefektur
Ye̍t-nàm-ngî sṳ-mû	Quoc ngu
Fuk-tín-sṳ	Fuding
Thú-ngí-khì-ngî sṳ-mû	Turkiska alfabetet
Kien-yòng-sṳ	Jianyang, Nanping
Shūnan-sṳ	Shunan
Skarżysko-Kamienna	Skarżysko-Kamienna
Kô-tá-ha̍p-lû-sṳ	Kota Bharu
Sú-chiuk-khiéu-phiang	Vesikulös stomatit
Kông-phú	Spektrum
Chhṳ̂m-súi-phu-khî	Sham Shui Po
Mielec	Mielec
Yùn-siau-yen	Yunxiao
客家	Hakka
Vù-kau-piáng	Ojäst bröd
Wejherowo	Wejherowo
Ńg-fù Sṳ̍p-liuk-koet	De sexton kungadömena
Néu-yok Tû-fi-khî	New Yorks storstadsregion
Ng̀-tshon-sṳ	Wuchuan, Zhanjiang
Lanaudière	Lanaudière
Lo̍k-chhîn-sṳ	Yueqing
Eu-hói-khî	Ouhai
Thai-ngâ-tshu̍k	Atayalfolket
Joy	Joy (musikgrupp)
Liu̍k-tó-hiông	Gröna ön
Pu-nùng-tshu̍k	Bununfolket
Nàm-kôn-hiông	Nangan
Liùng-vân-khî	Longwan
Lu̍k-sàng-khî	Lucheng, Zhejiang
Phìn-yòng-yen	Pingyang
Yún-kâ-yen	Yongjia
Thung-thèu-yen	Dongtou
Ǹg-yèn	Fiskbullar
Chhṳ̀-hâi-sṳ	Cixi, Ningbo
Kîm-sàng-tsṳ́n	Jincheng, Kinmen
Vû-hiu-hiông	Wuqiu
Mâ-hâi	George Leslie Mackay
Theui-waan Thin-get Lin-mang	Taiwans Solidaritetsförbund
Phìn-fông Kûng-lî	Kvadratkilometer
Shuì-ôn-sṳ	Rui'an
Fung-fa-sṳ	Fenghua
Thòi-fûng Mo̍k-Là-Khiet (2009-ngièn)	Tyfonen Morakot
Thòi-pet Tshia̍p-yun	Taipeis tunnelbana
Chhòn-yùng Hòng-khûng	EVA Air
Kôn-yîm	Guanyin
Phài-vân-tshu̍k	Paiwanfolket
Thòi-vân nàm-tó ngî-ngièn	Formosanska språk
Lìm-pâ Se-pâu	Lymfocyt
Thò-yèn-sṳ	Taoyuan
Hak-kâ thú-lèu	Fujian Tulou
100000	100000 (tal)
Kô-sîn-shì	Ku (kejsare)
Jarosław	Jarosław
Tûng-khî (Hiông-kóng)	Östra Hongkong
Gaspésie–Îles-de-la-Madeleine	Gaspésie–Îles-de-la-Madeleine
Pok-lò-yen	Boluo
Ostrowiec Świętokrzyski	Ostrowiec Świętokrzyski
Tshiâ-tshu̍k	She (folk)
Sên-sán	Produktion
Chojnice	Chojnice
Bronckhorst	Bronckhorst
Mine-sṳ	Mine, Yamaguchi
Mì-fûn-ho̍k	Differential
Tûng-hiông-tshu̍k	Dongxiang
Włodawa	Włodawa
Chat-ho̍k Pok-sṳ	Filosofie doktor
Lì-tó-khî	Öarna
Ermelo	Ermelo
Thông-phûng	Långtungebin
Tshûng-shîn-yen	Okinawa prefektur
Tshòng-lo̍k-sṳ	Changle, Fuzhou
Sâm-súi-khî	Sanshui
Nàm-thin-sṳ	Nam Dinh
Montpellier Thai-ho̍k	Montpelliers universitet
Końskie	Końskie
Kien-nèn-yen	Jianning
Lô-kông-khî	Luogang
Madrid Chhṳ-chhṳ Thai-ho̍k	Universidad Autónoma de Madrid
Medway	Medway
Pó-ôn-khî	Bao'an
Nysa, Pô-làn	Nysa
Culemborg	Culemborg
Kôan-tan-sṳ	Kuantan
Thâu-thông-shì	Yao (kejsare)
Hikari-sṳ	Hikari (stad)
Krosno	Krosno
Kûng-lî	Kilometer
Aldealafuente	Aldealafuente
Shâu-sân-sṳ	Shaoshan
Kudamatsu-sṳ	Kudamatsu
Kiong-tshu̍k	Qiang
Afrikaner-ngìn	Afrikander
Yîn-koet-ngìn	Britter
Brummen	Brummen
Kûng-yîn	Hektometer
Fû-yûng-sṳ	Seremban
Jasło	Jasło
Beuningen	Beuningen
Kîn-mí	Gigameter
Sîn-lòng	Brudgum
Pân-kap	Guineaduva
Súi-tshu̍k	Shui
Vì-kî Pak-khô Ngî-ngièn Lie̍t-péu	Wikipedia:Wikipedia på andra språk
Siên-pî-chhu̍k	Xianbei
Sanyo-Onoda-sṳ	Sanyoonoda
Billingham	Billingham
Pin-kông-khî	Binjiang
Pet-khî (Hiông-kóng)	Norra Hongkong
Nu-tshu̍k	Nufolket
Sî-sûng-pán-na̍p Thài-tshu̍k Tshṳ-tshṳ-chû	Xishuangbanna
Ngièn-lóng-khî	Yuen Long
Kôn-thòng-khî	Kwun Tong
Khwûi-tshiâng-khî	Kwai Tsing
Thai-pu-khî	Tai Po
Vòng-thai-siên-khî	Wong Tai Sin
Tshiên-vân-khî	Tsuen Wan
Chhîn-sîn-yen	Qingxin
Pâ-thìn-khiùn	Ba Đình
Mìn-chú Chin-phu-tóng	Demokratiska framstegspartiet
Tomaszów Lubelski	Tomaszów Lubelski
Thiên-hò-khî	Tianhe
Po-thèu-khî	Potou
Hàng-thung Chok-ngia̍p Ne-thúng	Mobiloperativsystem
Hrubieszów	Hrubieszów
Liùng-mùn-yen	Longmen
Hói-tshong-khî	Haicang
Pet Québec Thi-khî	Nord-du-Québec
Montérégie	Montérégie
Druten	Druten
Nàm-hiùng-sṳ	Nanxiong
Sun-tet-khî	Shunde
Fân-nyî-khî	Panyu
Québec-ngìn Tóng	Parti Québécois
Grahamstown	Grahamstown
Kui-phìn-sṳ	Guiping
Tûng-sân-yen	Dongshan, Zhangzhou
Si̍p-mî-khî	Jimei
Kraśnik	Kraśnik
Radzyń Podlaski	Radzyń Podlaski
Thûn-mùn-khî	Tuen Mun
Kiú-liùng-sàng-khî	Kowloon City
Nàm-khî (Hiông-kóng)	Södra Hongkong
Vân-chái-khî	Wan Chai
Stockton-on-Tees	Stockton-on-Tees
Kóng-nèn-yen	Guangning
Wokingham	Wokingham
Kô-lò-sî	Kolossai
Lò-fù-khî	Luohu
Yàm-thièn-khî	Yantian
Khiâm-nàm Pu-yî-tshu̍k Mèu-tshu̍k Tshṳ-tshṳ-chû	Qiannan
Lìm-ha Fì-tshu̍k Tshṳ-tshṳ-chû	Linxia
Liùng-kông-khî	Longgang, Guangdong
Orania	Orania (stad)
Fu-yòng-sṳ	Fuyang, Hangzhou
Yì-yâu-sṳ	Yuyao
Â-pa Chhong-chhu̍k Kiông-chhu̍k Chhṳ-chhṳ-chû	Ngawa
Lìm-ôn-sṳ	Lin'an
Hói-tsû-khî	Haizhu
Ye̍t-siù-khî	Yuexiu
Swellendam	Republiken Swellendam
Vòng-pu-khî	Huangpu, Guangzhou
Nàm-hói-khî	Nanhai
Sin-nî-sṳ	Xinyi, Maoming
Sîn-fi-khî	Xinhui
Tshiùng-fa-sṳ	Conghua
Lièn-sân Chong-chhu̍k Yâu-chhu̍k Chhṳ-chhṳ-yen	Lianshan, Qingyuan
Lo̍k-tshông-sṳ	Lechang
Lièn-chiu-sṳ	Lianzhou
Kô-yêu-sṳ	Gaoyao
Hîn-nèn-sṳ	Xingning, Meizhou
Ho̍k-sân-sṳ	Heshan, Jiangmen
Yòng-chhûn-sṳ	Yangchun
Thùng-ôn-khî	Tong'an
Liu̍k-fûng-sṳ	Lufeng, Shanwei
Thòi-kông-khî	Taijiang, Fuzhou
Liùng-hói-sṳ	Longhai
Sa̍k-sṳ̂-sṳ	Shishi, Quanzhou
Siông-ôn-khî	Xiang'an
Mên-hêu-yen	Minhou
Liù-yòng-sṳ	Liuyang
Tsàu-vú-sṳ	Shaowu
Hói-shù-khî	Haishu
Kien-tet-sṳ	Jiande
Phî-yen	Pi, Chengdu
Tshîn-hói-khî	Chenghai
Yîn-tet-sṳ	Yingde
Vi	Magsäck
Tshông-sân-khî	Cangshan, Fuzhou
Liùng-hâ	Hummer
Pak-van-mí	Megameter
Chhà-lîn-yen	Chaling
Shèn-sàng-khî	Chancheng
Tshòng-thai-yen	Changtai
Tshòng-tin-yen	Changting
Tshèu-ôn-yen	Chao'an
Chaudière-Appalaches	Chaudière-Appalaches
Sî-Chû	Västra Zhoudynastin
Sàng-siong-khî	Chengxiang
Tshak-kham-khî	Chikan, Zhanjiang
Sùn-ôn-yen	Chun'an
Lí-sàng-khî	Licheng, Quanzhou
Pet-ngan Thi-khî (Québec)	Côte-Nord
Mí-nàm-kâ-pó-ngìn	Menangkabau
Néu-yok-kóng	New York Harbor
Tha̍k-é	Dizi
Su-nèn-yen	Shouning
Thai-phû-yen	Dabu
Kú-thièn-yen	Gutian
Tet-fa-yen	Dehua
Tet-khin-yen	Deqing, Zhaoqing
Fi-sàng-khî	Huicheng
Fài-si̍p-yen	Huaiji
Kông-hói-khî	Jianghai
Thien-pha̍k-yen	Dianbai
Mòi-yen	Meixian
Lièn-sàng-yen	Liancheng
Kô-chiu-sṳ	Gaozhou
Si-fi-sṳ	Sihui
Ngièu-phìn-yen	Raoping
Lùi-chiu-sṳ	Leizhou
Sun-tshông-yen	Shunchang
Lò-ngièn-yen	Luoyuan
Phîn-nàm-yen	Pingnan, Ningde
Phìn-thâm-yen	Pingtan
Nàm-ôn-sṳ	Nan'an, Quanzhou
Àu-choi Fôn	Sadelnäbbstork
Tín-fù-khî	Dinghu
Chhîn-sàng-khî	Qingcheng, Qingyuan
Tûng-ngièn-yen	Dongyuan
Kî-chhòng	Flygplats
Téu-mùn-khî	Doumen
Tôn-chiu-khî	Duanzhou
Lî Ngâ-kok	James Legge
Yen	Härad (Kina)
Fûng-sun-yen	Fengshun
Siong-sân-yen	Xiangshan, Ningbo
Ngiûn-chû-khî	Yinzhou, Ningbo
Kông-pet-khî (Nèn-pô-sṳ)	Jiangbei, Ningbo
Nèn-hói-yen (Chet-kông-sén)	Ninghai
Kông-kòn-khî	Jianggan
Ngò-mì-sân-sṳ	Emeishan, Leshan
Siù-yí-khî	Xiuyu
Yún-tshûn-yen	Yongchun
Tsiau-sàng-khî	Jiaocheng, Ningde
Sien-yù-yen	Xianyou
Yèn-phìn-khî	Yanping
Sîn-lò-khî	Xinluo
Phú-sàng-yen	Pucheng, Nanping
Sâm-ngièn-khî	Sanyuan, Fujian
Hâm-kông-khî	Hanjiang, Putian
Fûng-tshe̍t-khî	Fengze
Lai-sàng-khî	Licheng, Putian
Sông-hông-yen	Shanghang
Tshiùng-hâi-yen	Songxi
Vú-phìn-yen	Wuping
Nàm-tshìn-yen	Nanjing, Zhangzhou
Liùng-fù-khî	Longhu
Sông-chhṳ̍t-yen	Sangzhi
Kông-sàng-khî	Jiangcheng, Yangjiang
Phûng-kông-khî	Pengjiang
Yòng-sî-yen	Yangxi
Yòng-tûng-yen	Yangdong
Hiông-chû-khî	Xiangzhou, Zhuhai
Yùng-yen (Chhṳ-kung-sṳ)	Rong, Zigong
Meu-kóng-khî	Maogang
Kîm-phìn-khî	Jinping, Shantou
Ket-sî-yen	Jiexi
Mòi-kông-khî	Meijiang
Siong-khiâu-khî	Xiangqiao
Ket-tûng-yen	Jiedong
Sîn-fûng-yen	Xinfeng, Shaoguan
Fò-phìn-yen	Heping, Heyuan
Sé-kiok-lî	Fottvagning
Kîm-vân-khî	Jinwan
Phìn-yén-yen	Pingyuan, Meizhou
Hói-fûng-yen	Haifeng
Lièn-nàm Yâu-chhu̍k Chhṳ-chhṳ-yen	Liannan
Liùng-tshôn-yen	Longchuan, Heyuan
Liu̍k-hò-yen	Luhe, Shanwei
Chiau-liang-yen	Jiaoling
Kông-tûng-khî (Nèn-pô-sṳ)	Jiangdong
Hâ-sàng-khî	Xiacheng
Kiúng-shú-khî	Gongshu
Yì-hông-khî	Yuhang
Sông-sàng-khî	Shangcheng, Hangzhou
Sân-sî Sṳ-sa	Son Tay
Windsor lâu Maidenhead	Royal Borough of Windsor and Maidenhead
Â-ha̍p-sùi-lû-vòng	Ahasverus (Bibeln)
Mà-tsông-khî	Mazhang
Ńg-fà-yen	Wuhua, Meizhou
Súi-hâi-yen	Suixi, Zhanjiang
Tshî-vùn-yen	Xuwen
Fuk-ôn-sṳ	Fu'an
Nàm-àu-yen	Nan'ao
Liâm-kông-sṳ	Lianjiang, Zhanjiang
Mên-tshîn-yen	Minqing
Hâ-sân-khî	Xiashan
Kien-eu-sṳ	Jian'ou
Mâ-mî-khî	Mawei
Yún-thai-yen	Yongtai
Liùng-vùn-khî	Longwen
Sṳ-mìn-khî	Siming
Fi-tûng-yen	Huidong, Huizhou
Phìn-fò-yen	Pinghe
Thai-nèn-yen	Taining
Kông-tshe̍t-yen	Guangze
Yún-ôn-sṳ	Yong'an
Thí-ngoi Mo̍k-yòng-ha̍p	Extrakorporeal membranoxygenering
Lìm Tan	Lin Dan
分類:Tet-koet	Kategori:Tyskland
分類:Yi-thai-li	Kategori:Italien
分類:Kâ-nâ-thai	Kategori:Kanada
分類:Sî-pân-ngà	Kategori:Spanien
分類:Chûng-koet	Kategori:Kina
分類:Ngi̍t-pún	Kategori:Japan
分類:Àu-thai-li-â	Kategori:Australien
分類:Yin-thu	Kategori:Indien
分類:Yî-set-lie̍t	Kategori:Israel
分類:Nàm-fî	Kategori:Sydafrika
Redcar and Cleveland	Redcar and Cleveland
分類:Yin-thu-nì-sî-â	Kategori:Indonesien
分類:Pâ-kî-sṳ̂-thán	Kategori:Pakistan
分類:Pô-làn	Kategori:Polen
分類:Sîn-kâ-po	Kategori:Singapore
分類:Hòn-koet	Kategori:Sydkorea
分類:Thai-koet	Kategori:Thailand
分類:Ye̍t-nàm	Kategori:Vietnam
分類:Phú-nen-lui	Kategori:Däggdjur
分類:Tiâu	Kategori:Fåglar
分類:Chhṳ̍t-vu̍t	Kategori:Växter
分類:Vu̍t-lí-ho̍k	Kategori:Fysik
分類:Chhṳ-yèn Khô-ho̍k	Kategori:Naturvetenskap
分類:Sâng-vu̍t-ho̍k	Kategori:Biologi
分類:Fa-ho̍k	Kategori:Kemi
分類:Li̍t-sṳ́	Kategori:Historia
分類:Thi-lî	Kategori:Geografi
分類:Sa-fi	Kategori:Samhälle
分類:Chûng-kau	Kategori:Religion
分類:Thí-yuk	Kategori:Sport
分類:Khô-ho̍k	Kategori:Vetenskap
分類:Lièn-ha̍p-koet	Kategori:Förenta nationerna
分類:Êu-chû Lièn-mèn	Kategori:Europeiska unionen
分類:Kien-chuk-vu̍t	Kategori:Byggnader
分類:Thûng-sin	Kategori:Kommunikation
分類:Thi-khiù	Kategori:Jorden
Sî Berkshire	West Berkshire
Hiông-kóng Thiet-lu Yû-han Kûng-sṳ̂	MTR Corporation
Thai-mo-sân	Tai Mo Shan
Kú Lò-mâ	Romerska riket
Sân-thi-mâ-lî-ngî	Västmariska
Tsui-heu ke Sṳ́m-phan	Yttersta domen
Sat-mû-ngí-ki-song	Första Samuelsboken
分類:Chet-ho̍k	Kategori:Filosofi
分類:Fu̍t-kau	Kategori:Buddhism
分類:Kî-tuk-kau	Kategori:Kristendom
分類:Yù-thai-kau	Kategori:Judendom
Ên-tiâu	Örnar
Bochotnica	Bochotnica
Jagersfontein	Jagersfontein
Zung-kok tsen-thung zit-nit	Traditionella kinesiska högtider
分類:Hàng-sên	Kategori:Planeter
分類:Vùn-fa	Kategori:Kultur
分類:Ngìn-vùn Khô-ho̍k	Kategori:Humaniora
分類:Tî-sṳt	Kategori:Kunskap
Chṳ́-set	Purpur
Hòn Sân-mìn	Theodor Hamberg
Lù-tshṳ̀	Skarvar
分類:Yên-yèn	Kategori:Skådespelare
模板:Tl	Mall:Mall
模板:Userbox	Mall:Användarbox
分類:Koet-kâ	Kategori:Världens länder
Wikipedia:Kón-lî-yèn	Wikipedia:Administratörer
分類:Ngìn-vu̍t	Kategori:Personer
Wikipedia:Hàng-tsṳn-yèn	Wikipedia:Byråkrater
Wikipedia:Kî-hi-ngìn	Wikipedia:Robotar
分類:Sṳ̀-kiên	Kategori:Tid
分類:Chhṳ-yèn	Kategori:Natur
分類:Kûng-chhàng	Kategori:Ingenjörsvetenskap
分類:Yî-ho̍k	Kategori:Medicin
分類:Chṳn-chṳ	Kategori:Politik
分類:Kau-yuk	Kategori:Utbildning
分類:Kông-ho̍k	Kategori:Optik
Âi-khi̍p	Egypten
分類:Chat-ho̍k-kâ	Kategori:Filosofer
模板:Bot	Mall:Bot
Kâ-nâ-thai	Kanada
分類:Hiûng-ngà-li	Kategori:Ungern
分類:Hî-lia̍p	Kategori:Grekland
分類:Lâ-thot-vì-â	Kategori:Lettland
分類:Yù-hi	Kategori:Spel
Thiên-koet	Himmelriket
分類:Êu-chû koet-kâ	Kategori:Europas länder
分類:Êu-chû	Kategori:Europa
模板:Documentation	Mall:Dokumentation
Wikipedia:Yung-fu	Wikipedia:Typer av användare
Pok-sṳ	Doktor
Wikipedia:Sa-khî	Wikipedia:Deltagarportalen
分類:Wikipedians by language	Kategori:Användare efter språk
Khi-néu Kî-chhòng	Flygnav
Khî-ngia̍p	Näringsliv
模板:Softredirect	Mall:Mjuk omdirigering
模板:Delete	Mall:Radera
分類:Kî-su̍t	Kategori:Teknologi
分類:Ngî-ngièn	Kategori:Språk
Wikipedia:Chhóng-kien Sîn Thiàu-muk	Wikipedia:Skriv en ny artikel
分類:還無索引嘅頁面	Kategori:Icke-indexerade sidor
分類:含有損壞文件鏈接嘅頁面	Kategori:Sidor med trasiga fillänkar
模板:Navbox	Mall:Navbox
Thoi-chhú	Känguru
Pak-ha̍p-fâ	Liljesläktet
模板:!	Mall:!
模板:!-	Mall:!-
模板:Tnavbar	Mall:Navbar
模板:Unicode	Mall:Unicode
模板:Smallcaps	Mall:Kapitäler
模板:Small	Mall:Small
模板:Nowrap	Mall:Nowrap
分類:Fî-chû	Kategori:Afrika
分類:Sṳn-kîn	Kategori:Bibeln
分類:Si	Kategori:Böcker
模板:Pâ-phe̍t	Mall:Babel
模板:Stub	Mall:Stub
模板:User ca-1	Mall:Användare ca-1
模板:User de	Mall:Användare de
模板:User de-1	Mall:Användare de-1
模板:User en-3	Mall:Användare en-3
模板:User en-1	Mall:Användare en-1
模板:User en-2	Mall:Användare en-2
模板:User en-4	Mall:Användare en-4
模板:User en-0	Mall:Användare en-0
模板:User en	Mall:Användare en
模板:User de-2	Mall:Användare de-2
分類:Yî-chhiu	Kategori:Universum
模板:User fr-2	Mall:Användare fr-2
模板:User ja-1	Mall:Användare ja-1
模板:User fr	Mall:Användare fr
模板:Location map/Info	Mall:Kartposition/Info
分類:Khûn-chhùng	Kategori:Insekter
分類:Â-chû	Kategori:Asien
分類:Chṳ-li	Kategori:Chile
分類:Nàm-mî-chû	Kategori:Sydamerika
分類:Khà-sṳ̂-tì-li-â lâu Lòi-ngong	Kategori:Kastilien och Leon
模板:Esoteric	Mall:Komplicerad kod
分類:Mâ-lòi-sî-â	Kategori:Malaysia
分類:Sṳ̍t-phín	Kategori:Mat
模板:Mod	Mall:Mod
模板:SIL	Mall:Språk/kodlista
模板:User es-2	Mall:Användare es-2
模板:Fôn-ngiàng	Mall:Nybörjare
分類:Thiàu-mi-liau	Kategori:Smaktillsatser
分類:Chû-chṳt	Kategori:Organisationer
分類:Ngî-ngièn-ho̍k	Kategori:Lingvistik
模板:ITA	Mall:ITA
模板:非洲行政區劃	Mall:Afrika
模板:SVK	Mall:SVK
模板:Infobox Country	Mall:Landsfakta
模板:TUR	Mall:TUR
分類:User en-4	Kategori:Användare en-4
分類:User en	Kategori:Användare en
分類:User zh	Kategori:Användare zh
分類:User zh-N	Kategori:Användare zh-N
分類:User en-2	Kategori:Användare en-2
模板:User zh	Mall:Användare zh
模板:Cite web	Mall:Webbref
分類:Hòng-khûng	Kategori:Flyg
模板:Country data	Mall:Landsdata
分類:Yím-sṳ̍t	Kategori:Mat och dryck
模板:BS3	Mall:BS3
分類:Tsúng-thúng	Kategori:Presidenter
模板:IPA	Mall:IPA
分類:Chṳn-chṳ Ngìn-lui	Kategori:Politiker
分類:Mî-chû	Kategori:Amerika
模板:其他	Mall:Olika betydelser
分類:Language user templates	Kategori:Babelmallar
Wikipedia:GNU自由文檔協議證書	Wikipedia:Texten till GNU Free Documentation License
模板:大洋洲行政區劃	Mall:Oceanien
分類:Vùn-ho̍k-kâ	Kategori:Författare
分類:Kiûn-sṳ	Kategori:Militärväsen
模板:Country data Malaysia	Mall:Landsdata Malaysia
模板:Lang-he	Mall:Lang-he
模板:Both	Mall:Both
分類:Sṳ-kie Pok-lám-fi	Kategori:Världsutställningar
模板:Documentation subpage	Mall:Dokumentationssida
模板:FIN	Mall:FIN
模板:Purge	Mall:Rensa
模板:Lang-de	Mall:Lang-de
模板:Provinces of China	Mall:Kina
模板:Userpage	Mall:Wikipediaanvändare
模板:SWE	Mall:SWE
分類:Ye̍t-nàm kî-chhòng	Kategori:Flygplatser i Vietnam
Kiet-tshòng	Colon (anatomi)
分類:Kûng-sṳ̂	Kategori:Företag
Â-mí	Attometer
模板:User fr-3	Mall:Användare fr-3
模板:JPN	Mall:JPN
分類:Thien-nó	Kategori:Datorer
模板:MKD	Mall:MKD
模板:LTU	Mall:LTU
Mô-li-ngìn	Maorier
模板:Disambig	Mall:Förgrening
模板:Tick	Mall:J
分類:Hàng-thung Thien-fa	Kategori:Mobiltelefoner
模板:Lang-grc	Mall:Lang-grc
模板:CZE	Mall:CZE
模板:Lifetime	Mall:FD
分類:Chhòn-ngiam-phiang	Kategori:Infektionssjukdomar
分類:Sîn-kau	Kategori:Protestantism
模板:GBR	Mall:GBR
分類:Sâng-vu̍t	Kategori:Organismer
模板:SVN	Mall:SLO
模板:FRA	Mall:FRA
模板:Hiông-kóng Hàng-tsṳn Khî-va̍k	Mall:Hongkong
模板:User pt-2	Mall:Användare pt-2
分類:Kâ-li-sî-â	Kategori:Galicien
模板:歐洲行政區劃	Mall:Europa
分類:User yue	Kategori:Användare zh-yue
分類:User fr	Kategori:Användare fr
分類:User ja	Kategori:Användare ja
分類:User pt	Kategori:Användare pt
分類:User nl-3	Kategori:Användare nl-3
分類:User fr-2	Kategori:Användare fr-2
分類:User ja-2	Kategori:Användare ja-2
分類:User ko-N	Kategori:Användare ko-N
分類:User fr-N	Kategori:Användare fr-N
分類:Vùn-sṳ	Kategori:Skrift
分類:Tho-kau	Kategori:Taoism
分類:User ca	Kategori:Användare ca
分類:User ca-1	Kategori:Användare ca-1
分類:User de	Kategori:Användare de
分類:User de-2	Kategori:Användare de-2
分類:User de-N	Kategori:Användare de-N
分類:User en-3	Kategori:Användare en-3
分類:User en-N	Kategori:Användare en-N
分類:User es	Kategori:Användare es
分類:User es-2	Kategori:Användare es-2
分類:User es-N	Kategori:Användare es-N
分類:Hiông-kóng Thi-lî	Kategori:Hongkongs geografi
模板:Lang-lv	Mall:Lang-lv
分類:Kí-hò-ho̍k	Kategori:Geometri
模板:Ye̍t-nàm	Mall:Vietnams provinser
分類:User ja-1	Kategori:Användare ja-1
分類:User ko	Kategori:Användare ko
Hà-mà	Paddor
模板:Lang-vi	Mall:Lang-vi
分類:Thiên-hi	Kategori:Väder
分類:Lièn-ha̍p-koet Pi-sû-chóng	Kategori:Förenta nationernas generalsekreterare
分類:Hói-yòng	Kategori:Hav
模板:LUX	Mall:LUX
分類:Thai-yòng-ne	Kategori:Solsystemet
分類:Kóng-tûng-sén	Kategori:Guangdong
分類:Fuk-kian	Kategori:Fujian
分類:Kîn-chi	Kategori:Ekonomi
分類:Koet-chi Chû-chṳt	Kategori:Internationella organisationer
分類:Fat-mìn-kâ	Kategori:Uppfinnare
分類:Yím-liau	Kategori:Drycker
分類:Sa-fi Khô-ho̍k	Kategori:Samhällsvetenskap
分類:Mî-koet Koet-kâ Kûng-yèn	Kategori:Nationalparker i USA
分類:Kô-tén Kau-yuk	Kategori:Högre utbildning
分類:Thi-hìn	Kategori:Landformer
分類:Pâ-lùn-sî-â Chhṳ-chhṳ-khî	Kategori:Valencia (autonom region)
模板:User ja-2	Mall:Användare ja-2
分類:Thiên-chú-kau	Kategori:Katolicism
分類:Yîm-ngo̍k-kâ	Kategori:Musiker
模板:!((	Mall:!((
模板:))!	Mall:))!
模板:Lang	Mall:Lang
分類:Fa-kâ	Kategori:Målare
分類:Yin-thu chûng-kau	Kategori:Religion i Indien
分類:Ho̍k-su̍t	Kategori:Academica
分類:Sa-fi chṳ-thu	Kategori:Sociala institutioner
分類:Ngìn-lui	Kategori:Människor
模板:CYP	Mall:CYP
分類:Yin-thu Thi-lî	Kategori:Indiens geografi
分類:Sông-ngia̍p	Kategori:Handel
模板:EST	Mall:EST
模板:AUT	Mall:AUT
分類:Meu-khô	Kategori:Kattdjur
分類:Thòi-vân Thi-lî	Kategori:Taiwans geografi
分類:Nì-pok Thi-lî	Kategori:Nepals geografi
分類:Thai-khûng-ngìn	Kategori:Astronauter
分類:Khî-ngia̍p-kâ	Kategori:Personer inom näringslivet
分類:Fî-li̍t-pîn	Kategori:Filippinerna
分類:User nl	Kategori:Användare nl
分類:User zh-1	Kategori:Användare zh-1
分類:User zh-4	Kategori:Användare zh-4
分類:User zh-3	Kategori:Användare zh-3
分類:User zh-2	Kategori:Användare zh-2
分類:Ho̍k-vi	Kategori:Akademiska titlar
分類:Pô-sṳ̂ koet-vòng	Kategori:Persiska rikets monarker
分類:Kîm-yùng	Kategori:Finansväsen
分類:Thien-sṳ	Kategori:Television
分類:Chhòn-kau-sṳ	Kategori:Missionärer
分類:Hói-hia̍p	Kategori:Sund
分類:Yin-Êu Ngî-ne	Kategori:Indoeuropeiska språk
分類:Kî-chhòng	Kategori:Flygplatser
分類:Fa-ho̍k ngièn-su	Kategori:Grundämnen
分類:Khô-ho̍k-kâ	Kategori:Forskare
分類:Pâ-kî-sṳ̂-thán Thi-lî	Kategori:Pakistans geografi
分類:Kî-tuk-kau lî-ngì	Kategori:Liturgi
分類:Nì-pok	Kategori:Nepal
分類:Thòi-vân	Kategori:Taiwan
分類:Chûng-koet chhèu-thoi	Kategori:Kinesiska kungahus
分類:Pet-mî-chû koet-kâ	Kategori:Nordamerikas länder
分類:Sṳ-tshòi	Kategori:Grönsaker
分類:Súi-kó	Kategori:Frukter
分類:Khiu-yok Sṳn-kîn	Kategori:Gamla Testamentet
分類:Pok-vu̍t-kón	Kategori:Museer
分類:Hì-hèu	Kategori:Klimat
分類:Â-chû Thi-lî	Kategori:Asiens geografi
分類:Ngìn-lui-ho̍k	Kategori:Antropologi
分類:Thai-khûng Chhàm	Kategori:Rymdstationer
模板:ESP	Mall:ESP
分類:Thung-vu̍t	Kategori:Djur
分類:Chit-chhûi Thung-vu̍t	Kategori:Ryggradsdjur
分類:Ngî-yîm-ho̍k	Kategori:Fonetik
分類:Hòng-khûng Kûng-sṳ̂	Kategori:Flygbolag
分類:Ngìn-khièn	Kategori:Mänskliga rättigheter
分類:Ngo̍k-hi	Kategori:Musikinstrument
分類:Pó-sa̍k	Kategori:Ädelstenar
分類:Koet-kâ Kûng-yèn	Kategori:Nationalparker
分類:Hi-siong-ho̍k	Kategori:Meteorologi
分類:Chûng-mî-chû	Kategori:Centralamerika
分類:Hiông-kóng	Kategori:Hongkong
分類:Kóng-sî-sén	Kategori:Guangxi
分類:Yên-liau	Kategori:Bränslen
分類:Sông-hói	Kategori:Shanghai
分類:Sin-sit kî-su̍t	Kategori:IT
分類:Ngiuk-lui	Kategori:Kött
分類:Yo̍k-ho̍k	Kategori:Farmaci
分類:Sú-tû	Kategori:Huvudstäder
分類:Kham-thap-pu-lî-â	Kategori:Kantabrien
分類:Â-sṳ̂-thù-lî-â-sṳ̂-sén	Kategori:Asturien
分類:Thòi-pet-sṳ	Kategori:Taipei
分類:Lò-màn Ngî-chhu̍k	Kategori:Romanska språk
分類:Kâu-thûng	Kategori:Transport
分類:Ngiên-kiu	Kategori:Forskning
分類:Thông-lui	Kategori:Sackarider
分類:Fòng-ti	Kategori:Kejsare
分類:Nàm-tó ngî-hì	Kategori:Austronesiska språk
分類:Pet-mî-chû	Kategori:Nordamerika
分類:Kô-sú	Kategori:Sångare
分類:Si-chhòng	Kategori:Tibet
分類:Sú-ho̍k-kâ	Kategori:Matematiker
分類:Vu̍t-lî ho̍k-kâ	Kategori:Fysiker
分類:Kîn-chi ho̍k-kâ	Kategori:Nationalekonomer
分類:Mìn-tsú	Kategori:Demokrati
分類:Kî-tuk-kau Li̍t-sṳ́	Kategori:Kristendomens historia
分類:Àu-mûn	Kategori:Macao
分類:Hiông-kóng pan-tó	Kategori:Hongkongs öar
分類:Thòi-vân ngî-ngièn	Kategori:Språk i Taiwan
分類:Khiù-lui Yun-thung	Kategori:Bollsport
分類:Ngiùn-hòng	Kategori:Banker
Fu̍k-vu	Tjänst
分類:Kâ-thai-lò-nì-â	Kategori:Katalonien
Kap-kut-vùn	Orakelbensskrift
分類:Khien-không	Kategori:Hälsa
分類:User zh-classical-2	Kategori:Användare zh-classical-2
模板:Lang-pl	Mall:Lang-pl
Trojany	Trojany
分類:Â-chû koet-kâ	Kategori:Asiens länder
模板:Chûng-fà Mìn-chhu̍k	Mall:Kinas nationaliteter
模板:MLT	Mall:MLT
分類:Kûng-yèn	Kategori:Parker
分類:Si-chhòng Thi-lî	Kategori:Tibets geografi
分類:Nui-mùng-kú Tshṳ-tshṳ-khî	Kategori:Inre Mongoliet
分類:Lâ-tên Mî-chû	Kategori:Latinamerika
分類:Chúng-chhu̍k	Kategori:Människoraser
分類:Mîn-ngî	Kategori:Min
分類:Hiông-kóng Sân-Fûng	Kategori:Berg i Hongkong
分類:Siak-khiet-kau	Kategori:Sikhism
分類:Sa-fi Mìn-tsú Tsú-ngi	Kategori:Socialdemokrati
模板:BEL	Mall:BEL
分類:Kú-thoi chhu̍k-khiùn	Kategori:Antikens folkslag
分類:Chûng-kau-ho̍k	Kategori:Religionsvetenskap
分類:Thòi-vàn Ngièn-chhu-mìn	Kategori:Taiwans ursprungsbefolkning
分類:Thien-fa	Kategori:Telefoni
模板:TPE	Mall:TPE
分類:Ngân-set	Kategori:Färg
分類:Â-là-kung	Kategori:Aragonien
分類:User cdo	Kategori:Användare cdo
分類:User zh-min-dong-N	Kategori:Användare cdo-N
分類:Tseu-mìn	Kategori:Belysning
甲型流感病毒H7N9亞型	Influensa A virus subtyp H7N9
模板:HUN	Mall:HUN
分類:User en-1	Kategori:Användare en-1
分類:User de-1	Kategori:Användare de-1
Li̍t-thoi-chṳ-song	Första Krönikeboken
Liû-khiû Khiùn-tó	Ryukyuöarna
模板:User ru-3	Mall:Användare ru-3
模板:User nl-3	Mall:Användare nl-3
Yòng-ya̍p-é	Dagfjärilar
Ngiên-kiu-só	Avancerad nivå
模板:Style/IPA	Mall:Style/IPA
模板:Style/yid	Mall:Style/yid
模板:Ping	Mall:Ping
IPhone 5S	Iphone 5S
IPhone 5C	Iphone 5C
特殊:最近更改	Special:Senaste ändringar
模組:HtmlBuilder	Modul:HtmlBuilder
模組:Navbox	Modul:Navbox
馬來西亞航空17號班機空難	Malaysia Airlines Flight 17
