អាហ្វ្រិក	Afrika
ជប៉ុន	Japan
អង់គ្លេស	England
ស្កុតឡែន	Skottland
វ៉ែល	Wales
អៀរឡង់ខាងជើង	Nordirland
សាធារណរដ្ឋអៀរឡង់	Irland
ប្រទេសហុងគ្រី	Ungern
អេស្ប៉ាញ	Spanien
សហរដ្ឋអាមេរិក	USA
ផែនដី	Jorden
ប៊ឺណឺស លី	Tim Berners-Lee
ស៊ុយអែត	Sverige
ប្រទេសប៉ូឡូញ	Polen
អ៊ីតាលី	Italien
ព័រទុយហ្គាល់	Portugal
អឺរ៉ុប	Europa
អាស៊ី	Asien
វិគីភីឌា	Wikipedia
ភីអេចភី	PHP
ទីក្រុងញូវយ៉ក	New York
កុំព្យូទ័រ	Dator
អ៊ីនធើណេត	Internet
បារ៉ាក់ អូបាម៉ា	Barack Obama
ប៉ារីស	Paris
អាប្រាហាម លីនខូន	Abraham Lincoln
ប្រព័ន្ធប្រតិបត្តការ Android	Android (operativsystem)
Google ស្វែងរក	Google
ម៉ិកស៊ិក	Mexiko
មហាសមុទ្រអាត្លង់ទិក	Atlanten
មហាសមុទ្រប៉ាស៊ីហ្វិក	Stilla havet
ថ្ងៃច័ន្ទ	Måndag
ខែមករា	Januari
ខែកុម្ភៈ	Februari
ខែមីនា	Mars (månad)
ភពអង្គារ	Mars (planet)
ខែមេសា	April
ខែឧសភា	Maj
ខែមិថុនា	Juni
ខែកក្កដា	Juli
ខែសីហា	Augusti
ខែកញ្ញា	September
ខែតុលា	Oktober
ខែវិច្ឆិកា	November
ខែធ្នូ	December
អង្គារ	Tisdag
ថ្ងៃពុធ	Onsdag
ថ្ងៃព្រហស្បតិ៍	Torsdag
ថ្ងៃសុក្រ	Fredag
ថ្ងៃសៅរ៍	Lördag
ថ្ងៃអាទិត្យ	Söndag
សេះ (​អុក​)	Springare
បារាំង	Frankrike
សត្វឆ្កែ	Hund
រាជាណាចក្ររួម	Storbritannien
ឆ្មា	Katt
ភាសាបារាំង	Franska
ប្រេស៊ីល	Brasilien
រុស្ស៊ី	Ryssland
ការ៉េ	Kvadrat
សមុទ្រ	Hav
អាល្លឺម៉ង់	Tyskland
ភាសាអាល្លឺម៉ង់	Tyska
ប្រទេសអាយឡែន	Island
ភពសៅរ៍	Saturnus
១ (លេខ)	1 (tal)
២ (លេខ)	2 (tal)
៣ (លេខ)	3 (tal)
៥	5 (tal)
ចតុកោណកែង	Rektangel
មុំកែង	Rät vinkel
អ៊ុយក្រែន	Ukraina
ទីក្រុងរ៉ូម	Rom
អាល់បានី	Albanien
អាស៊ែបៃហ្សង់	Azerbajdzjan
អង់ដូរ៉ា	Andorra
សាធារណរដ្ឋកាហ្សាក់ស្ថាន	Kazakstan
បុរីវ៉ាទីកង់	Vatikanstaten
គុយបា	Kuba
ឥណ្ឌូនេស៊ី	Indonesien
អាហ្វ្រិកខាងត្បូង	Sydafrika
ប្រវត្តិសង្ខេប ក្រុមតន្រ្តី រ៉ុក linkin park	Linkin Park
ប្រទេសអាល់ហ្សេរី	Algeriet
ស្រា	Vin
ទឹក	Vatten
ទូរទស្សន៏	Television
ភាសាអាយឡែន	Isländska
ឈីលី	Chile
ព្រះយេស៊ូវ គ្រីស្ទ	Jesus
ភពពុធ	Merkurius
ប្រវត្តិសាស្ត្រ	Historia
ភពសុក្រ	Venus
ភាសា	Språk
ភពព្រហស្បតិ៍	Jupiter
ភពអ៊ុយរ៉ានុស	Uranus
វិគីភីឌាភាសាអង់គ្លេស	Engelskspråkiga Wikipedia
ភពណិបទូន	Neptunus
សិង្ហបុរី	Singapore
ភ្លុយតុង	Pluto
ហ្វេសប៊ុក	Facebook
សង្គ្រាមលោកលើកទីមួយ	Första världskriget
សង្គ្រាមលោកលើកទី២	Andra världskriget
ទំព័រគំរូ:Corruption	Korruption
Ubuntu	Ubuntu
លីនុច	Linux
គណិតវិទ្យា	Matematik
បារ៉ែន	Bahrain
ព្រះចន្ទ	Månen
អូស្ត្រាលី	Australien
រូបវិទ្យា	Fysik
ជីវវិទ្យា	Biologi
កូរ៉េខាងជើង	Nordkorea
ព្រះរាជាណាចក្រកម្ពុជា	Kambodja
ឌីណូស័រ	Dinosaurier
សាសនាឥស្លាម	Islam
សេរីភាព	Fred
សហភាពអឺរ៉ុប	Europeiska unionen
ចេក	Banan
ណាប៉ូលេអុងបូណាប៉ារត៍	Napoleon I
ព្រះអាទិត្យ	Solen
ឆ្នាំពន្លឺ	Ljusår
អូសេអានី	Oceanien
ប្រព័ន្ធព្រះអាទិត្យ	Solsystemet
អុីដ្រូសែន	Väte
ទីម័រខាងកើត	Östtimor
ម៉ុង ប្លុង	Mont Blanc
សឺរេស	Ceres (dvärgplanet)
អៀរីស	Eris (dvärgplanet)
ភព	Planet
តន្ត្រី	Musik
ភាសាអ៊ីតាលី	Italienska
អាលុយមីញ៉ូម	Aluminium
នូវែលសេឡង់	Nya Zeeland
ឥណ្ឌា	Indien
អង់ដ្រេ ម៉ារី អំពែរ	André-Marie Ampère
វីលីម ហ្សេកស្ពែរ	William Shakespeare
ប៉ាឡាវ	Palau
ម៉ុងហ្គោលី	Mongoliet
ជេនហ្គិស ខាន់	Djingis khan
កូឡុំប៊ី	Colombia
ព្រះពុទ្ធសាសនា	Buddhism
ហ្គាតេម៉ាឡា	Guatemala
មហាសមុទ្រអាកទិក	Norra ishavet
អ៊ីរ៉ង់	Iran
ភាសាប៉ូឡូញ	Polska
ហ្សកដង់	Jordanien
កៀហ៊្សីស៊ីស្ថាន	Kirgizistan
គុយវ៉ែត	Kuwait
ឡាវ	Laos
លីបង់	Libanon
ទ្វីបអាមេរិក	Amerika
ម៉ាឡេស៊ី	Malaysia
មីយ៉ាន់ម៉ា	Burma
នេប៉ាល់	Nepal
ប៉ាគីស្ថាន	Pakistan
MySQL	MySQL
អារ៉ាប៊ីសាអូឌីត	Saudiarabien
ស្រីលង្កា	Sri Lanka
ផ្លាតូ	Platon
តាជីគីស្ថាន	Tadzjikistan
YouTube	Youtube
អារីស្តូត	Aristoteles
ថៃ	Thailand
វិទ្យុ	Radio
តួរមិនីស្ថាន	Turkmenistan
វៀតណាម	Vietnam
កូរ៉េខាងត្បូង	Sydkorea
សាធារណរដ្ឋឥស្លាមអាហ្វហ្កានីស្ថាន	Afghanistan
ព្រែកជីកស៊ុយអែស	Suezkanalen
បង់ក្លាដែស្ស	Bangladesh
សូក្រាត	Sokrates
ធ្វិតថឺរ	Twitter
ប៊្រុយណេ	Brunei
ហ្វីលីពីន	Filippinerna
អ៊ីសាក់ ញូតុន	Isaac Newton
OpenStreetMap	Open Street Map
អាល់បឺត អែងស្តែង	Albert Einstein
ប្រទេសហ្សំប៊ី	Zambia
ប៉េកាំង	Peking
មហាត្មះគន្ធី	Mahatma Gandhi
ឆាលែស ដាវីន	Charles Darwin
ជូលីស៍ សេសារ	Julius Caesar
ឥន្ទធនូ	Regnbåge
អង្គការសហប្រជាជាតិ	Förenta nationerna
ភូមិវិទ្យា	Geografi
ទីក្រុងប្រាក	Prag
បន្ទុកអគ្គីសនី	Elektrisk laddning
ខេត្តជើងភ្នំ (ប្រទេសអ៊ីតាលី)	Piemonte
មហាសមុទ្រឥណ្ឌា	Indiska oceanen
អូសាម៉ា ប៊ីន ឡាឌែន	Usama bin Ladin
ភាសាអេស្ប៉ាញ	Spanska
ភីឡាដេលផ្យា	Philadelphia
ញូវយ៉ក	New York (delstat)
វ្លាឌីមៀរ អ៊ីលីច លេនីន	Vladimir Lenin
អូហ្គុសទុស	Augustus
លោកកៃយុសសេសារ	Caligula
ត្រាហ្សាន	Trajanus
Kde	KDE
កូរ៉ាស៊ូន អាគីណូ	Corazon Aquino
ទីក្រុងតូខ្យូ	Tokyo prefektur
ហ្វឺឌីណាន់ដ៏ ម៉ាហ្សេឡង់	Ferdinand Magellan
ស៊ីសេរ៉ូ	Cicero
ភ្នំពេញ	Phnom Penh
ទីក្រុងព្រៃនគរ	Ho Chi Minh-staden
ទីក្រុងហានូយ	Hanoi
គ្រិស្តសាសនា	The True Jesus Church
ភាសាអង់គ្លេស	Engelska
គូឡាឡាំពួ	Kuala Lumpur
២០០១	2001
JavaScript	Javascript
HTML5	HTML5
ល្បឿនពន្លឺ	Ljusets hastighet
JPEG	JPEG
អេឡិចត្រុង	Elektron
ចក្រភព រ៉ូម	Romerska kejsardömet
Microsoft	Microsoft
គីមីវិទ្យា	Kemi
ស៊ីទ្រុងជ្រូក	C-sharp
បេណេឌីកទី១៦	Benedictus XVI
៧ កក្កដា	7 juli
បាល់ទាត់	Fotboll
ទីក្រុងបូកូតា	Bogotá
ថ្ងៃទី៣១ខែធ្នូ	31 december
រិសថា	4 Vesta
ស៊ីដនីយ៏	Sydney
ភ្លើង	Eld
ខ្យល់	Jordens atmosfär
កោះស៊ូម៉ាត្រា	Sumatra
ចាការតា	Jakarta
ចំណាត់ថ្នាក់ក្រុម:Wikipedia templates	Kategori:Mallar
កោះជ្វា	Java
ចំណាត់ថ្នាក់ក្រុម:ចំណាត់ថ្នាក់ក្រុមនៃទំព័រគំរូវិគីភីឌា	Kategori:Mallar efter ämne
កាលីម៉ាន់តាន់	Kalimantan
ខេត្តបន្ទាយមានជ័យ	Banteay Meanchey
វិគីភីឌា:ប្រអប់ខ្សាច់	Wikipedia:Sandlådan
អាកាសយានដ្ឋាន ដុង ហ៊យ	Dong Hoi flygplats
អាន់ ហ្វ្រែង	Anne Frank
ខុង ជឺ	Konfucius
ម៉ារីលីន ម៉ុនរ៉ូ	Marilyn Monroe
ចំណាត់ថ្នាក់ក្រុម:គណិតវិទ្យា	Kategori:Matematik
ទំព័រគំរូ:ទិន្នន័យប្រទេស អ៊ីរ៉ង់	Mall:Landsdata Iran
ចំណាត់ថ្នាក់ក្រុម:ប្រវត្តិសាស្ត្រខ្មែរ	Kategori:Kambodjas historia
ចំណាត់ថ្នាក់ក្រុម:ប្រវត្តិសាស្រ្តសិង្ហបុរី	Kategori:Singapores historia
សមុទ្រ មេឌីទែរ៉ានេ	Medelhavet
វីនដូអេច	Windows 8
ទំព័រគំរូ:ប្រទេសនៅទ្វីបអាស៊ី	Mall:Asien
ទន្លេហ្គារ៉ូន	Garonne
ស៊ីតថល	Seattle
ជញ្ជាំង ប៊ែរឡាំង	Berlinmuren
ស្រូវ	Ris
ទំព័រគំរូ:Lang-tr	Mall:Lang-tr
ទំព័រគំរូ:ផតថល	Mall:Portal
ទំព័រគំរូ:តំបន់នៃពិភពលោក	Mall:Världens regioner
ប៊ីល ហ្គេត	Bill Gates
ភាសាជប៉ុន	Japanska
ប្រជុំវីជ្ជា	Uppslagsverk
ឌីវីឌី	DVD
ទំព័រដើម	Portal:Huvudsida
Central processing unit	Central Processing Unit
រេស៊ីស្ទ័រ	Resistor
កីឡាអូឡាំពិក	Olympiska spelen
សមុទ្រ កាសព្យែន	Kaspiska havet
ឈី ហ្គីវ៉ារ៉ា	Che Guevara
ទីក្រុងកាបូល	Kabul
ហ្គ្រាប្រីអ៊ែល ហ្រ្គារ៉ាស្សៀ ម៉ារ៉ាហ្គេស	Gabriel García Márquez
ទស្សនវិជ្ជា	Filosofi
ចំណាត់ថ្នាក់ក្រុម:លុប	Kategori:Snabbraderingar
លិទ្ធិកុម្មុយនិស្ត	Kommunism
ហ៊ីលឡារី រូដហេម គ្លីនតុន	Hillary Clinton
Boeing 737	Boeing 737
អាហារនៅប្រទេសបារំាង និង របៀបធ្វើ	Franska köket
មណ្ឌលម៉ាញេតូ	Magnetosfären
ភាសាកាតាឡាន	Katalanska
បណ្ណាល័យ	Bibliotek
នីល ហេនរីក ដេវីដ ប៊័រ	Niels Bohr
និវេសនវិទ្យា	Ekologi
ក្លឹបបាល់ទាត់បារសេឡូណា	FC Barcelona
នយោបាយ	Politik
ធនាគារពិភពលោក	Världsbanken
ប្រជាធិបតេយ្យ	Demokrati
អង្គការសន្ធិសញ្ញាអាត្លង់ទិកខាងជើង	Nato
ម៉ារី ស្កូដូស្កា គុយរី	Marie Curie
រង្វាន់ណូបែល	Nobelpriset
មជ្ឈិមបូព៌ា	Mellanöstern
រាជវង្សហាន	Handynastin
ប្រទេស	Stat
គ្រឹស្តុបផើ កូឡំបូស (Christopher Columbus)	Christofer Columbus
ព្រែកជីកប៉ាណាម៉ា	Panamakanalen
មហាសមុទ្រខាងត្បូង	Antarktiska oceanen
ត្រីផ្សោតនៅកម្ពុជា	Delfiner
ក្មេង	Barn
លេអុនហាដ អយល័រ	Leonhard Euler
ណាប៉ូលេអុងទី៣	Napoleon III
ភាសារុស្ស៊ី	Ryska
ល្វី ដ៏អស្ចារ្យ	Ludvig XIV av Frankrike
សមាគមប្រជាជាតិអាស៊ីអាគ្នេយ៍	Association of Southeast Asian Nations
ប្រវត្តិសាស្ត្របារាំង	Frankrikes historia
តុលាការយុត្តិធម៌អន្តរជាតិ	Internationella domstolen i Haag
យូណេស្កូ	Unesco
អង្គការសុខភាពពិភពលោក	Världshälsoorganisationen
អង្គការពាណិជ្ជកម្មពិភពលោក	Världshandelsorganisationen
ភាសាចិន	Kinesiska
ធម្មជាតិ	Natur
ឈាម	Blod
រញ្ជួយផែនដី	Jordbävning
សមុទ្រឡាប់តែវ	Laptevhavet
ភ្លើងចរាចរ	Trafiksignal
ម៉ាទីន ឡូតធឺរ ឃីង	Martin Luther King
ត្រីកោណមាត្រ	Trigonometri
ធរណីមាត្រ	Geometri
វេយ្យាករណ៍	Grammatik
សេដ្ឋកិច្ច	Nationalekonomi
អក្សរក្រិច	Grekiska alfabetet
អក្សរឡាតាំង	Latinska alfabetet
រឿងមហាភារតយុទ្ធ	Mahabharata
ការិយាល័យសហព័ន្ធស៊ើបអង្កេត	Federal Bureau of Investigation
វីយោឡុង	Violin
ឃឹម	Tsymbaly
អេឡិចសាន់ដឺ ដឹ ហ្គារ៉ែត	Alexander den store
សង្គម	Samhälle (sociologi)
ការអប់រំ	Bildning
មនុស្សប្រុស	Man
វិគីភីឌាភាសាអេស៉្បាញ	Spanskspråkiga Wikipedia
សិទ្ធិមនុស្ស	Mänskliga rättigheter
ទាសភាព	Slaveri
សង្គ្រាមស៊ីវិល	Inbördeskrig
ភ្នំ	Berg
ហុងកុង	Hongkong
សង្គ្រាមត្រជាក់	Kalla kriget
សេអ៊ូល	Seoul
សង្គ្រាមវៀតណាម	Vietnamkriget
ម៉ៃឃើល ហ្វារ៉ាដេយ	Michael Faraday
អង់រីកូ ហ្វែរមី	Enrico Fermi
ភាសាអ៊ុយក្រែន	Ukrainska
HTML	HTML
ច្យូហានេស គូទេនបឺគ	Johannes Gutenberg
ភាសាដាណឺម៉ាក	Danska
ភាសាអេស្តូនី	Estniska
ហិណ្ឌូសាសនា	Hinduism
ភាសាពែក	Persiska
សាសនា	Religion
ភាសាកូរ៉េ	Koreanska
ភាសាខ្មែរ	Khmer (språk)
ហ្រ្គេតស៊ីងមួន	Sigmund Freud
ភាសាថៃ	Thai
ភាសាម៉ាឡេ	Malajiska
ភាសាឥណ្ឌូនេស៊ី	Indonesiska
ភាសាហេប្រ៊ូ	Hebreiska
ចន ឡុក	John Locke
ថ្លើម	Lever
ចិត្តវិទ្យា	Psykologi
មហាសមុទ្រ	Ocean
ពុទ្ធប្រវត្តិសង្ខេប	Buddha
ចរិយាមារយាទ	Etik
សារជីវកម្មផ្សព្វផ្សាយព័ត៌មានរបស់ចក្រភពអង់គ្លេស(BBC)	BBC
ក្លិបបាល់ទាត់ឆេលស៊ី	Chelsea FC
គ្រោងឆ្អឹងមនុស្ស	Människans skelett
ក (អវយវៈ)	Hals
រាជវង្សថាង	Tangdynastin
John F. Kennedy	John F. Kennedy
LibreOffice	LibreOffice
ផ្លូវរូងដីក្រោមសមុទ្រ	Kanaltunneln
តារាងខួបនៃធាតុគីមី	Periodiska systemet
ប្រូម៉ាស	Ost
ទំពាំងបាយជូរ	Druva
បន្លែ	Grönsaker
បច្ចេកវិទ្យា	Teknologi
វិស្វកម្ម	Ingenjörsvetenskap
ទំនាក់ទំនង	Kommunikation
វិជ្ជាជីវៈខាងសារព័ត៌មាន	Journalistik
កាសែត	Tidning
ទូរស័ព្ទ	Telefon
វប្បធម៌	Kultur
សំស្ក្រឹត	Sanskrit
ប្រដាប់របត់ឈាម	Hjärt- och kärlsystemet
The Guardian	The Guardian
សមីការឌីផេរ៉ង់ស្យែល	Differentialekvation
មៃក្រូសូហ្វអ៊ិសេល	Microsoft Excel
មុំ	Vinkel
សំទុះ	Acceleration
ព្រះសិវៈ	Shiva
ព្រះវិស្ណុ	Vishnu
Local Area Network	Lokalt datornät
Wide Area Network	Wide Area Network
ព្រះព្រហ្ម	Brahma
កម្លាំង	Kraft
អេឡិចត្រូម៉ាញ៉េទិច	Elektromagnetism
កសិកម្ម	Jordbruk
សំលៀកបំពាក់	Kläder
ល្បឿន	Hastighet
ក្រដាស	Papper
សុញ្ញកាស	Vakuum
ក្រលាផ្ទៃ	Area
ទ្រឹស្តីបទពីតាករ	Pythagoras sats
ចំនួនកុំផ្លិច	Komplexa tal
Cristiano Ronaldo	Cristiano Ronaldo
អ្នកថតរូប	Fotografi
ល្ខោន	Teater
គ្រឿងអេឡិចត្រូនិច	Elektronisk komponent
ព័ត៌មានវិទ្យា	Informationsteknik
អាស៊ីអាគ្នេយ៍	Sydostasien
ក្រុងសៀមរាប	Siem Reap
បញ្ជីរាយនាម ប្រទេស	Lista över självständiga stater
វិគីភីឌាភាសាព័រទុយហ្គាល់	Portugisiskspråkiga Wikipedia
ប្រដាប់រំលាយអាហារ	Matspjälkning
កីឡាចាក់សាប	Fäktsport
រោគផ្ដាសាយធម្មតា	Förkylning
រោគសរសៃប្រសាទ	Psykisk störning
ប្រតិទិន ក្រេកូរី	Gregorianska kalendern
សុខភាព	Hälsa
ជម្ងឺរលាកទងសួត	Lunginflammation
ជំងឺអេដស៍	Aids
កូដ QR	QR-kod
ជំងឺទឹកនោមផ្អែម	Diabetes
ទំព័រគំរូ:Location map Belgium	Mall:Kartposition Belgien
ទំព័រគំរូ:Location map Croatia	Mall:Kartposition Kroatien
ទំព័រគំរូ:Location map Ukraine	Mall:Kartposition Ukraina
ទំព័រគំរូ:Location map Vietnam	Mall:Kartposition Vietnam
ទំព័រគំរូ:Location map Australia	Mall:Kartposition Australien
ញូតុន	Newton (enhet)
ចក្រភព អូតូម៉ង់	Osmanska riket
ម៉ាស៊ីនចំហេះក្នុង	Förbränningsmotor
ក្បាច់គិតលេខ	Abakus
វឺតប្រែស	Wordpress
Joomla!	Joomla
ដើមដូង	Kokospalm
ភាសាណាវ៉ាថ្ល៍	Nahuatl
ភាសាម៉ាយ៉ាយូកាតិក	Yukatek
អែនជេលីណា ចូលី	Angelina Jolie
អ៊ីលដឺហ្រ្វែន	Île-de-France
ភាសាអារ៉ាប់	Arabiska
Thanksgiving	Thanksgiving
តំបន់ឃ្ជឺស្សឺ	Kyushu
តំបន់ស៊ីកុគឹ	Shikoku
នាយករដ្ឋមន្ត្រី	Premiärminister
ទង់ជាតិ	Flagga
ខ្មៅដៃ	Blyertspenna
សហភាពសូវៀត	Sovjetunionen
ចំណុចរលាយ	Smältpunkt
កាមេរ៉ា	Kamera
កម្មវិធីទូរទស្សន៍	TV-program
ខេត្តខាហ្គុស៊ីម៉ា	Kagoshima prefektur
ភាសាស៊ី	C (programspråk)
ម៉ង់តេរីយើ	Charles-Louis de Secondat Montesquieu
វិគីភីឌា:អត្ថបទពិសេស	Wikipedia:Utmärkta artiklar
ទំព័រគំរូ:Link FA	Mall:Link FA
ពិភពលោក	Världen
ឈូក	Indisk lotus
ឡងប៊ិច (កាលីផ្វនញ៉ា)	Long Beach
រង្វង់	Cirkel
ប្លង់	Plan (geometri)
ទៀបកោះម៉ាឡេ	Malackahalvön
អេប៉ុងហ្ស៍ (ពពុះទឹក)	Svampdjur
មធ្យមនព្វន្ធ	Aritmetiskt medelvärde
World Cup	Världsmästerskapet i fotboll
សម្ដេចប៉ាប	Påve
IATA	International Air Transport Association
បុណ្យណូអែល	Jul
ត្រីកោណ	Triangel
លោកអេលីសេ រីខ្លាស	Élisée Reclus
អ្នកប្រើប្រាស់:អេង ឡុង/សង្គមវិទ្យាមូលដ្ឋាន	Sociologi
សញ្ញាសំលេងអន្តរជាតិ	Internationella fonetiska alfabetet
តៃវ៉ាន់	Taiwan (ö)
Friedrich Schiller	Friedrich Schiller
ជំនឿបាហៃ	Bahá'í
១	1
អាប្រាហាម ម៉ាស្លូ	Abraham H. Maslow
ខ្ទឹមស	Vitlök
អ៊ូលេនបាធរ	Ulan Bator
កោះ	Ö (landområde)
ភាសាផ្លូវការ	Officiellt språk
ខ្សែអេក្វាទ័រ	Ekvator
ទិស	Väderstreck
លេខអាតូម	Atomnummer
អាល់ហ្វ្រិដ ណូបែល	Alfred Nobel
សម្ដេចប៉ាប យូហាន ទី២៣	Johannes XXIII
កិរិយាសព្ទ	Verb
ទីតានិច	RMS Titanic
សត្វឆ្អឹងកង	Ryggradsdjur
បាគូ	Härfågel
អំពែរ	Ampere
១ មុនគ.ស	1 f.Kr.
ម៉ែត្រការ៉េ	Kvadratmeter
ជំនួយ:Interlanguage links	Plankton
សហស្សវត្សរ៍ទី២	1000-talet (millennium)
ខេត្តកំពង់គោ	Long An
ទ្រឹស្តីបទទ្វេធា	Binomialsatsen
សមុទ្រជប៉ុន	Japanska havet
អាស៊ីខាងកើត	Östasien
អាមេរិក កណ្ដាល	Centralamerika
គ្រីស្ទអឌែលហ្វៀន	Kristadelfianer
បរិមាត្រ	Omkrets
ចក្រភព អូទ្រីស-ហុងគ្រី	Österrike-Ungern
បណ្ណាល័យជាតិ	Folkbibliotek
ផាយថុន	Python (programspråk)
អានន្ទ	Ananda
បាកាន	Pagan
ចិន	Kina (region)
ច្បាប់ធម្មតា	Common law
អ្នកម្តាយ តេរេសា​ (Mother Teresa)	Moder Teresa
ប្លូក	Blogg
រោគគ្រុនចាញ់	Denguefeber
ដុល្លារហុងកុង	Hongkongdollar
ខ្សែបណ្ដោយ	Meridian
ខេត្តឃ្លាំង	Soc Trang (provins)
ខេត្តទឹកខ្មៅ	Ca Mau (provins)
សមុទ្រខារ៉ា	Karahavet
កំរងកោះ	Ögrupp
តួប្រុស	Skådespelare
អំបូរភាសាយូតូអាហ្សតិក	Uto-aztekiska språk
ចាស្ទីន ពីពេ្រ	Justin Bieber
ក្រុម​ភាសា​ថៃកៈដៃ	Tai–kadaispråk
ចក្រភព រុស្ស៊ី	Kejsardömet Ryssland
មឞវជ	Mošovce
បេណាហ្សៀរ ប៊ូតូ	Benazir Bhutto
ស៊ីឌី	CD
ឧទ្ធម្ភាគចក្រ	Helikopter
គុណនាម	Adjektiv
វីតាមីន	Vitamin
វែបសាយ	Webbplats
តំបន់ហុកកៃដូ	Hokkaido
រូបមន្តសមមូលម៉ាស់-ថាមពល	E = mc²
សមុទ្រ អារ៉ាល់	Aralsjön
ហូ ជីមិញ	Ho Chi Minh
ម៉ាក ហ្សុកឃឺបឺក	Mark Zuckerberg
ប្រតិកម្មគីមី	Kemisk reaktion
ខេត្តក្រមួនស	Kien Giang
ខេត្តមាត់ជ្រូក	An Giang
ខេត្តរោងដំរី	Tay Ninh (provins)
ខេត្តព្រះត្រពាំង	Tra Vinh (provins)
Binomial nomenclature	Binomial nomenklatur
ខេត្តពលលាវ	Bac Lieu (provins)
ខេត្តផ្សារដែក	Dong Thap
វ៉ែសបែង	Västbanken
ភាសាបាលី	Pali
គេហទំព័រ	Webbsida
ចតុកោណ	Fyrhörning
ឈិន ឡុង	Jackie Chan
ទិវាកុមារអន្តរជាតិ	Internationella barndagen
Yahoo!	Yahoo!
បន្ទាត់	Rät linje
ហ្មរិឩពឡ	Mariupol
G8	G8
អង្កត់ផ្ចិត	Diameter
គ្រូបង្រៀន	Lärare
ស្នាដៃនៃបុព្វបុរសខ្មែរ	Skrivkonst
ស្ដេចប៉ាប យ៉ូហាន ប៉ូលទី១	Johannes Paulus I
ណៃពិដោ	Naypyidaw
ISO 4217	ISO 4217
ព្យែរ គុយរី	Pierre Curie
ក្រុមប្រឹក្សាសន្តិសុខ អង្គការសហប្រជាជាតិ	FN:s säkerhetsråd
ពហុកោណ	Polygon
ទិវានៃក្ដីស្រលាញ់	Alla hjärtans dag
ហ្គូហ្គល	Marknad (ekonomi)
សមុទ្រចិនខាងត្បូង	Sydkinesiska havet
និវេសនប្រព័ន្ធ	Ekosystem
សមុទ្រលឿង	Gula havet
យ៉ាំងហ្គូន	Rangoon
សូរព្យញ្ជនៈ	Konsonant
ច្បាប់ចលនារបស់ញូតុន	Newtons rörelselagar
ឈូងសមុទ្របេងហ្គាល់	Bengaliska viken
ទិវានារីអន្តរជាតិ	Internationella kvinnodagen
ភ្នំហ្វឹជី	Fuji
ប៉ុលពត	Pol Pot
Xian H-6	Xian H-6
Chengdu J-7	Chengdu Jian-7
Shenyang J-8	Shenyang Jian-8
ភ្នំភ្លើង អ៊ីស៊ាឡឺក	Eyjafjallajökull
ម៉ាក្រូសេដ្ឋកិច្ច	Makroekonomi
ដីជ្រោយហ្គាស្សា	Gazaremsan
​វិទ្យុ​ស្ទូឌីយោ 54 បណ្តាញ	Radio Studio 54 Network
អេលីប	Ellips (matematik)
វិទ្យុអាស៊ីសេរី	Radio Free Asia
សមាគមន៍សារព័ត៌មាន	Associated Press
អធិដ្ឋាន	Bön
គណៈកម្មាធិការអូឡាំពិកអន្តរជាតិ	Internationella olympiska kommittén
Skype	Skype
ចតុកោណស្មើ	Romb
ទន្លេមេគង្គ	Mekong
មេកានិច	Mekanik
វិចិត្រសាលវលញ្ឆករប្រទេស	Lista över statsvapen
ហែងរីហ ហឺត	Heinrich Hertz
អង់រី បិកកឺរ៉ែល	Henri Becquerel
ទស្សនាវដ្ដី	Tidskrift
សមីការដឺក្រេទី២	Andragradsekvation
រូពីឥណ្ឌូនេស៊ី	Rupiah
សមុទ្រអុកហុតស្គ៍	Ochotska havet
ចិត្តវិភាគ	Psykoanalys
ខ្មែរម៉ាស្ទើ	Webbansvarig
URL	Uniform Resource Locator
ក្រុមបាល់ទាត់ជម្រើសជាតិ អេស្ប៉ាញ	Spaniens herrlandslag i fotboll
Google Earth	Google Earth
ប៊ែនហាដ រីម៉ាន	Bernhard Riemann
កោន	Kon
អាតុល	Atoll
ទិន្នន័យ	Data (representation)
ខ្លែង	Drake (leksak)
ស្ថាបត្យករ	Arkitekt
មហាអំណាច អាប់ស៊ីស	Axelmakterna
វិគីភីឌា:FAQ	Wikipedia:Vanliga frågor
ចក្រភព អាល្លឺម៉ង់	Kejsardömet Tyskland
ក្រុមបាល់ទាត់ជម្រើសជាតិ អាល្លឺម៉ង់	Tysklands herrlandslag i fotboll
ហេរី ផោតធ័រ និង សិលាទេព	Harry Potter och de vises sten
អង្គការ Creative Commons	Creative Commons
ឥណ្ឌូចិន	Indokina
ប្រាសាទអង្គរវត្ត	Angkor Wat
ទ្រឹស្ដីរ៉ឺឡាទីវីតេ	Relativitetsteori
ប្រុស	Hane
Toulon	Toulon
ប៉ាស្កាល់	Pascal (måttenhet)
ទ្រឹស្ដីល្បែង	Spelteori
នីតិរដ្ឋ	Lagstyre
សមុទ្រចិនខាងកើត	Östkinesiska havet
ខ្នុរ	Jackfrukt
ប្រលេឡូក្រាម	Parallellogram
ចតុកោណព្នាយ	Parallelltrapets
ស៊ូស៊ី	Sushi
រូប៊ិក ខ្យូប	Rubiks kub
កាល	Plautus
ចង្រិត	Syrsor
ទិវាពលកម្មអន្ដរជាតិ	Första maj
ស្ទឹង	Bäck (vattendrag)
សមុទ្រអង់ដាម៉ង់	Andamansjön
ប៉ិបស៊ី	Pepsi
ក្រុមបាល់ទាត់ជម្រើសជាតិ អង់គ្លេស	Englands herrlandslag i fotboll
ក្រុមបាល់ទាត់ជម្រើសជាតិ បារាំង	Frankrikes herrlandslag i fotboll
ទំព័រគំរូ:Commonscat	Mall:Commonscat
វិគីភីឌាភាសាអាល្លឺម៉ង់	Tyskspråkiga Wikipedia
អាស៊ីខាងលិច	Främre Orienten
យេនឌ័រ	Könsidentitet
អង្គការសហភាពអន្តរជាតិដើម្បីអភិរក្សធម្មជាតិ	Internationella naturvårdsunionen
ទីក្រុងមេឌេយីណ	Medellín
ប៉ារ៉ាបូល	Parabel (kurva)
ខេត្តអ៊ីវ៉ាតិ	Iwate
ទ្វារសមុទ្រមលក្កា	Malackasundet
មហាយាន	Mahayana
ប្រព័ន្ធប្រតិបត្តការ iOS	IOS
ចំនួនបឋម	Primtal
សង្គ្រាម ប្រាំមួយ ថ្ងៃ	Sexdagarskriget
ក្រុងឡូវែល រដ្ឋម៉ាស្សាឈូស៊ែត	Lowell, Massachusetts
សមុទ្រជ្វា	Javasjön
សិប្បកម្មខ្ញុំ	Minecraft
ច្រកសមុទ្រធ្ងន់ធ្ងរ	Dire Straits
វីហ្សួលបេហ៊្សិក.ណេត	Visual Basic .NET
អនុគមន៍ដឺក្រេទី២	Andragradsfunktion
ច្បាប់អំពែរ	Ampères lag
ជំងឺអ៊ីបូឡា	Ebolafeber
ច្រកកូរ៉េ	Koreasundet
ឆកសមុទ្រកូរ៉េ	Koreabukten
កង្កែប	Stjärtlösa groddjur
ខ្សែទឹកឃឹរ៉ុស៊ីអុ	Kuroshio
ចំណាត់ថ្នាក់ក្រុម:ព្រះមហាក្សត្រ	Kategori:Monarker
ចំណាត់ថ្នាក់ក្រុម:រដ្ឋាភិបាល	Kategori:Myndigheter
ទំព័រគំរូ:Infobox legislature	Mall:Parlament
ទន្លេយ៉ាលូ	Yalu
ទំព័រគំរូ:ប្រវត្តិសាស្ត្រចិន	Mall:Kinas historia
ទំព័រគំរូ:ប្រវត្តិសាស្ត្រអាស៊ី	Mall:Historia i Asien
មីហ្គេល អ៊ីដាលហ្គោ អ៊ី កុស្ទីយ៉ា	Miguel Hidalgo
នរោត្តម សីហមុនី	Norodom Sihamoni
ហ៊ុន សែន	Hun Sen
តូក្យូស្កាយទ្រី	Tokyo Sky Tree
ភាសាប៉ាស្តូ	Pashto
កំណែទម្រង់រូបិយវត្ថុ	Penningreform
ធនាគារកណ្ដាល	Centralbank
Pidgin	Pidgin (datorprogram)
​វិលហែម វុឌ	Wilhelm Wundt
យិដា តាដូ	Gerda Taro
មនុស្សពីងពាង	Spider-Man
សារធាតុគីមី	Kemikalier
ចលនានៅក្នុងរូបវិទ្យា	Rörelse (fysik)
ជម្ងឺកញ្ជ្រឹល	Mässling
ក្រុមបាល់ទាត់ជម្រើសជាតិ អាហ្សង់ទីន	Argentinas herrlandslag i fotboll
ខ្យល់ព្រះអាទិត្យ	Solvind
បាល់ទាត់ពិភពលោក ២០១៤	Världsmästerskapet i fotboll 2014
ម៉ូបាល (អាល់ឡាបាម៉ា)	Mobile
កុំព្យូទ័រផ្រូក្រាមមីង(Computer programming)	Programmering
ខេត្តឈីបា	Chiba prefektur
អាំងតេក្រាល	Integral
ខេត្តអៃឈិ	Aichi prefektur
វិបត្តិសេដ្ឋកិច្ចឆ្នាំ ១៩៩៧	Asienkrisen
ខ្មែរ	Vuxen
សិល្បៈប្រើវោហារបង្ហូរគំនិត	Retorik
ឃីមីហ្គាយ៉ុ	Kimi ga yo
សាល អូហ្គុស្ទីន ដឺ គូឡុំ	Charles-Augustin de Coulomb
ខេត្តអាគីតា	Akita prefektur
ថ្នាក់ពាក្យ	Ordklass
ស្ថានភាពអភិរក្ស	Bevarandestatus
កាន់ជិ	Kanji
នាម	Egennamn
ប្រវត្តិសាស្ត្រចិន	Kinas historia
អវតារ	Avatar
ច្បាប់គូឡុំ	Coulombs lag
រឿង រ៉ូមេអូ និង ហ្ស៊ុយលីយេ	Romeo och Julia
សាលីណា កូមាស់	Selena Gomez
ក្រុម (តារាងខួបនៃធាតុគីមី)	Periodiska systemets grupper
ក្រុមបាល់ទាត់ជម្រើសជាតិ ប្រេស៊ីល	Brasiliens herrlandslag i fotboll
ទ្រឹស្ដីគមនាគមន៍	Kommunikationsteori
កាល ឡែមស្ដែនណឺ	Karl Landsteiner
បាល់ប៉ូឡូញ	Polandball
ឯកសារភាពយន្ត	Dokumentärfilm
អនុគមន៍ត្រីកោណមាត្រ	Trigonometrisk funktion
ហ្រាន្ដកូស ហ្វីឡុន	François Fillon
ខួប (តារាងខួបនៃធាតុគីមី)	Periodiska systemets perioder
ល្បែងទាញព្រ័ត្រ	Dragkamp
Article (grammar)	Artikel (grammatik)
មេដ្យានទ័រ	Passare
Rfid	Radio Frequency Identification
អ៊ីប៉ូតេនុស	Hypotenusa
ហិចហ្វាន់	Hedgefond
ISO 3166	ISO 3166
សញ្ញាជាតិកូរ៉េខាងជើង	Nordkoreas statsvapen
មេហ្គា	Mega
គីឡូ	Kilo
ការតាំងសមាធិ	Meditation
ប៉េតា	Peta
យ៉ុតតា	Yotta
សង់ទី	Centi
ហ្គីហ្គា	Giga
តេរ៉ា	Tera
ហ្វង់តូ	Femto
ហ្សិតតា	Zetta
ច្រកតារតារី	Tatarsundet
ហ្សិបតូ	Zepto
កាតែត	Katet
អាត់តូ	Atto
យ៉ុកតូ	Yokto
ដេស៊ី	Deci
អាំងតេក្រាលមិនកំនត់	Primitiv funktion
គណបក្សហ៊្វុនស៊ិនប៉ិច	FUNCINPEC
ខេត្តក្យូតុ	Kyoto prefektur
តំលៃដាច់ខាត	Absolutbelopp
ហេដ្ឋារចនាសម្ព័ន្ធ	Infrastruktur
សាស្ត្រាចារ្យ	Professor
តេគីឡា	Tequila
សន្ធិសញ្ញាប្រេស្ត-លីតូវស្ក	Freden i Brest-Litovsk
William Thomson, 1st Baron Kelvin	William Thomson Kelvin
អាណាខេត្តអូសាកា	Osaka prefektur
ខេត្តអិហ៊ីមិ	Ehime prefektur
វាំងននដែក	Järnridån
Kara (band)	Kara (musikgrupp)
វីលៀម ជែម	William James
ខេត្តយ៉ាម៉ាកាតា	Yamagata prefektur
ច្រកតៃវ៉ាន់	Taiwansundet
គំរោងម៉ាន់ហាត់ថាន់	Manhattanprojektet
ខេត្តយ៉ាម៉ាហ្គឹឈិ	Yamaguchi prefektur
ខេត្តខាន់ណាហ្គាវ៉ា	Kanagawa prefektur
បញ្ចកោណ	Pentagon
តំបន់ជឺហ្គុកឹ	Chugoku
ខេត្តណាហ្គាណុ	Nagano prefektur
ខេត្តសៃតាម៉ា	Saitama prefektur
ខេត្តមីអិ	Mie prefektur
ណុត	Knop (enhet)
តំបន់តុហុកកឹ	Tohoku
ខេត្តហ្គឺនម៉ា	Gunma prefektur
ជ្រូកទឹក	Dugong
ខ្សែទឹកមហាសមុទ្រ	Havsström
ខេត្តមីយ៉ាសាគី	Miyazaki prefektur
ខេត្តឃឹម៉ាម៉ុតុ	Kumamoto prefektur
មូលដ្ឋានូបនីយកម្មភាសា	Lokalisering (handelsterm)
Mikoyan MiG-29	Mikojan-Gurevitj MiG-29
សប្ដាហ៏ពិសិដ្ឋ	Stilla veckan
ឈូងសមុទ្រថៃ	Thailandviken
អ៊ីមម៉ាជីន និងផូស៊ី	Immagine & Poesia
លី ក្វាន់យូ	Lee Kuan Yew
កម្មសិទ្ធិបញ្ញា	Immaterialrätt
អាណាខេត្តណារ៉ា	Nara prefektur
បុព្វបទនៅក្នុងប្រព័ន្ធខ្នាតអន្តរជាតិ	SI-prefix
យន្តហោះប៉ូឡូញកំទេចឆ្នាំ២០១០	Flygolyckan i Smolensk
ជនភៀសខ្លួន	Flykting
ហង់រី កាវិនឌីស	Henry Cavendish
បុណ្យចូលឆ្នាំចិន	Kinesiskt nyår
ថេរវាទ	Theravada
តំបន់ខាន់តូ	Kanto
ខេត្តនីហ្គាតាក់	Niigata prefektur
ខេត្តយ៉ាម៉ាណាស៊ី	Yamanashi prefektur
ខេត្តស៊ីម៉ាណិ	Shimane prefektur
ខេត្តតុយ៉ាម៉ា	Toyama prefektur
ខេត្តអូកាយ៉ាម៉ា	Okayama prefektur
ISO 3166-2	ISO 3166-2
ខេត្តអយតាក់	Ōita prefektur
ខេត្តខូឈិ	Kochi prefektur
អង្គការអន្តរជាតិនៃនយោបាយរបស់បារាំង	Organisation internationale de la Francophonie
ភ្នំមេរ៉ាពី	Merapi
ព្រះធម៌	Dharma
តំបន់ឈឺប៊ឹ	Chubu
រោគក្អកមាន់	Kikhosta
គន្ថនិទ្ទេស	Bibliografi
កម្ពុជា នៅកីឡាអូឡាំពិករដូវក្ដៅ ២០០៨	Kambodja i olympiska sommarspelen 2008
គីមឈី	Kimchi
ខេត្តកំពង់ចាម	Kampong Cham
ខ្សែទឹកហ្គ្រីនលែនខាងកើត	Östra Grönlandsströmmen
ខ្សែទឹកប៉ាស៊ីហ្វិកខាងជើង	Norra stillahavsströmmen
ខ្សែទឹកហាំបុល	Humboldtströmmen
ខ្សែទឹកអូស្ត្រាលីខាងកើត	Östaustraliska strömmen
ជ័រទឹក	Kåda
ដុនបូស្កូ	Giovanni Bosco
ធ្នូរង្វង់	Cirkelbåge
អប្សរា	Apsaraser
ស្រុក	Distrikt
រាជវង្សចោឡា	Chola
ខ្លារខិន ២ (រថក្រោះ)	Leopard 2
មហាអំណាច កណ្ដាល	Centralmakterna
អិចសា	Exa
ហិកតូ	Hekto
ដេកា	Deka
រ៉ូបឺតកាប៉ា	Robert Capa
មីល្លី	Milli
មីក្រូ	Mikro
ពីកូ	Piko
ណាណូ	Nano
លីប៉ូល ស៊ីដាស៊ាងហ័រ	Léopold Senghor
ទន្ដគោម	Agavesläktet
ប្រវតិ្តBoney M	Boney M.
វីមេអូ	Vimeo
អំពើអនិត្យានុកូល	Våld i nära relationer
ហង់រី ការចេរ ប្រេស្សុង	Henri Cartier-Bresson
ត្រីកោណសម័ង្ស	Liksidig triangel
ម៉ាក់ណូលា	Magnoliasläktet
ចូសេហ្វ ហិនរី	Joseph Henry
មន ស	Vitt mullbär
ពិធីបញ្ជាប់ពាក្យ	Förlovning
សមុទ្រហ្វីលីពីន	Filippinska sjön
ប្រព័ន្ធកូអ័រដោណេភូមិសាស្ត្រ	Geopolitik
តេត្រាអែត	Tetraeder
ម៉ោងផែនដី	Earth Hour
នរោត្ដម សីហនុ	Norodom Sihanouk
ទន្លេរីយ៉ូហ្គ្រែនដេ	Rio Grande
សំព័រ	Jackfruktsläktet
កម្មវិធីអភិវឌ្ឍន៍សហប្រជាជាតិ	FN:s utvecklingsprogram
ម៉ាស៊ីនថត លេកា	Leica
មេគុណជីនី	Ginikoefficient
នីត្រូគ្លីសេរីន	Nitroglycerin
វណ្ណយុត្តិ	Diakritiskt tecken
ទង់ជាតិកម្ពុជា	Kambodjas flagga
ក្រុងអង្គរ	Angkor
ក្រពេញទីមុស	Bräss
ទ្រឹស្តីបទកូស៊ីនុស	Cosinussatsen
ទក្សិណ ជិនវ័ត្រ	Thaksin Shinawatra
ប្រធាន	Subjekt (satsdel)
អ៊ែង​ហ្គ្រី បឺដ	Angry Birds
អ៊ីពែបូល	Hyperbel
វិសមភាពស្វ័យគុណ	Olikhet
ប៊ិច	Penna
ចេក​	Kokbanan
XHTML	XHTML
ចម្ប៉ាក្រហម	Magnolia champaca
គ្រោះទុរ្ភិក្ស	Hungersnöd
អរិយសច្ច៤	De fyra ädla sanningarna
ស្តាទិច	Statik
ខេត្តណាហ្គាសាគី	Nagasaki prefektur
វិគីភីឌាភាសាស្វីស	Svenskspråkiga Wikipedia
ភ្លើងឆេះព្រៃ	Skogsbrand
ទ្រឹស្តីបទស៊ីនុស	Sinussatsen
ច្បាប់ហ៊ូក	Hookes lag
ក្រុមបាល់ទាត់ជម្រើសជាតិ ជប៉ុន	Japans herrlandslag i fotboll
រោគឈឺចាប់ក្នុងសន្លាក់ឆ្អឹង	Ledinflammation
ប្លុកហ្គឺ (Blogger)	Blogger
ធម្មនុញ្ញនៃអង្គការសហប្រជាជាតិ	FN-stadgan
Boeing AH-64 Apache	Boeing AH-64 Apache
រោគហើមសួត	Bronkit
អេមីល្យូ ហ្គីណូ សេហ្គ្រែ	Emilio Segrè
Sukhoi Su-27	Suchoj Su-27
ម៉ាស៊ីនត្រជាក់	Luftkonditionering
កាំ	Radie
អភិសិទ្ធិ វេជ្ជាជីវៈ	Abhisit Vejjajiva
លីមីត	Gränsvärde
អ៊ីដ្រូស្តាទិច	Hydrostatik
វិគីភីឌាភាសាជប៉ុន	Japanskspråkiga Wikipedia
គោលនយោបាយរូបិយវត្ថុ	Penningpolitik
យានដឹកជញ្ជូនសាធារណៈ	Kollektivtrafik
ការសំភាសន៏	Intervju
ពាណិជ្ជកម្មអន្តរជាតិ	Internationell handel
ចក្រភពអាណានិគមបារាំង	Franska kolonialimperiet
ពន្ធលើប្រាក់ចំណូល	Inkomstskatt
រូបចំលាក់	Staty
នាឡិកាខ្សាច់	Timglas
ពុយមីស	Pimpsten
FM	Frekvensmodulering
សង្គមស៊ីវិល	Civilsamhället
សមុទ្របូហៃ	Bohai
ការិយាល័យ	Kontor
ការបង្រៀនដែនដីបរិសុទ្ធ	E-lärande
ម៉ែត្រក្នុងមួយវិនាទី	Meter per sekund
រូបមន្តហេរុង	Herons formel
ទន្សោង	Banteng
វីតាមីន B	B-vitamin
គណៈកម្មាធិការជាតិអូឡាំពិក	Nationell olympisk kommitté
ប៉មតូក្យូ	Tokyo Tower
ទិវាទឹកអន្តរជាតិ	Internationella vattendagen
រូបមន្តអយល័រ	Eulers formel
ស៊ីយ៉ាញួរ	Cyanider
អរិយដ្ឋង្គិកមគ្គ	Den ädla åttafaldiga vägen
សហភាពឥណ្ឌូចិន	Franska Indokina
ចន្ទគតិ	Månkalender
សំទុះមុំ	Vinkelacceleration
គោលនយោបាយសារពើពន្ធ	Finanspolitik
ឡាហ្គូន	Lagun
Mathew Brady	Mathew Brady
អប់សិន (ហិរញ្ញវត្ថុ)	Option
អង្កត់ធ្នូ	Korda
អាយុសង្ឃឹម	Medellivslängd
ជំនួយ:Using colours	Wikipedia:Färger
ខុទ្ទកាល័យ	Styrelse
សីដក់	Sepak takraw
បញ្ជីរដ្ឋមានអាវុធនុយក្លេអ៊ែរ	Lista över kärnvapenmakter
ទីផ្សារអ៊ីធើណែត	Internetmarknadsföring
សៀវភៅ	Djungelboken
បារីអេឡិចត្រូនិច	Elektronisk cigarett
Eagles (ក្រុមភ្លេង)	Eagles
កំណើនសេដ្ឋកិច្ច	Ekonomisk tillväxt
អាឌាម លេមបឺត	Adam Lambert
រូបមន្តដឺម័រ	De Moivres formel
អនុគមន៍ហ្គាំម៉ា	Gammafunktionen
ច្បាប់ប៉ាស្កាល់	Pascals princip
សញ្ញាជាតិបង់ក្លាដែស្ស	Bangladeshs statsvapen
នាង​សីតា	Sita
សូរ (​ភាសាសាស្ត្រ​)	Ordton
ខ្មែរក្រហម	Röda khmererna
ម៉ូឌុល​យ៉ាំង	Elasticitetsmodul
យុន ជីមិ-ហូ	Yun Chi-ho
កែវម៉ាស៊ីនថត	Objektiv
ទីភ្នាក់ងារសារព័ត៌មាន	Nyhetsbyrå
វិគីភីឌាភាសាស្លូវ៉ាគី	Slovakiskspråkiga Wikipedia
ថេរហ្វារ៉ាដេយ	Faradays konstant
ប្រវត្តិអ៊ីនធើណេត	Internets historia
សមភាពគួរកត់សំគាល់	Binom
ខូប្រា	Kopra
អត្ថបទ(ប្រើបា្រស់ភាសា)	Kontext
ជូគ័រលាង	Zhuge Liang
បំលែងឡាប្លាស	Laplacetransform
សញ្ញាជាតិតួរគី	Turkiets statsvapen
បឹងទន្លេសាប	Tonlé Sap
Dassault Mirage 2000	Dassault Mirage 2000
ចំនួនអវិជ្ជមាន	Negativa tal
សញ្ញាជាតិវៀតណាម	Vietnams statsvapen
ខ្មែរ (ជនជាតិ)	Khmerer
សញ្ញាជាតិកូរ៉េខាងត្បូង	Sydkoreas statsvapen
សញ្ញាជាតិឡាវ	Laos statsvapen
សញ្ញាជាតិប៉ាគីស្ថាន	Pakistans statsvapen
Tigranes the Great	Tigran II
អាណាចក្រខ្មែរ	Khmerriket
ត្រីពណ៌	Trikolor
សញ្ញាជាតិប៊្រុយណេ	Bruneis statsvapen
រង្វង់ត្រីកោណមាត្រ	Enhetscirkel
ចំរៀករង្វង់	Cirkelsektor
អនុគមន៍ដឺក្រេទី៣	Tredjegradsekvation
អនុគមន៍អ៊ីពែបូលីក	Hyperbolisk funktion
ឆាវ ឆាវ	Cao Cao
Sukhoi Su-30	Suchoj Su-30
កម្មវិធីស្បៀងអាហារពិភពលោក	Världslivsmedelsprogrammet
រៀល	Riel
សមុទ្រស្ទើរបិទ	Randhav
ច្រកសិង្ហបុរី	Singaporesundet
វិគីភីឌាភាសារុស្ស៊ី	Ryskspråkiga Wikipedia
សញ្ញាជាតិអូម៉ង់	Omans statsvapen
ភាសាកម្មវិធី Lua	Lua
ភ្លេងជាតិថៃ	Phleng Chat
ព្រះរតនត្រ័យ	De tre juvelerna
អាហារនៅប្រទេសម៉ិចស៊ិក	Mexikanska köket
ច្រកឡាប៉េរូស	La Pérousesundet
ផ្សារហិរញ្ញវត្ថុ	Finansmarknad
ព្រះឆាយាល័ក្ខកម្ពុជា	Kambodjas statsvapen
ទិវាអង្គការសហប្រជាជាតិ	FN-dagen
ខ្សែទឹកអាត្លង់ទិកខាងជើង	Nordatlantiska driften
ប្រវត្តិសាស្ត្រវៀតណាម	Vietnams historia
ខ្សែទឹកខាណារី	Kanarieströmmen
LinkedIn	Linkedin
បុណ្យវិសាខបូជា	Vesak
ទីក្រុងព្រែកឫស្សី	Can Tho
ជនជាតិចាម	Champa
រីស្ស៉ាត កាពុសស៊ីនស្គី	Ryszard Kapuściński
ប្រវត្តិសាស្ត្រភូមា	Burmas historia
ស៊ាន ឃីងស្តន	Sean Kingston
កងទ័ពជើងទឹកបារាំង	Frankrikes flotta
ចំប៉ី	Frangipanisläktet
អនុគមន៍បេសែ្សល	Besselfunktion
លោក អាប់ឌូ ឌីអោហ្វ	Abdou Diouf
វិធីហ្វៃណៃថ៍អ៊េលម៉ិន	Finita elementmetoden
ខេត្តព្រះសីហនុ	Sihanoukville
មានប្រ	Anggun
ដុនបូស្កូសាឡេស៊ាន្ត	Salesianer
ខ្នាតគោលនៅក្នុងប្រព័ន្ធខ្នាតអន្តរជាតិ	SI-enhet
អង្គរធំ	Angkor Thom
១៤១	141 (tal)
ព្រះបាទសុទ្ធោទន	Suddhodhana
វិទ្យុសម្លេងសហរដ្ឋអាមេរិក	Voice of America
ជេឃ្វីរី	Jquery
គម្ពីរបញ្ចតន្ត្រ	Panchatantra
ផ្លាយ អាស់	Flygaska
T-80	T-80
សញ្ញាជាតិកាតារ	Qatars statsvapen
មីហ៊្គោ	Meego
វិភាគចិត្តវិទ្យា	Analytisk psykologi
លីវ ប៉ី	Liu Bei
សង្គ្រាមគ្រីមៀ	Krimkriget
ក្ងោកបៃតង	Grön påfågel
នាវាចរណ៏	Navigatör
Pinterest	Pinterest
ទ្រឹស្តីបទទ្វេធាអាបែល	Abels binomialsats
អៀង ធីរិទ្ធ	Ieng Thirith
ភ្នំសេមេរូ	Semeru
កោះសមុយ	Koh Samui
អាំងតេក្រាលដោយផ្នែក	Partialintegration
ផ្សោតក្បាលត្រឡោក	Irrawadidelfin
Near Field Communication	Närfältskommunikation
កប៉ាល់ ជួង	Skeppsklocka
សាលាសំណាក់	Paviljong
ខ្សែទឹកកាលីហ្វរនៀ	Californiaströmmen
១៤៨	148 (tal)
AIDC F-CK-1 Ching-kuo	AIDC F-CK-1 Ching-Kuo
ប្រមោញ	Atherurus macrourus
ខេត្តសាឡៈវ៉ាន់	Saravane (provins)
WikiHow	Wikihow
ទិន្នន័យបើកចំហ	Öppna data
ទិន ហ្វី	Stephen Chow
ចម្ប៉ាខែក	Magnolia figo
ហាំង ង៉ោ	Haing S. Ngor
ព្រះបាទសូរ្យវរ្ម័នទី២	Suryavarman II
ហ្គោស ចុកតុង	Goh Chok Tong
ហិនរី វីលសុន	Henry Wilson
ហុងដា សូអ៊ិជិរ៉ូ	Soichiro Honda
ស៊ុន ឈាន	Sun Quan
ឆាវ ភី	Cao Pi
សមុទ្រកូរ៉ូ	Korohavet
ពិម្ពិសារ	Bimbisara
ដូមីនិក សាវីយ៉ូ	Domenico Savio
ក្រុមបាល់ទាត់ជម្រើសជាតិកម្ពុជា	Kambodjas herrlandslag i fotboll
ទ្រឹស្តីបទគ្រីន	Greens sats
គោព្រៃ	Kouprey
VCD	Video CD
ថ្ងៃបាស់ស្ទីល	Frankrikes nationaldag
កម្ពុជាប្រជាធិបតេយ្យ	Demokratiska Kampuchea
សាលាក្ដីខ្មែរក្រហម	Internationella domstolen i Kambodja
ណាសសែរ អាល់ មូហាមមេដ អាល់ អាហ៍មេដ អាល់ អាបាហ៍	Nasser al-Mohammed al-Ahmed al-Sabah
ខេត្តផុងសាលី	Phongsali (provins)
ខេត្តបកែវ	Bokeo (provins)
ខេត្តចំប៉ាសក្តិ	Champasack
កិលេស	Passion
កាំង ហ្កិច អ៊ាវ	Khang Khek Ieu
ចំនុចហ្គែរហ្គោន	Inskriven cirkel
ឋានន្តរសក្ដិរាជវង្សនិងអភិជន	Adelstitlar
ក្រុមហ៊ុនអាកាសចរណ៍ជាតិ កម្ពុជាអង្គរអ៊ែរ	Cambodia Angkor Air
វិសមភាពនេស្ប៉ីត	Nesbitts olikhet
ទ្រឹស្តីបទមេអំបៅ	Fjärilssatsen
កន្ថឹក	Tupaia belangeri
ហេង សំរិន	Heng Samrin
ខៀវ សំផន	Khieu Samphan
ជេកខប រីស	Jacob Riis
នួន ជា	Nuon Chea
អៀង សារី	Ieng Sary
ជយវម៌្មទី៣	Jayavarman II
ប្រវត្តិសាស្ត្រថៃ	Thailands historia
បុណ្យសែនព្រះខែ	Månfestivalen
គុណកិរិយា	Adverb
ឌីណាមិក HTML	DHTML
នូហាក់ ភូមសៈវ៉ាន់	Nouhak Phoumsavanh
កុំផ្លិចឆ្លាស់	Komplexkonjugat
ការកើនឡើងនៃចំនួនប្រជាជននៅលើពិភពលោក	Befolkningstillväxt
ប្រវត្តិសាស្ត្រលាវ	Laos historia
បន្ទាត់សេកង់	Sekant
ពហុកោណស្មើ	Liksidig
សម្ដេចប៉ាបហ្វ្រង់សូ័រ	Franciskus (påve)
គុណវិបត្តិនៃការជក់បារី	Rökningens effekter
ខ្វែងជ័យបុរី	Sainyabuli (provins)
ខ្វែងជើងខ្វែង	Xieng Khouang
ខេត្តឧត្តមជ័យ	Udomxai (provins)
ខេត្តកោះកុង	Koh Kong (provins)
ខេត្តកណ្ដាល	Kandal
ព្រះនាងយសោធរា	Yasodhara
អនុគមន៍បែតា	Betafunktionen
ទ្រឹស្តីបទតង់សង់	Tangenssatsen
លិង្គ	Lingam
ឌិត ប្រន	Dith Pran
មធ្យមនព្វន្ធ-ធរណីមាត្រ	Aritmetisk-geometriskt medelvärde
កូម៌ៈ	Kurma
អាកាសយានដ្ឋានអន្តរជាតិតានសូនណាត្ត	Tan Son Nhat internationella flygplats
ឧបទ្វីបកូរ៉េ	Koreahalvön
វីគីប្រជុំ	Wikimania
អាស៊ីហ្គេម	Asiatiska spelen
ទង់ជាតិសិង្ហបុរី	Singapores flagga
បង្អួចឆ្នាំ 2000	Windows 2000
សមីការដឺក្រេទី១	Linjär ekvation
សញ្ញាជាតិអាហ្វហ្គានីស្ថាន	Afghanistans statsvapen
E-commerce	E-handel
Sukhoi Superjet 100	Suchoj Superjet 100
អ្នក​មាន​ជាង​គេ​លើ​ពិភពលោក	Lista över världens rikaste personer
ឆកសមុទ្របូហៃ	Bohaibukten
T-ARA	T-ara
អាណាស្រុកម៉ូបាល (អាល់ឡាបាម៉ា)	Mobile County
ម្កាក់	Spondias dulcis
បារខែម	Barcamp
ដើមត្នោត	Palmyrapalm
ខេត្តកំពង់ធំ	Kompong Thom (provins)
ខេត្តព្រះវិហារ	Preah Vihear
ខេត្ត ហួ ផាន់	Hua Phan (provins)
ខ្វែងអាចម៍ក្រពើ	Attapeu (provins)
ខេត្តខាំមួន	Khammuan (provins)
ខេត្តប៉ៃលិន	Pailin
ឆាយាលក្សសារព័ត៌មាន	Bildjournalistik
រូបមន្តប្រេឆ្នៃដឺ	Bretschneiders formel
ក្រុមបាល់ទាត់ជម្រើសជាតិ កូរ៉េខាងត្បូង	Sydkoreas herrlandslag i fotboll
ប្រមា	Kortsvansat piggsvin
អេដូអារដូ អាម៉ាល់ឌី	Edoardo Amaldi
Chengdu J-20	Chengdu Jian-20
វេយ្យាករណ៍អង់គ្លេស	Engelsk grammatik
ស៊ីឡាត	Pencak silat
អាំងតេក្រាលហ្វ្រេនែល	Fresnels integraler
គោលនយោបាយសេដ្ឋកិច្ច	Ekonomisk politik
ទិវាសេរីភាពសារព័ត៌មានពិភពលោក	Världsdagen för pressfrihet
អាំងតេក្រាលផ្ទៃ	Ytintegral
បជាបតិគោតមី	Prajapati (buddhism)
ខេត្តហ៊ីរ៉ូស៊ីម៉ា	Hiroshima prefektur
បន្ទប់រៀន	Klassrum
ជំរំជនភៀសខ្លួន	Flyktingläger
ហ្គូតហ្គោល	Google Sites
ប្រភេទស្រាទំពាំងបាយជូរពីប្រទេសបារាំង	Franska viner
បទនគររាជ	Nokoreach
នគររាជសីមា	Nakhon Ratchasima
សង្គ្រាមកម្ពុជា-វៀតណាម	Kambodjansk-vietnamesiska kriget
១៥០	150 (tal)
ទ្រឹស្តីបទពីក	Picks sats
ខេត្តសៀមរាប	Siem Reap (provins)
ខេត្តកំពង់ស្ពឺ	Kampong Spoe (provins)
ប្រាសាទបាយ័ន	Bayon
អុនសេន	Onsen
ឧត្តមស្នងការអង្គការសហប្រជាជាតិទទួលបន្ទុកសិទ្ធិមនុស្ស	Kontoret för FN:s högkommissarie för mänskliga rättigheter
ត្រីតុកកែជ្រូក	Leopardabborre
ក្រុងហាកុណិ (ខេត្តកាណាហ្គាវ៉ា)	Hakone
ប្រវត្តិសាស្ត្រខ្មែរ	Kambodjas historia
ម៉ាជូ ពីជូ	Machu Picchu
គណនីធនាគារ	Bankkonto
ខ្សែទឹកប្រេស៊ីល	Brasilianska strömmen
ត្រកៀតប៉ោង	Vattenhyacint
ចតុកោណចារឹកក្នុងរង្វង់	Cyklisk fyrhörning
១៣៨	138 (tal)
គីឡូម៉ែត្រការ៉េ	Kvadratkilometer
ចេននី រីវឺរ៉ា	Jenni Rivera
១៤៤	144 (tal)
រលួស	Erythrina variegata
១៤០	140 (tal)
១៤៣	143 (tal)
១៤៧	147 (tal)
១៤៦	146 (tal)
១៤៩	149 (tal)
១៤២	142 (tal)
១៣៩	139 (tal)
១៤៥	145 (tal)
ប្រទេសមួយ ប្រព័ន្ធពីរ	Ett land, två system
ត្រកៀត	Vattenhyacintväxter
បណ្តាញផ្លូវហាយវេអាស៊ី	Asienväg
ច្រកចូហរ	Johorsundet
ព្រះសង្ឃ	Munk
នគរលូ	Lu (stat)
ត្រីរាជ	Mekongjättemal
Yeghishe Charents	Yeghishe Charents
ភាពលំអៀង	Metodfel
CAC/PAC JF-17 Thunder	CAC/PAC JF-17 Thunder
Gloomy Sunday	Gloomy Sunday
ខេត្តហ្លួងព្រះបាង	Louang Prabang (provins)
សង្គ្រាមឥណ្ឌូចិនលើកទី១	Indokinakriget
ខេត្តស្វាយរៀង	Svay Rieng (provins)
ISO 9362	ISO 9362
ប៉ាកាយ៉ា	Pacaya
ខ្លែងប្រម៉ង់	Rödbent pygméfalk
ខេត្តអូគីណាវ៉ា	Okinawa prefektur
គណបក្សប្រជាជនកម្ពុជា	Kambodjanska folkpartiet
អាស៊ីខាងត្បូង	Sydasien
កណ្ដុរភ្នំ	Egentliga bamburåttor
ឃុំបន្ទាយឆ្មារ	Banteay Chhmar
តំបន់ត្រីកោណមាស	Gyllene triangeln, Asien
សង្គ្រាមផ្ទៃក្នុងកម្ពុជា	Kambodjanska inbördeskriget
ESET	ESET
អាស៊ីហ្គេមរដូវរងារ	Asiatiska vinterspelen
ក្រុងយ៉ាណៃ	Yanai
KM	Kilometer
BRIC	BRIC
ជម្រើសអ្នកប្រើប្រាស់	Konsumentteori
ប្រព័ន្ធគោល	Talbas
ក្រុមប្រឹក្សាអូឡាំពិកអាស៊ី	Asiens olympiska råd
McDonnell Douglas F-15E Strike Eagle	McDonnell Douglas F-15E Strike Eagle
២៤២	242 (tal)
សារមន្ទីរទួលស្លែង	S-21 Tuol Sleng
VietJet Air	VietJet Air
សាកលវិទ្យាល័យ ចុឡាលុងករណ៍	Chulalongkornuniversitetet
អនុគមន៍ស៊ីនុសកាឌីណាល់	Sinc-funktionen
ខេត្តព្រៃវែង	Prey Veng (provins)
អនុគមន៍ពហុហ្គាំម៉ា	Polygammafunktionen
កប្ប	Kalpa (tidsenhet)
ខ្សែទឹកអេក្វាទ័រខាងជើង	Ekvatorialström
នគរវ្នំ	Funan
ខេត្តកំពង់ឆ្នាំង	Kampong Chhnang
ព្រះនាងមាយា	Mahamaya
ពោធិបក្ខិយធម៌	Bodhipakkhiyādhammā
ការ​បញ្ចាំង​ស្លាយ	Bildspel
វីគីភីឌាភាសាខ្មែរ	Lättflyktiga organiska föreningar
ចំប៉ីសៀម	Ökenrossläktet
ជំនួយ:មាតិកា	Wikipedia:Hjälp
ច្បាប់ប្រលេឡូក្រាម	Parallellogramlagen
ព្រៃវែង	Prey Veng
ធនធានដែលមិនកកើតឡើងវិញ	Icke förnybara energikällor
ខ្សែទឹកអៀមីងហ្គើរ	Irmingerströmmen
វិសមភាព ហាតឌី	Hardys olikhet
ស្វាកន្ទុយស	Pygathrix nigripes
ពិធីបុណ្យមាឃបូជា	Magha Puja
សុន សេន	Son Sen
ចំនួនតេត្រាអែក	Tetraedertal
ក្រុងកំពង់ធំ	Kampong Thum
ភ្នំដា	Ankor Borei och Phnom Da
ចំណុចរំពុះ	Kokpunkt
សាធារណរដ្ឋខ្មែរ	Khmerrepubliken
អក្សរខ្មែរ	Khmerisk skrift
ក្មេងទំនើង	Ungdomskriminalitet
ចេនឡា	Chenla
ប្រកែកនយោបាយថៃ ស.ក.២០១០	Politiska protesterna i Thailand 2010
កម្មវីធីសូនីវីហ្គាស	Sony Vegas
កងទ័ពអេហ្ស៊ីប	Egyptiska väpnade styrkor
ខ្សែទឹកណរវេយ	Norska strömmen
វិសមភាពញូតុន	Newtons olikheter
តំបន់អឌ្ឍច័ន្ទមាស	Gyllene halvmånen
សហរដ្ឋ	Union (statsvetenskap)
ផលបូក រីម៉ាន	Riemannsumma
វិគីភីឌា:ស្ថានទូតខ្មែរ	Wikipedia:Ambassaden
ប្រៃសណីយ៍ភ័ណ្ឌ	Paket (postväsen)
នវវិទ្យា	Neologi
អនុគមន៍ទ្រីហ្គាំម៉ា	Trigammafunktionen
ខ្សែទឹករង្វល់របស់មហាសមុទ្រ	Havsströmsvirvelområde
វិទ្យុតាមអ៊ីនធើណែត	Digitalradio
ខ្សែទឹកហ្គ្រីនលែនខាងលិច	Västra Grönlandsströmmen
ឈូងសមុទ្រ	Bukt
មួយម៉ូនីកា	Agnes Monica
ESET NOD32 Antivirus	NOD32
វិគីភីឌា:Glossary	Wikipedia:Ordlista
ចំណាត់ថ្នាក់ក្រុម:ប្រទេសជប៉ុន	Kategori:Japan
ចំណាត់ថ្នាក់ក្រុម:ម៉ិកសិច	Kategori:Mexiko
វិធីសាស្រ្តក្នុងការទំនាក់ទំនង	Kommunikationsmodell
ចេមនិងផ្លែប៉ែសយក្ស	James och jättepersikan
ចំណាត់ថ្នាក់ក្រុម:ឥណ្ឌូនេស៊ី	Kategori:Indonesien
ចំណាត់ថ្នាក់ក្រុម:សិង្ហបុរី	Kategori:Singapore
ចំណាត់ថ្នាក់ក្រុម:រូបវិទ្យា	Kategori:Fysik
ចំណាត់ថ្នាក់ក្រុម:វិទ្យាសាស្រ្តធម្មជាតិ	Kategori:Naturvetenskap
ចំណាត់ថ្នាក់ក្រុម:ជីវវិទ្យា	Kategori:Biologi
ចំណាត់ថ្នាក់ក្រុម:សាសនា	Kategori:Religion
ចំណាត់ថ្នាក់ក្រុម:កីឡា	Kategori:Sport
ចំណាត់ថ្នាក់ក្រុម:វិទ្យាសាស្ត្រ	Kategori:Vetenskap
ប្រជាមតិទាក់ទងនឹងឯករាជភាពរបស់ស្កុតឡែនឆ្នំា២០១៤	Folkomröstningen om skotsk självständighet 2014
សាសនាក្នុងប្រទេសចិន	Kinesisk religion
ត្រីគល់រាំង	Siamesisk jättekarp
ប្រវត្តិច្បាប់រក្សាសិទ្ធ	Upphovsrättens historia
ទ្រឹស្ដីនៃពណ៌	Färglära
ស្ករត្នោត	Palmsocker
ទំព័រគំរូ:Dts	Mall:Dts
ទីក្រុងរ៉ូមបុរាណ	Romerska riket
ទំព័រគំរូ:Box-footer	Mall:Box-footer
កន្ថឹកក្បាលឆ្នូត	Nordlig slätsvansspetsekorre
រឹសគូប	Kubikrot
វត្តភ្នំ	Wat Phnom
អាគីតា	Akita (olika betydelser)
អនុគមន៍ហ្សេតាបឋម	Primtalszetafunktionen
អ្នកសារពត័មាន	Journalist
ចំណាត់ថ្នាក់ក្រុម:អូឡាំពិក	Kategori:Olympiska spelen
ចំណាត់ថ្នាក់ក្រុម:ព្រះពុទ្ធសាសនា	Kategori:Buddhism
ប្រអប់ខ្សាច់	Sandlåda
ស្ថានីយទូរទស្សន៍	TV-kanal
ជំងឺរលាកបំពង់ក	Faryngit
ទំព័រគំរូ:Lang-ta	Mall:Lang-ta
អូរកែវ	Oc Eo
ពហុធាប៊ែរនូយី	Bernoullipolynom
ខេត្តបលិខាំសៃ	Bolikhamsai (provins)
ចៅ​សែន​ កុសល​ឈុំ	Chau Sen Cocsal Chhum
ជញ្ជាំងក្រហម	Redwall - Cluny Gisslaren
ព្រះរាជាណាចក្រកម្ពុជា (១៩៥៣-១៩៧០)	Kungariket Kambodja (1953-1970)
ចំណាត់ថ្នាក់ក្រុម:អត្ថបទខ្លីមិនពេញលេញ	Kategori:Stubbar
ចំណាត់ថ្នាក់ក្រុម:ទ្វីប	Kategori:Världsdelar
ចំណាត់ថ្នាក់ក្រុម:ភូមិវិទ្យា	Kategori:Geologi
ចំណាត់ថ្នាក់ក្រុម:យន្តហោះ	Kategori:Luftfarkoster
ខេមបូឌា ដេលី	Cambodia Daily
ទំព័រគំរូ:ប្រព័ន្ធព្រះអាទិត្យ	Mall:Solsystemet
ពីរ៉ាមីត	Pyramid (geometri)
ពន្ធតែមប្រិ៍	Stämpelskatt
កន្លះបរិមាត្រ	Semiperimeter
គ្រោះមហន្តរាយ	Katastrof
អនុគមន៍គុយ-តែតតា	Q-thetafunktionen
វិគីភីឌា:Reference desk	Wikipedia:Faktafrågor
ទំព័រគំរូ:Authority control	Mall:Auktoritetsdata
ទំព័រគំរូ:Quote	Mall:Citat
ទំព័រគំរូ:Location map Scotland	Mall:Kartposition Skottland
ទំព័រគំរូ:Location map England	Mall:Kartposition England
ចំណាត់ថ្នាក់ក្រុម:សេដ្ឋកិច្ច	Kategori:Nationalekonomi
វិគីភីឌា:សុំប្តូរអត្តនាម	Wikipedia:Byte av användarnamn
វិគីភីឌា:Oversight	Wikipedia:Censorer
វិគីភីឌា:រូបយន្ត	Wikipedia:Robotar
ចំណាត់ថ្នាក់ក្រុម:Hidden categories	Kategori:Dolda kategorier
វិសមភាពភីត្រឹ	Peetres olikhet
អេហ៊្សីប	Egypten
វិគីភីឌា:វិគីគម្រោង	Wikipedia:Projekt
យីហ៊ុប	Magnolia coco
ទំព័រគំរូ:Bot	Mall:Bot
វិគីភីឌា:អ្វីៗដែលវិគីភីឌាមិនអនុញ្ញាត	Wikipedia:Vad Wikipedia inte är
កាណាដា	Kanada
វិសមភាព ស្ទេហ្វេនសេន	Steffensens olikhet
ចំណាត់ថ្នាក់ក្រុម:ប្រទេសអាយឡែន	Kategori:Island
វិគីភីឌា:អំពីវិគីភីឌា	Wikipedia:Om
ចំណាត់ថ្នាក់ក្រុម:ខ្នាតក្រលាផ្ទៃ	Kategori:Areaenheter
ទំព័រគំរូ:Flagicon	Mall:Flaggbild
ចំណាត់ថ្នាក់ក្រុម:អឺរ៉ុប	Kategori:Europa
ចំណាត់ថ្នាក់ក្រុម:ជំនួយក្នុងវិគីភីឌា	Kategori:Wikipedia:Hjälp
វិគីភីឌា:ទំព័រអ្នកប្រើប្រាស់	Wikipedia:Användarsidor
វិគីភីឌា:ព្រឹត្តិការណ៍​ថ្មីៗ	Portal:Aktuella händelser
ទំព័រគំរូ:Documentation	Mall:Dokumentation
វិគីភីឌា:អ្នកប្រើប្រាស់	Wikipedia:Typer av användare
វិគីភីឌា:Protection policy	Wikipedia:Skrivskydd
វិគីភីឌា:WikiLove	Wikipedia:Wikikärlek
វិគីភីឌា:ហត្ថលេខា	Wikipedia:Signera diskussionsinlägg
វិគីភីឌា:អត្ថបទខ្លីមិនពេញលេញ	Wikipedia:Stubbar
វិគីភីឌា:លក្ខណៈវិនិច្ឆ័យនៃលុបជាបន្ទាន់	Wikipedia:Snabbraderingar
វិគីភីឌា:Most wanted articles	Wikipedia:Önskelista
ទំព័រគំរូ:Facebook navbox	Mall:Facebook
វិគីភីឌា:Huggle	Wikipedia:Huggle
វិសមភាព អាស្គី-ហ្គាស្ពើ	Askey–Gaspers olikhet
ទំព័រគំរូ:Softredirect	Mall:Mjuk omdirigering
ទំព័រគំរូ:លុបជាបន្ទាន់	Mall:Radera
ក្លោងទ្វារ:ចិន	Portal:Kina
វិគីភីឌា:វិគីគម្រោង ជីវប្រវត្តិ	Wikipedia:Projekt biografier
ជំនួយ:ប្រអប់ព័ត៌មាន	Wikipedia:Faktamallar
ឫសទី១២នៃ២	Tolfte roten ur 2
នរោត្តម មុនីនាថ សីហនុ	Norodom Monineath
ចំណាត់ថ្នាក់ក្រុម:ភាសា	Kategori:Språk
ចំណាត់ថ្នាក់ក្រុម:វេយ្យាករណ៍	Kategori:Grammatik
ចំណាត់ថ្នាក់ក្រុម:វិគីភីឌា	Kategori:Wikipedia
វិគីភីឌា:ការបដិសេធ ទូទៅ	Wikipedia:Allmänt förbehåll
ជំនួយ:ចំណាត់ថ្នាក់ក្រុម	Wikipedia:Kategorier
វិគីភីឌា:សារទំព័រគំរូ	Wikipedia:Meddelandemall
វិគីភីឌា:អសង្ស័យកម្ម	Wikipedia:Stilguide
Portal:Contents/Portals	Portal:Portaler
ទំព័រគំរូ:Navbox	Mall:Navbox
ជំនួយ:រូបមន្ត	Wikipedia:Matematiska uttryck
ជំនួយ:តំណភ្ជាប់	Wikipedia:Wikilänkar
ទំព័រគំរូ:Citation needed	Mall:Källa behövs
តំបន់ពាណិជ្ជកម្មសេរី	Frihandelsavtal
ទំព័រគំរូ:Error	Mall:Error
ទំព័រគំរូ:!	Mall:!
ចំណាត់ថ្នាក់ក្រុម:Flag templates	Kategori:Flaggmallar
ទំព័រគំរូ:((	Mall:((
ទំព័រគំរូ:))	Mall:))
ទំព័រគំរូ:=	Mall:=
ទំព័រគំរូ:Navbar	Mall:Navbar
ទំព័រគំរូ:Loop	Mall:Loop
ទំព័រគំរូ:Void	Mall:Void
ទំព័រគំរូ:Key press	Mall:Knapp
ទំព័រគំរូ:Transclude	Mall:Transclude
ទំព័រគំរូ:Sc	Mall:Kapitäler
ទំព័រគំរូ:Small	Mall:Small
ទំព័រគំរូ:Clear	Mall:Clear
ទំព័រគំរូ:Col-break	Mall:Col-break
ទំព័រគំរូ:Col-begin	Mall:Col-begin
ទំព័រគំរូ:Col-end	Mall:Col-end
ទំព័រគំរូ:Trim	Mall:Str trim
ទំព័រគំរូ:Nowrap	Mall:Nowrap
ទំព័រគំរូ:Bots	Mall:Bots
ទំព័រគំរូ:Abbr	Mall:Tooltip
វិគីភីឌា:វិគីគម្រោង ទំព័រគំរូ	Wikipedia:Projekt mallstandardisering
ចំណាត់ថ្នាក់ក្រុម:ខ្សែកោង	Kategori:Kurvor
ទំព័រគំរូ:Babel	Mall:Babel
ទំព័រគំរូ:Commons	Mall:Commons
ទំព័រគំរូ:Link GA	Mall:Link GA
ទំព័រគំរូ:NavPeriodicTable	Mall:PeriodiskaSystemet
វិគីភីឌា:Citing sources	Wikipedia:Källhänvisningar
ទំព័រគំរូ:អត្ថបទខ្លីមិនពេញលេញ	Mall:Stub
ទំព័រគំរូ:User af-1	Mall:Användare af-1
ទំព័រគំរូ:User als-1	Mall:Användare als-1
ទំព័រគំរូ:User az	Mall:Användare az
ទំព័រគំរូ:See also	Mall:Se även
ទំព័រគំរូ:User de	Mall:Användare de
ទំព័រគំរូ:User de-1	Mall:Användare de-1
ទំព័រគំរូ:User et-1	Mall:Användare et-1
ទំព័រគំរូ:User el	Mall:Användare el
ទំព័រគំរូ:User es	Mall:Användare es
ទំព័រគំរូ:User de-3	Mall:Användare de-3
ទំព័រគំរូ:User en-3	Mall:Användare en-3
ទំព័រគំរូ:User en-1	Mall:Användare en-1
ទំព័រគំរូ:User en-2	Mall:Användare en-2
ទំព័រគំរូ:User en-4	Mall:Användare en-4
ទំព័រគំរូ:User fi	Mall:Användare fi
ទំព័រគំរូ:User en-0	Mall:Användare en-0
ទំព័រគំរូ:User en	Mall:Användare en
ទំព័រគំរូ:User de-2	Mall:Användare de-2
ទំព័រគំរូ:User es-1	Mall:Användare es-1
ទំព័រគំរូ:User fa	Mall:Användare fa
ទំព័រគំរូ:User fr-1	Mall:Användare fr-1
ទំព័រគំរូ:User id-3	Mall:Användare id-3
ទំព័រគំរូ:User it-3	Mall:Användare it-3
ទំព័រគំរូ:User tr-2	Mall:Användare tr-2
ទំព័រគំរូ:User fr-2	Mall:Användare fr-2
ទំព័រគំរូ:User tr	Mall:Användare tr
ទំព័រគំរូ:User ja	Mall:Användare ja
ទំព័រគំរូ:User ja-1	Mall:Användare ja-1
ទំព័រគំរូ:User it-1	Mall:Användare it-1
ទំព័រគំរូ:User fr	Mall:Användare fr
ទំព័រគំរូ:Location map/Info	Mall:Kartposition/Info
ចំណាត់ថ្នាក់ក្រុម:Navigational boxes	Kategori:Navigationsrutor
ទំព័រគំរូ:ទិន្នន័យ នៃប្រទេសតាជីគីស្ថាន	Mall:Landsdata Tadzjikistan
ចំណាត់ថ្នាក់ក្រុម:អាស៊ី	Kategori:Asien
ចំណាត់ថ្នាក់ក្រុម:User uk-N	Kategori:Användare uk-N
ទំព័រគំរូ:Intricate template	Mall:Komplicerad kod
ទំព័រគំរូ:Lang-ja	Mall:Lang-ja
ទំព័រគំរូ:ទិន្នន័យប្រទេស គុយវ៉ែត	Mall:Landsdata Kuwait
ទំព័រគំរូ:Mod	Mall:Mod
ទំព័រគំរូ:User it	Mall:Användare it
ទំព័រគំរូ:User uk	Mall:Användare uk
ទំព័រគំរូ:User es-2	Mall:Användare es-2
ទំព័រគំរូ:ស្វាគមន៍	Mall:Nybörjare
ទំព័រគំរូ:គម្រោងវិគីជាបងប្អូន	Mall:Wikipediasystrar
ចំណាត់ថ្នាក់ក្រុម:External link templates	Kategori:Externa länkmallar
ទំព័រគំរូ:ទិន្នន័យប្រទេស ស្លូវ៉ាគី	Mall:Landsdata Slovakien
ចំណាត់ថ្នាក់ក្រុម:ទំព័រគំរូសំរាប់កូអរដោនេ	Kategori:Koordinatmallar
ទំព័រគំរូ:Country flagnavy	Mall:Flotta/core
ទំព័រគំរូ:USA	Mall:USA
ទំព័រគំរូ:ទិន្នន័យប្រទេស អេត្យូពី	Mall:Landsdata Etiopien
ទំព័រគំរូ:ទិន្នន័យប្រទេស ឆេក	Mall:Landsdata Tjeckien
ទំព័រគំរូ:ទិន្នន័យ នៃប្រទេសថៃ	Mall:Landsdata Thailand
ទំព័រគំរូ:ទិន្នន័យប្រទេស គុយបា	Mall:Landsdata Kuba
ទំព័រគំរូ:Lang-km	Mall:Lang-km
ទំព័រគំរូ:ទិន្នន័យប្រទេស អាល់បានី	Mall:Landsdata Albanien
ទំព័រគំរូ:ទិន្នន័យ នៃប្រទេសប៉េរូ	Mall:Landsdata Peru
ទំព័រគំរូ:ទិន្នន័យ នៃប្រទេសម៉ាកាវ	Mall:Landsdata Macao
ទំព័រគំរូ:ទិន្នន័យប្រទេស សាធារណរដ្ឋចិន	Mall:Landsdata Republiken Kina
ទំព័រគំរូ:ទិន្នន័យ នៃប្រទេសអ៊ូបេគីស្ថាន	Mall:Landsdata Uzbekistan
ចំណាត់ថ្នាក់ក្រុម:User ms	Kategori:Användare ms
ទំព័រគំរូ:ទិន្នន័យ នៃប្រទេសឡាតវី	Mall:Landsdata Lettland
ទំព័រគំរូ:Football kit	Mall:Fotbollkit
ទំព័រគំរូ:ទិន្នន័យ នៃប្រទេសម៉ាល់តា	Mall:Landsdata Malta
ទំព័រគំរូ:ទិន្នន័យ នៃប្រទេសម៉ូណាកូ	Mall:Landsdata Monaco
ទំព័រគំរូ:ទិន្នន័យ នៃប្រទេសដាណឺម៉ាក	Mall:Landsdata Danmark
ទំព័រគំរូ:Wikiatlas	Mall:Wikiatlas
ទំព័រគំរូ:ទិន្នន័យ នៃប្រទេសប៉ូឡូញ	Mall:Landsdata Polen
ចំណាត់ថ្នាក់ក្រុម:User fr-1	Kategori:Användare fr-1
ទំព័រគំរូ:ទិន្នន័យ នៃប្រទេសណ័រវ៉េ	Mall:Landsdata Norge
ទំព័រគំរូ:ទិន្នន័យប្រទេស ហ្សកហ៊្សី	Mall:Landsdata Georgien
ទំព័រគំរូ:Wikiquote	Mall:Wikiquote
ទំព័រគំរូ:Country showdata	Mall:Land showdata
ទំព័រគំរូ:Image label	Mall:Image label
ទំព័រគំរូ:ទិន្នន័យប្រទេស ស្រីលង្កា	Mall:Landsdata Sri Lanka
ទំព័រគំរូ:ទិន្នន័យ នៃប្រទេសមិចសិច	Mall:Landsdata Mexiko
ទំព័រគំរូ:ទិន្នន័យប្រទេស ក្រិច	Mall:Landsdata Grekland
ទំព័រគំរូ:ទិន្នន័យ នៃប្រទេសអារ៉ាប៊ីសាអូឌីត	Mall:Landsdata Saudiarabien
ទំព័រគំរូ:ទិន្នន័យប្រទេស ក្រូអាត	Mall:Landsdata Kroatien
ទំព័រគំរូ:ប្រអប់ព័ត៌មាន អ្នកនិពន្ធ	Mall:Författare
ទំព័រគំរូ:Stub category	Mall:Kategoristub
ទំព័រគំរូ:Ja icon	Mall:Ja ikon
ទំព័រគំរូ:ទិន្នន័យ នៃប្រទេសសហភាពអារ៉ាប់អេមីរ៉េត	Mall:Landsdata Förenade Arabemiraten
ទំព័រគំរូ:Infobox television	Mall:Infobox TV-program
ទំព័រគំរូ:Geographic location	Mall:Geografiskt läge
ទំព័រគំរូ:Prose	Mall:Prosa
ទំព័រគំរូ:Infobox musical artist	Mall:Infobox musiker
ទំព័រគំរូ:ទិន្នន័យប្រទេស Serbia	Mall:Landsdata Serbien
ទំព័រគំរូ:Collapsible list	Mall:Hopfällbar lista
ទំព័រគំរូ:ទិន្នន័យ នៃប្រទេសអូស្រ្តាលី	Mall:Landsdata Australien
ទំព័រគំរូ:ទិន្នន័យ​នៃប្រទេសប៉ាឡេស្ទីន	Mall:PSE
ទំព័រគំរូ:Subatomic particle	Mall:SubatomicParticle
ទំព័រគំរូ:Sidebar	Mall:Sidebar
ទំព័រគំរូ:In use	Mall:Pågår
ទំព័រគំរូ:Es icon	Mall:Es ikon
ទំព័រគំរូ:ទិន្នន័យ នៃប្រទេសបារាំង	Mall:Landsdata Frankrike
ទំព័រគំរូ:Ambox	Mall:Ambox
ទំព័រគំរូ:Update	Mall:Inaktuell
ទំព័រគំរូ:ប្រអប់ព័ត៌មាន មន្ទីរពេទ្យ	Mall:Infobox Sjukhus
ទំព័រគំរូ:ប្រអប់ព័ត៌មាន ទស្សនាវដ្ដី	Mall:Tidskrift
ទំព័រគំរូ:Image requested	Mall:Illustrationsbehov
ទំព័រគំរូ:ប្រអប់ព័ត៌មាន ភ្លេងជាតិ	Mall:Infobox Nationalsång
ទំព័រគំរូ:Very long	Mall:Väldigt lång
ទំព័រគំរូ:ទិន្នន័យ​នៃប្រទេសគាហ្គីស្ថាន	Mall:KGZ
ទំព័រគំរូ:ប្រអប់ព័ត៌មាន សាលារៀន	Mall:Infobox skola
ទំព័រគំរូ:Rnd	Mall:Rnd
ទំព័រគំរូ:ប្រអប់ព័ត៌មាន ប្រទេស	Mall:Landsfakta
ទំព័រគំរូ:Max	Mall:Högsta
ទំព័រគំរូ:Infobox software	Mall:Datorprogram
ទំព័រគំរូ:ទិន្នន័យប្រទេស ឡាវ	Mall:Landsdata Laos
ទំព័រគំរូ:Infobox airline	Mall:Flygbolag
ទំព័រគំរូ:Wide image	Mall:Panorama
ទំព័រគំរូ:ទិន្នន័យ នៃប្រទេសអូទ្រីស	Mall:Landsdata Österrike
ទំព័រគំរូ:Collapsible option	Mall:Hopfällbart alternativ
វិគីភីឌា:សំណួរ	Wikipedia:Frågor och svar
ទំព័រគំរូ:Redirect4	Mall:Str left
ទំព័រគំរូ:ទិន្នន័យ នៃប្រទេសនេប៉ាល់	Mall:Landsdata Nepal
ទំព័រគំរូ:Pagelist	Mall:Pagelist
ទំព័រគំរូ:Px	Mall:Px
ទំព័រគំរូ:Resolved	Mall:Utfört
ទំព័រគំរូ:Str sub long	Mall:Str sub
ទំព័រគំរូ:ទិន្នន័យ នៃប្រទេសហ្វាំងឡង់	Mall:Landsdata Finland
ទំព័រគំរូ:Selfref	Mall:Hänvisning2
ទំព័រគំរូ:ទិន្នន័យ​នៃប្រទេសហ្វីលីពីន	Mall:PHL
ទំព័រគំរូ:ទិន្នន័យ នៃប្រទេសអេស៊ីប	Mall:Landsdata Egypten
ទំព័រគំរូ:ទិន្នន័យ នៃប្រទេសលីថូនី	Mall:Landsdata Litauen
ទំព័រគំរូ:ប្រអប់ព័ត៌មាន គណបក្សនយោបាយ	Mall:Partifakta
ទំព័រគំរូ:ទិន្នន័យប្រទេស ជប៉ុន	Mall:Landsdata Japan
ទំព័រគំរូ:Expand section	Mall:Stubavsnitt
ទំព័រគំរូ:Navbox with columns	Mall:Navbox with columns
ទំព័រគំរូ:ប្រអប់ព័ត៌មាន ល្បែងវីដេអូ	Mall:Datorspelsfakta
ទំព័រគំរូ:IsLeapYear	Mall:Omskottår
ទំព័រគំរូ:Age in years and days	Mall:Ålder i år och dagar
ទំព័រគំរូ:Nom	Mall:Nom2
ទំព័រគំរូ:Facebook	Mall:Facebook-konto
ទំព័រគំរូ:Cleanup	Mall:Städa
ទំព័រគំរូ:ប្រអប់ព័ត៌មាន សាកលវិទ្យាល័យ	Mall:Universitet
ទំព័រគំរូ:Cite journal	Mall:Tidskriftsref
ទំព័រគំរូ:ទិន្នន័យប្រទេស អាស៊ែបៃហ្សង់	Mall:Landsdata Azerbajdzjan
ទំព័រគំរូ:វិគីសៀវភៅ	Mall:Wikibooks
ទំព័រគំរូ:Image	Mall:Bild
ទំព័រគំរូ:User browser:Firefox	Mall:Användare Firefox
ទំព័រគំរូ:User es-0	Mall:Användare es-0
ទំព័រគំរូ:Time ago	Mall:Tid sedan
ទំព័រគំរូ:Familytree	Mall:Släktträd
ទំព័រគំរូ:ទិន្នន័យប្រទេស វៀតណាម	Mall:Landsdata Vietnam
ទំព័រគំរូ:S-aft	Mall:S-aft
ទំព័រគំរូ:Featured article	Mall:Utmärkt
ទំព័រគំរូ:ទិន្នន័យ នៃប្រទេសរុស្ស៊ី	Mall:Landsdata Ryssland
ចំណាត់ថ្នាក់ក្រុម:User en-4	Kategori:Användare en-4
ចំណាត់ថ្នាក់ក្រុម:User en	Kategori:Användare en
ចំណាត់ថ្នាក់ក្រុម:User zh	Kategori:Användare zh
ចំណាត់ថ្នាក់ក្រុម:User zh-N	Kategori:Användare zh-N
ចំណាត់ថ្នាក់ក្រុម:User en-2	Kategori:Användare en-2
ទំព័រគំរូ:ប្រអប់ព័ត៌មាន	Mall:Faktamall
ទំព័រគំរូ:TOC right	Mall:TOChöger
ទំព័រគំរូ:Main other	Mall:Artikel annan
ទំព័រគំរូ:User zh	Mall:Användare zh
ទំព័រគំរូ:Template other	Mall:Mall annan
ទំព័រគំរូ:Legend	Mall:Legend
ទំព័រគំរូ:Cite web	Mall:Webbref
ទំព័រគំរូ:YouTube	Mall:Youtube
ទំព័រគំរូ:ទិន្នន័យ នៃប្រទេសអ៊ីតាលី	Mall:Landsdata Italien
ទំព័រគំរូ:Current	Mall:Pågående
ទំព័រគំរូ:ទិន្នន័យប្រទេស	Mall:Landsdata
ទំព័រគំរូ:Won	Mall:Vinst
ទំព័រគំរូ:Tnavbar-collapsible	Mall:Navbar-collapsible
ទំព័រគំរូ:Coor URL	Mall:Coor URL
ទំព័រគំរូ:Min	Mall:Lägsta
ទំព័រគំរូ:Wiktionary	Mall:Wiktionary
ទំព័រគំរូ:ទិន្នន័យ នៃប្រទេសស៊ុយអែត	Mall:Landsdata Sverige
ទំព័រគំរូ:Bar box	Mall:Stapeldiagram
ទំព័រគំរូ:Chem	Mall:Kemisk formel
ទំព័រគំរូ:Language icon	Mall:Språkikon
ទំព័រគំរូ:Lang-sr	Mall:Lang-sr
ទំព័រគំរូ:User ru	Mall:Användare ru
ទំព័រគំរូ:IPA	Mall:IPA
ទំព័រគំរូ:អត្ថន័យដទៃទៀត	Mall:Olika betydelser
ទំព័រគំរូ:ទិន្នន័យប្រទេស សហភាពសូវៀត	Mall:Landsdata Sovjetunionen
ទំព័រគំរូ:ទិន្នន័យ នៃប្រទេសឥណ្ឌា	Mall:Landsdata Indien
ទំព័រគំរូ:Language with name	Mall:LangWithName
ទំព័រគំរូ:Birth year and age	Mall:Ålder
ទំព័រគំរូ:List of African capitals	Mall:Huvudstäder i Afrika
ទំព័រគំរូ:ប្រអប់ព័ត៌មាន ក្រុមជនជាតិ	Mall:Folkgrupp
ទំព័រគំរូ:Archive box	Mall:Arkivbox
ទំព័រគំរូ:MONTHNAME	Mall:MÅNADSNAMN
វិគីភីឌា:Text of GNU Free Documentation License	Wikipedia:Texten till GNU Free Documentation License
ទំព័រគំរូ:រង្វាន់ណូបែល	Mall:Nobelpriset
ទំព័រគំរូ:Sisterlinks	Mall:Systerlänkar
ទំព័រគំរូ:ទិន្នន័យប្រទេស អង់ដូរ៉ា	Mall:Landsdata Andorra
ទំព័រគំរូ:ប្រអប់ព័ត៌មាន តំបន់ការពារ	Mall:Nationalpark
ទំព័រគំរូ:Border	Mall:Border
ទំព័រគំរូ:ទិន្នន័យប្រទេស ព័រទុយហ្គាល់	Mall:Landsdata Portugal
ទំព័រគំរូ:Death date and age	Mall:Död datum och ålder
ចំណាត់ថ្នាក់ក្រុម:People stubs	Kategori:Personstubbar
ទំព័រគំរូ:ទិន្នន័យប្រទេស បុរីវ៉ាទីកង់	Mall:Landsdata Vatikanstaten
ទំព័រគំរូ:Icon	Mall:Ikon
ចំណាត់ថ្នាក់ក្រុម:Template:Country data templates	Kategori:Landsdatamallar
ចំណាត់ថ្នាក់ក្រុម:ជ័យលាភីរង្វាន់ណូបែល ផ្នែករូបវិទ្យា	Kategori:Nobelpristagare i fysik
ចំណាត់ថ្នាក់ក្រុម:ជ័យលាភីរង្វាន់ណូបែល ផ្នែកគីមីវិទ្យា	Kategori:Nobelpristagare i kemi
ទំព័រគំរូ:Navbox with collapsible groups	Mall:Navbox with collapsible groups
ទំព័រគំរូ:GeoGroup	Mall:GeoLänk
ទំព័រគំរូ:ទិន្នន័យប្រទេស ចិន	Mall:Landsdata Kina
ទំព័រគំរូ:Wikify	Mall:Ickewiki
ទំព័រគំរូ:ទិន្នន័យ នៃ ប្រទេស អង់គ្លេស	Mall:Landsdata Kungariket England
ទំព័រគំរូ:ទិន្នន័យ នៃប្រទេសអៀរឡង់	Mall:Landsdata Republiken Irland
ទំព័រគំរូ:ទិន្នន័យ នៃប្រទេសទួរគី	Mall:Landsdata Turkiet
ទំព័រគំរូ:ទិន្នន័យ នៃប្រទេសស្វីស	Mall:Landsdata Schweiz
ទំព័រគំរូ:ទិន្នន័យ នៃប្រទេសហ្វីលីពីន	Mall:Landsdata Filippinerna
ទំព័រគំរូ:Hidden begin	Mall:Hidden begin
ទំព័រគំរូ:Army	Mall:Armé
ទំព័រគំរូ:ទិន្នន័យ នៃប្រទេសម៉ាឡេស៊ី	Mall:Landsdata Malaysia
ទំព័រគំរូ:ទិន្នន័យប្រទេស អាមេនី	Mall:Landsdata Armenien
ទំព័រគំរូ:Infobox OS	Mall:Infobox operativsystem
ទំព័រគំរូ:ទិន្នន័យ នៃប្រទេសតៃវ៉ាន់	Mall:Landsdata Taiwan
ទំព័រគំរូ:ទិន្នន័យប្រទេស វៀតណាមខាងត្បូង	Mall:Landsdata Sydvietnam
ទំព័រគំរូ:ទិន្នន័យ នៃប្រទេសភូមា	Mall:Landsdata Myanmar
ទំព័រគំរូ:ទិន្នន័យ នៃប្រទេសឈីលី	Mall:Landsdata Chile
ទំព័រគំរូ:ទិន្នន័យប្រទេស លីបង់	Mall:Landsdata Libanon
ទំព័រគំរូ:ទិន្នន័យប្រទេស ចិនតៃប៉ិ	Mall:Landsdata Kina-Taipei
ទំព័រគំរូ:ប្រអប់ព័ត៌មាន សៀវភៅ	Mall:Bokfakta
ទំព័រគំរូ:ប្រអប់ព័ត៌មាន ភព	Mall:Infobox planet
ទំព័រគំរូ:Compact periodic table	Mall:Periodiska systemet navbox
ទំព័រគំរូ:Lang-fa	Mall:Lang-fa
ទំព័រគំរូ:ICD10	Mall:ICD10
ទំព័រគំរូ:ទិន្នន័យ​នៃប្រទេសម៉ាឡេស៊ី	Mall:MAS
ទំព័រគំរូ:Infobox website	Mall:Infobox webbplats
ទំព័រគំរូ:Globalize	Mall:Global
ទំព័រគំរូ:Image label end	Mall:Image label end
ទំព័រគំរូ:Navboxes	Mall:Navboxes
ទំព័រគំរូ:Documentation subpage	Mall:Dokumentationssida
ទំព័រគំរូ:Uncategorized	Mall:Okategoriserad
ទំព័រគំរូ:ទិន្នន័យ​នៃប្រទេសឥណ្ឌូនេស៊ី	Mall:IDN
ទំព័រគំរូ:Talk header for guidelines	Mall:Diskussionssida
ទំព័រគំរូ:Quote box	Mall:Citatbox
ទំព័រគំរូ:Navbox years	Mall:NavboxYears
ទំព័រគំរូ:CcTLD	Mall:Toppdomäner
ទំព័រគំរូ:Oldid	Mall:Permalink
ទំព័រគំរូ:List of Asian capitals by region	Mall:Huvudstäder i Asien
ទំព័រគំរូ:Bquote	Mall:Block quote
ទំព័រគំរូ:ប្រអប់ព័ត៌មានទីកន្លែងកេរដំណែលពិភពលោក	Mall:Världsarv
ទំព័រគំរូ:Str len	Mall:Str len
ទំព័រគំរូ:Purge	Mall:Rensa
ទំព័រគំរូ:Lang-de	Mall:Lang-de
ទំព័រគំរូ:Lang-la	Mall:Lang-la
ទំព័រគំរូ:ប្រអប់ព័ត៌មាន អាគារ	Mall:Faktamall byggnad
ទំព័រគំរូ:Location map USA	Mall:Kartposition USA
ទំព័រគំរូ:Lang-el	Mall:Lang-el
ទំព័រគំរូ:ទិន្នន័យ​នៃប្រទេសអារ៉ាប៊ីសាអូឌីត	Mall:SAU
ទំព័រគំរូ:User page	Mall:Wikipediaanvändare
ទំព័រគំរូ:Lang-my	Mall:Lang-my
ទំព័រគំរូ:ប្រអប់ព័ត៌មាន ព្រះវិហារគ្រិស្ដសាសនា	Mall:Infobox kyrka
ទំព័រគំរូ:ផ្នែក និងទឹកដីនាយសមុទ្ររបស់បារាំង	Mall:Frankrikes utomeuropeiska departement och förvaltningsområden
ទំព័រគំរូ:User	Mall:Anv-data
ទំព័រគំរូ:Spoken Wikipedia	Mall:Talad artikel
ទំព័រគំរូ:University-stub	Mall:Universitetsstub
ទំព័រគំរូ:វិគីភីឌាភាសា	Mall:Wikipediautgåvor
ទំព័រគំរូ:Clarify	Mall:Förtydliga
ទំព័រគំរូ:Refimprove	Mall:Källor
ទំព័រគំរូ:Lorem ipsum	Mall:Lorem ipsum
ទំព័រគំរូ:ស្នើសុំប្ដូរឈ្មោះ	Mall:Byt namn
ទំព័រគំរូ:CIA World Factbook link	Mall:CIA World Factbook link
ទំព័រគំរូ:Image label small	Mall:Image label small
ទំព័រគំរូ:Nihongo	Mall:Nihongo
ទំព័រគំរូ:User fr-3	Mall:Användare fr-3
ទំព័រគំរូ:Th icon	Mall:Th ikon
ទំព័រគំរូ:Failed verification	Mall:Ej i angiven källa
ទំព័រគំរូ:Notelist	Mall:Anmärkningslista
ទំព័រគំរូ:S-ttl	Mall:S-ttl
ទំព័រគំរូ:Infobox former country	Mall:Historisk stat
ទំព័រគំរូ:JPN	Mall:JPN
ទំព័រគំរូ:Merge from	Mall:Infoga från
ទំព័រគំរូ:Cmbox	Mall:Cmbox
ជំនួយ:តារាង	Wikipedia:Tabeller
ទំព័រគំរូ:End date	Mall:End date
ទំព័រគំរូ:ទិន្នន័យ​នៃប្រទេសប៉ាគីស្ថាន	Mall:PAK
ទំព័រគំរូ:Age in days nts	Mall:Dagar från idag
ទំព័រគំរូ:S-bef	Mall:S-bef
ទំព័រគំរូ:Nations at the 2008 Summer Olympics	Mall:Deltagande nationer i olympiska sommarspelen 2008
ទំព័រគំរូ:Guideline	Mall:Riktlinje
ទំព័រគំរូ:JULIANDAY	Mall:JULIANDAY
ទំព័រគំរូ:DNB portal	Mall:DNB-Portal
ទំព័រគំរូ:Talkarchive	Mall:Arkivsida
ទំព័រគំរូ:Pagetype	Mall:Namntyp
ទំព័រគំរូ:ទិន្នន័យ​នៃប្រទេសអ៊ីរ៉ង់	Mall:IRN
ទំព័រគំរូ:ទិន្នន័យ​នៃប្រទេសហ្សកដង់	Mall:JOR
ទំព័រគំរូ:Bibleverse	Mall:Bibelvers
ទំព័រគំរូ:ទិន្នន័យ​នៃប្រទេសហុងកុង	Mall:HKG
ទំព័រគំរូ:ទិន្នន័យ​នៃប្រទេសកូរ៉េខាងជើង	Mall:PRK
ទំព័រគំរូ:ទិន្នន័យ​នៃប្រទេសឥណ្ឌា	Mall:IND
ទំព័រគំរូ:ទិន្នន័យ​នៃប្រទេសម៉ាកាវ	Mall:MAC
ទំព័រគំរូ:សបា្ដហ៍	Mall:Veckodagar
ទំព័រគំរូ:To do	Mall:Att göra
ទំព័រគំរូ:CURRENTJULIANDAY	Mall:CURRENTJULIANDAY
ទំព័រគំរូ:Nobold	Mall:Ej fet
ចំណាត់ថ្នាក់ក្រុម:User ja-N	Kategori:Användare ja-N
ទំព័រគំរូ:PDFlink	Mall:PDF
ទំព័រគំរូ:Ca icon	Mall:Ca ikon
ទំព័រគំរូ:ទិន្នន័យ នៃប្រទេសអាល្លឺម៉ងខាងកើត	Mall:Landsdata Västtyskland
ទំព័រគំរូ:Lang-ru	Mall:Lang-ru
ទំព័រគំរូ:Br separated entries	Mall:Br separated entries
ទំព័រគំរូ:Infobox saint	Mall:Infobox helgon
ទំព័រគំរូ:Hidden end	Mall:Hidden end
ទំព័រគំរូ:ណែនាំ	Mall:Förgrening
ទំព័រគំរូ:ទិន្នន័យ នៃប្រទេសហុងកុង	Mall:Landsdata Hongkong
ទំព័រគំរូ:No	Mall:Ej utfört
ទំព័រគំរូ:Tick	Mall:J
ចំណាត់ថ្នាក់ក្រុម:ទំព័រគំរូ ប្រអប់ព័ត៌មាន	Kategori:Faktamallar
ចំណាត់ថ្នាក់ក្រុម:Lists of flags	Kategori:Listor över flaggor
ទំព័រគំរូ:ទិន្នន័យប្រទេស Nazi Germany	Mall:Landsdata Nazityskland
ចំណាត់ថ្នាក់ក្រុម:អ្នកថតរូប	Kategori:Fotografi
ទំព័រគំរូ:Para	Mall:Para
ទំព័រគំរូ:Partial	Mall:Partiell
ចំណាត់ថ្នាក់ក្រុម:យន្តហោះយោធា	Kategori:Stridsflygplan
ទំព័រគំរូ:Legend inline	Mall:Legend inline
ទំព័រគំរូ:Death year and age	Mall:Död år och ålder
ទំព័រគំរូ:LAO	Mall:LAO
ទំព័រគំរូ:PRT	Mall:POR
ទំព័រគំរូ:States of Austria	Mall:Österrike
ទំព័រគំរូ:For	Mall:För
ទំព័រគំរូ:Ifsubst	Mall:Omsubst
ចំណាត់ថ្នាក់ក្រុម:អង្គការមិនរកប្រាក់កំរៃ	Kategori:Ideella organisationer
ទំព័រគំរូ:High-risk	Mall:Högriskmall
ទំព័រគំរូ:Lang-uk	Mall:Lang-uk
ទំព័រគំរូ:Contains Chinese text	Mall:Kinesiska tecken
ទំព័រគំរូ:KHM	Mall:KHM
ទំព័រគំរូ:ប្រអប់ព័ត៌មាន អង្គការ	Mall:Organisationsfakta
ទំព័រគំរូ:MNE	Mall:MNE
ទំព័រគំរូ:Category TOC	Mall:KategoriTOC
ទំព័រគំរូ:Resize	Mall:Resize
ទំព័រគំរូ:Lang-nl	Mall:Lang-nl
ទំព័រគំរូ:Lang-id	Mall:Lang-id
ទំព័រគំរូ:ទិន្នន័យ​នៃប្រទេសកូរ៉េខាងត្បូង	Mall:KOR
ទំព័រគំរូ:EMedicine2	Mall:EMedicine2
ទំព័រគំរូ:លំហឈ្មោះ	Mall:Namnrymder
ទំព័រគំរូ:ទិន្នន័យប្រទេស កាតារ	Mall:Landsdata Qatar
ទំព័រគំរូ:User it-2	Mall:Användare it-2
ទំព័រគំរូ:Lang-fr	Mall:Lang-fr
ទំព័រគំរូ:Superimpose	Mall:Superponera
ទំព័រគំរូ:FRA	Mall:FRA
ទំព័រគំរូ:Age	Mall:Age
ទំព័រគំរូ:Hang on	Mall:Låtvara
ទំព័រគំរូ:Flagicon image	Mall:Flaggikon bild
ទំព័រគំរូ:Pending	Mall:Avvaktande
ទំព័រគំរូ:Infobox person	Mall:Infobox biografi
ទំព័រគំរូ:ទិន្នន័យ នៃប្រទេសអ៊ីស្រាអែល	Mall:Landsdata Israel
ទំព័រគំរូ:Number table sorting	Mall:Nts
ទំព័រគំរូ:List of European capitals by region	Mall:Huvudstäder i Europa
ទំព័រគំរូ:ទិន្នន័យប្រទេស កូឡុំប៊ី	Mall:Landsdata Colombia
ទំព័រគំរូ:ទិន្នន័យប្រទេស Ghana	Mall:Landsdata Ghana
ទំព័រគំរូ:ទិន្នន័យប្រទេស កូរ៉េខាងត្បូង	Mall:Landsdata Sydkorea
ទំព័រគំរូ:Legend-line	Mall:Legend-linje
ចំណាត់ថ្នាក់ក្រុម:ព្រះមហាក្សត្រខ្មែរ	Kategori:Kambodjas regenter
ទំព័រគំរូ:Coord	Mall:Coord
ទំព័រគំរូ:POV	Mall:POV
ទំព័រគំរូ:Citation/make link	Mall:Link
ចំណាត់ថ្នាក់ក្រុម:20th-century births	Kategori:Födda 1900-talet
ទំព័រគំរូ:Dmoz	Mall:Dmoz
ចំណាត់ថ្នាក់ក្រុម:ពហុកោណ	Kategori:Polygoner
ទំព័រគំរូ:User la-1	Mall:Användare la-1
ទំព័រគំរូ:ទិន្នន័យប្រទេស បារ៉ែន	Mall:Landsdata Bahrain
ទំព័រគំរូ:Biology-stub	Mall:Biologistub
ចំណាត់ថ្នាក់ក្រុម:ឯកសារអំពី ទំព័រគំរូ	Kategori:Malldokumentation
ចំណាត់ថ្នាក់ក្រុម:អត្ថបទខ្លីមិនពេញលេញ អំពីកម្ពុជា	Kategori:Kambodjastubbar
ចំណាត់ថ្នាក់ក្រុម:User et	Kategori:Användare et
ចំណាត់ថ្នាក់ក្រុម:User fr	Kategori:Användare fr
ចំណាត់ថ្នាក់ក្រុម:User id	Kategori:Användare id
ចំណាត់ថ្នាក់ក្រុម:User ja	Kategori:Användare ja
ចំណាត់ថ្នាក់ក្រុម:User la	Kategori:Användare la
ចំណាត់ថ្នាក់ក្រុម:User li	Kategori:Användare li
ចំណាត់ថ្នាក់ក្រុម:User sv	Kategori:Användare sv
ចំណាត់ថ្នាក់ក្រុម:User th	Kategori:Användare th
ចំណាត់ថ្នាក់ក្រុម:User fr-3	Kategori:Användare fr-3
ចំណាត់ថ្នាក់ក្រុម:User it-3	Kategori:Användare it-3
ចំណាត់ថ្នាក់ក្រុម:User ja-3	Kategori:Användare ja-3
ចំណាត់ថ្នាក់ក្រុម:User tr-3	Kategori:Användare tr-3
ចំណាត់ថ្នាក់ក្រុម:User et-1	Kategori:Användare et-1
ចំណាត់ថ្នាក់ក្រុម:User nl-1	Kategori:Användare nl-1
ចំណាត់ថ្នាក់ក្រុម:User tr-1	Kategori:Användare tr-1
ចំណាត់ថ្នាក់ក្រុម:User ko-4	Kategori:Användare ko-4
ចំណាត់ថ្នាក់ក្រុម:User fr-4	Kategori:Användare fr-4
ចំណាត់ថ្នាក់ក្រុម:User it-4	Kategori:Användare it-4
ចំណាត់ថ្នាក់ក្រុម:User fr-2	Kategori:Användare fr-2
ចំណាត់ថ្នាក់ក្រុម:User it-2	Kategori:Användare it-2
ចំណាត់ថ្នាក់ក្រុម:User ja-2	Kategori:Användare ja-2
ចំណាត់ថ្នាក់ក្រុម:User la-2	Kategori:Användare la-2
ចំណាត់ថ្នាក់ក្រុម:User tr-2	Kategori:Användare tr-2
ចំណាត់ថ្នាក់ក្រុម:User fr-N	Kategori:Användare fr-N
ចំណាត់ថ្នាក់ក្រុម:User it-N	Kategori:Användare it-N
ចំណាត់ថ្នាក់ក្រុម:User nl-N	Kategori:Användare nl-N
ចំណាត់ថ្នាក់ក្រុម:User ru-N	Kategori:Användare ru-N
ចំណាត់ថ្នាក់ក្រុម:កំសាន្ត	Kategori:Nöjen
ចំណាត់ថ្នាក់ក្រុម:User af	Kategori:Användare af
ចំណាត់ថ្នាក់ក្រុម:User af-1	Kategori:Användare af-1
ចំណាត់ថ្នាក់ក្រុម:កោះ	Kategori:Öar
ចំណាត់ថ្នាក់ក្រុម:User de	Kategori:Användare de
ចំណាត់ថ្នាក់ក្រុម:User de-2	Kategori:Användare de-2
ចំណាត់ថ្នាក់ក្រុម:User de-3	Kategori:Användare de-3
ចំណាត់ថ្នាក់ក្រុម:User de-4	Kategori:Användare de-4
ចំណាត់ថ្នាក់ក្រុម:User de-N	Kategori:Användare de-N
ចំណាត់ថ្នាក់ក្រុម:User el	Kategori:Användare el
ចំណាត់ថ្នាក់ក្រុម:User en-3	Kategori:Användare en-3
ចំណាត់ថ្នាក់ក្រុម:User en-N	Kategori:Användare en-N
ចំណាត់ថ្នាក់ក្រុម:User es	Kategori:Användare es
ចំណាត់ថ្នាក់ក្រុម:User es-1	Kategori:Användare es-1
ចំណាត់ថ្នាក់ក្រុម:User es-2	Kategori:Användare es-2
ចំណាត់ថ្នាក់ក្រុម:User es-4	Kategori:Användare es-4
ចំណាត់ថ្នាក់ក្រុម:User es-N	Kategori:Användare es-N
ចំណាត់ថ្នាក់ក្រុម:User fi	Kategori:Användare fi
ចំណាត់ថ្នាក់ក្រុម:User fi-N	Kategori:Användare fi-N
ទំព័រគំរូ:N/a	Mall:N/a
ទំព័រគំរូ:Bcdb	Mall:BCDB
ចំណាត់ថ្នាក់ក្រុម:User id-1	Kategori:Användare id-1
ចំណាត់ថ្នាក់ក្រុម:User id-3	Kategori:Användare id-3
ទំព័រគំរូ:ទិន្នន័យ នៃប្រទេសអាល្លឺម៉ង់	Mall:Landsdata Tyskland
ទំព័រគំរូ:Multiple image	Mall:Multiple image
ទំព័រគំរូ:ទិន្នន័យប្រទេស ចក្រភពអង់គ្លេស	Mall:Landsdata Storbritannien
ចំណាត់ថ្នាក់ក្រុម:ធរណីមាត្រ	Kategori:Geometri
ទំព័រគំរូ:អង្គការសហប្រជាជាតិ	Mall:FN
ទំព័រគំរូ:ប្រអប់ព័ត៌មាន រោគ-ជំងឺ	Mall:Infobox sjukdom
ទំព័រគំរូ:Weather box	Mall:Klimattabell
វិគីភីឌា:អត្ថបទ​ប្រចាំ​ថ្ងៃ	Wikipedia:Utvald artikel
ចំណាត់ថ្នាក់ក្រុម:User it	Kategori:Användare it
ចំណាត់ថ្នាក់ក្រុម:User it-1	Kategori:Användare it-1
ចំណាត់ថ្នាក់ក្រុម:User ja-1	Kategori:Användare ja-1
ចំណាត់ថ្នាក់ក្រុម:User ko	Kategori:Användare ko
ចំណាត់ថ្នាក់ក្រុម:User ko-1	Kategori:Användare ko-1
ចំណាត់ថ្នាក់ក្រុម:User ko-2	Kategori:Användare ko-2
ចំណាត់ថ្នាក់ក្រុម:User ko-3	Kategori:Användare ko-3
ចំណាត់ថ្នាក់ក្រុម:User ksh	Kategori:Användare ksh
ចំណាត់ថ្នាក់ក្រុម:User ksh-N	Kategori:Användare ksh-N
ចំណាត់ថ្នាក់ក្រុម:User la-1	Kategori:Användare la-1
ចំណាត់ថ្នាក់ក្រុម:User lb	Kategori:Användare lb
ទំព័រគំរូ:Cite doi	Mall:Cite doi
ទំព័រគំរូ:ប្រអប់ព័ត៌មាន រូបិយវត្ថុ	Mall:Valuta
ទំព័រគំរូ:Sup	Mall:Sup
ទំព័រគំរូ:Current U.S. Senators	Mall:Nuvarande ledamöter av USA:s senat
ទំព័រគំរូ:Lang-vi	Mall:Lang-vi
ទំព័រគំរូ:Distinguish	Mall:Förväxlas
ទំព័រគំរូ:Infobox programming language	Mall:Faktaruta programspråk
ទំព័រគំរូ:He icon	Mall:He ikon
ទំព័រគំរូ:Pp-protected	Mall:Skyddad
ចំណាត់ថ្នាក់ក្រុម:User ru-1	Kategori:Användare ru-1
ទំព័រគំរូ:TOC limit	Mall:TOC limit
វិគីភីឌា:បាបេល	Wikipedia:Babel
ទំព័រគំរូ:Expand list	Mall:Ofullständig lista
ទំព័រគំរូ:Tdeprecated	Mall:Ersatt mall
ចំណាត់ថ្នាក់ក្រុម:1900s births	Kategori:Födda 1900-talet (decennium)
ទំព័រគំរូ:Talk other	Mall:Diskussion annan
ចំណាត់ថ្នាក់ក្រុម:User ms-2	Kategori:Användare ms-2
ចំណាត់ថ្នាក់ក្រុម:សមុទ្រ	Kategori:Hav
ទំព័រគំរូ:IPA-all	Mall:IPA2
ទំព័រគំរូ:Lang-ko	Mall:Lang-ko
ទំព័រគំរូ:Lang-it	Mall:Lang-it
ចំណាត់ថ្នាក់ក្រុម:User nds	Kategori:Användare nds
ចំណាត់ថ្នាក់ក្រុម:User nds-1	Kategori:Användare nds-1
ជំនួយ:Archiving a talk page	Wikipedia:Arkivering
ទំព័រគំរូ:ទិន្នន័យ នៃប្រទេសប្រេស៊ីល	Mall:Landsdata Brasilien
វិគីភីឌា:WikiProject Computing	Wikipedia:Projekt datavetenskap
ចំណាត់ថ្នាក់ក្រុម:អង្គការអន្តរជាតិ	Kategori:Internationella organisationer
ទំព័រគំរូ:Sfn	Mall:Sfn
ចំណាត់ថ្នាក់ក្រុម:សមីការឌីផេរ៉ង់ស្យែល	Kategori:Differentialekvationer
ចំណាត់ថ្នាក់ក្រុម:ខេត្តក្រុងខ្មែរ	Kategori:Provinser i Kambodja
ទំព័រគំរូ:Release date and age	Mall:Startdatum och ålder
ចំណាត់ថ្នាក់ក្រុម:ឧទ្ធម្ភាគចក្រ	Kategori:Helikoptrar
ចំណាត់ថ្នាក់ក្រុម:វិទ្យាសាស្ត្រសង្គម	Kategori:Samhällsvetenskap
ឈាន	Dhyana
ទំព័រគំរូ:ទិន្នន័យ នៃប្រទេសហុងគ្រី	Mall:Landsdata Ungern
ចំណាត់ថ្នាក់ក្រុម:ឆ្នាំកំណើត ១៩៥១	Kategori:Födda 1951
ទំព័រគំរូ:Zh icon	Mall:Zh ikon
ទំព័រគំរូ:Advert	Mall:Reklam
ទំព័រគំរូ:Infobox government agency	Mall:Myndighet
វិគីភីឌា:Tools	Wikipedia:Externa hjälpmedel
ទំព័រគំរូ:User ru-2	Mall:Användare ru-2
ចំណាត់ថ្នាក់ក្រុម:User ru	Kategori:Användare ru
ចំណាត់ថ្នាក់ក្រុម:User ru-2	Kategori:Användare ru-2
ចំណាត់ថ្នាក់ក្រុម:User ru-3	Kategori:Användare ru-3
ចំណាត់ថ្នាក់ក្រុម:វត្តអារាមព្រះពុទ្ធសាសនា	Kategori:Buddhistiska tempel
ទំព័រគំរូ:S-reg	Mall:Successionsbox regent
ចំណាត់ថ្នាក់ក្រុម:User th-N	Kategori:Användare th-N
ចំណាត់ថ្នាក់ក្រុម:User tr	Kategori:Användare tr
ចំណាត់ថ្នាក់ក្រុម:User tr-4	Kategori:Användare tr-4
ចំណាត់ថ្នាក់ក្រុម:User tr-N	Kategori:Användare tr-N
ទំព័រគំរូ:En icon	Mall:En ikon
ទំព័រគំរូ:Nay	Mall:N
ទំព័រគំរូ:ប្រអប់ភាសា	Mall:Lang
ទំព័រគំរូ:ទិន្នន័យប្រទេស Russian SFSR	Mall:Landsdata Ryska SFSR
ទំព័រគំរូ:ទិន្នន័យប្រទេស តួកម៉េនីស្ថាន	Mall:Landsdata Turkmenistan
ទំព័រគំរូ:Str index	Mall:Str index
ទំព័រគំរូ:Alabama	Mall:Alabama
ទំព័រគំរូ:ប្រធានបទអាស៊ី	Mall:Asien metamall
ទំព័រគំរូ:BLP	Mall:NLP
ទំព័រគំរូ:Bar percent	Mall:Procentstapel
ទំព័រគំរូ:Bu	Mall:Bu
ទំព័រគំរូ:CURRENTISOYEAR	Mall:CURRENTISOYEAR
ទំព័រគំរូ:Fr icon	Mall:Fr ikon
ទំព័រគំរូ:Twitter	Mall:Twitter
ទំព័រគំរូ:Ko icon	Mall:Ko ikon
ទំព័រគំរូ:Lang-hi	Mall:Lang-hi
ទំព័រគំរូ:EST	Mall:EST
ទំព័រគំរូ:IAFD name	Mall:IAFD namn
ទំព័រគំរូ:ទិន្នន័យ​នៃប្រទេសរុស្ស៊ី	Mall:RUS
ទំព័រគំរូ:Compu-domain-stub	Mall:Domänstub
ទំព័រគំរូ:ICD9	Mall:ICD9
ទំព័រគំរូ:ប្រវត្តិសាស្ត្របារាំង	Mall:Frankrikes historia
ទំព័រគំរូ:CHL	Mall:CHL
ទំព័រគំរូ:Campaign	Mall:Kampanj
ទំព័រគំរូ:ប្រអប់យុទ្ធនាការសង្គ្រាមឥណ្ឌូចិន	Mall:Kampanj Indokinakrigen
ទំព័រគំរូ:Centralized discussion	Mall:Aktuella diskussioner
ទំព័រគំរូ:ទិន្នន័យ​នៃប្រទេសស៊ីរី	Mall:SYR
ទំព័រគំរូ:ENG	Mall:ENG
ទំព័រគំរូ:Copy to Wikibooks	Mall:Wikibooksflytt
ទំព័រគំរូ:Citation	Mall:Citation
ទំព័រគំរូ:Citation/core	Mall:Citation/core
ចំណាត់ថ្នាក់ក្រុម:ប្រទេសជាកោះ	Kategori:Östater
ទំព័រគំរូ:ប្រអប់ព័ត៌មាន ភាសា/family-color	Mall:Språk/familj-färg
ទំព័រគំរូ:User la-2	Mall:Användare la-2
ទំព័រគំរូ:User ru-1	Mall:Användare ru-1
ចំណាត់ថ្នាក់ក្រុម:អាំងតេក្រាល	Kategori:Integraler
ចំណាត់ថ្នាក់ក្រុម:រូបវិទូ	Kategori:Fysiker efter nationalitet
ចំណាត់ថ្នាក់ក្រុម:គមនាគមន៍នៅប្រទេសជប៉ុន	Kategori:Transport i Japan
ចំណាត់ថ្នាក់ក្រុម:ប្រទេសហ្សំប៊ី	Kategori:Zambia
ទំព័រគំរូ:Cuisine	Mall:Kök
ទំព័រគំរូ:ទិន្នន័យប្រទេស យូហ៊្គោស្លាវី	Mall:Landsdata Jugoslavien
ទំព័រគំរូ:Multi-listen end	Mall:Multi-listen end
ចំណាត់ថ្នាក់ក្រុម:ការអប់រំនៅប្រទេសជប៉ុន	Kategori:Utbildning i Japan
ចំណាត់ថ្នាក់ក្រុម:ការអប់រំនៅកម្ពុជា	Kategori:Utbildning i Kambodja
ចំណាត់ថ្នាក់ក្រុម:User ja-0	Kategori:Användare ja-0
ចំណាត់ថ្នាក់ក្រុម:User nl	Kategori:Användare nl
ទំព័រគំរូ:Unbulleted list	Mall:Unbulleted list
ចំណាត់ថ្នាក់ក្រុម:User zh-1	Kategori:Användare zh-1
ចំណាត់ថ្នាក់ក្រុម:User zh-4	Kategori:Användare zh-4
ចំណាត់ថ្នាក់ក្រុម:User zh-3	Kategori:Användare zh-3
ចំណាត់ថ្នាក់ក្រុម:User zh-2	Kategori:Användare zh-2
ចំណាត់ថ្នាក់ក្រុម:មេកានិច	Kategori:Mekanik
ចំណាត់ថ្នាក់ក្រុម:អនុគមន៍សនិទាន	Kategori:Rationella funktioner
ចំណាត់ថ្នាក់ក្រុម:រូបវិទូអាល្លឺម៉ង់	Kategori:Tyska fysiker
ចំណាត់ថ្នាក់ក្រុម:រូបវិទូអ៊ីតាលី	Kategori:Italienska fysiker
ចំណាត់ថ្នាក់ក្រុម:រូបវិទូបារាំង	Kategori:Franska fysiker
ទំព័រគំរូ:Tnavbar-header	Mall:Navbar-header
ចំណាត់ថ្នាក់ក្រុម:ព្រឹត្តិការណ៍កីឡាចំរុះ	Kategori:Multisportevenemang
ចំណាត់ថ្នាក់ក្រុម:គណិតវិទូអាល្លឺម៉ង់	Kategori:Tyska matematiker
ទំព័រគំរូ:ទិន្នន័យប្រទេស វៀតណាមខាងជើង	Mall:Landsdata Nordvietnam
ចំណាត់ថ្នាក់ក្រុម:ចំនួនគត់រឺឡាទីប	Kategori:Heltal
ចំណាត់ថ្នាក់ក្រុម:ត្រីកោណមាត្រ	Kategori:Trigonometri
ចំណាត់ថ្នាក់ក្រុម:ទ្រឹស្តីបទគណិតវិទ្យា	Kategori:Satser
ចំណាត់ថ្នាក់ក្រុម:អាកាសយានដ្ឋាន	Kategori:Flygplatser
ចំណាត់ថ្នាក់ក្រុម:រូបវិទូអាមេរិក	Kategori:Amerikanska fysiker
ចំណាត់ថ្នាក់ក្រុម:រូបវិទូអង់គ្លេស	Kategori:Engelska fysiker
ចំណាត់ថ្នាក់ក្រុម:អ្នកនិពន្ធល្បី	Kategori:Kambodjanska författare
ចំណាត់ថ្នាក់ក្រុម:នាយករដ្ឋមន្ត្រីសិង្ហបុរី	Kategori:Singapores premiärministrar
ចំណាត់ថ្នាក់ក្រុម:រង្វាន់ណូបែល	Kategori:Nobelpriset
ចំណាត់ថ្នាក់ក្រុម:ប្រទេសកម្ពុជា	Kategori:Kambodja
ចំណាត់ថ្នាក់ក្រុម:អ្នកនយោបាយប៉ាគីស្ថាន	Kategori:Pakistanska politiker
ទំព័រគំរូ:Lang-hy	Mall:Lang-hy
ចំណាត់ថ្នាក់ក្រុម:អ្នកនយោបាយខ្មែរ	Kategori:Kambodjanska politiker
ចំណាត់ថ្នាក់ក្រុម:អ្នករុករកជនជាតិបារាំង	Kategori:Franska upptäcktsresande
ចំណាត់ថ្នាក់ក្រុម:ស្រីលង្កា	Kategori:Sri Lanka
ចំណាត់ថ្នាក់ក្រុម:ទំព័រគំរូឈ្មោះភាសា	Kategori:Flerspråkiga stödmallar
ចំណាត់ថ្នាក់ក្រុម:ទំព័រគំរូក្នុងរូបវិទ្យា	Kategori:Fysikmallar
ទំព័រគំរូ:ISO 639 name	Mall:Språknamn
ទំព័រគំរូ:ទិន្នន័យប្រទេស Wales	Mall:Landsdata Wales
ចំណាត់ថ្នាក់ក្រុម:ពហុធា	Kategori:Polynom
ចំណាត់ថ្នាក់ក្រុម:ពិជគណិតថ្នាក់ដំបូង	Kategori:Elementär algebra
ចំណាត់ថ្នាក់ក្រុម:អនុគមន៍	Kategori:Funktioner
ចំណាត់ថ្នាក់ក្រុម:ភាសាជប៉ុន	Kategori:Japanska
ចំណាត់ថ្នាក់ក្រុម:ត្រីកោណ	Kategori:Trianglar
ចំណាត់ថ្នាក់ក្រុម:សំភារៈ​សំណង់	Kategori:Byggnadsmaterial
ទំព័រគំរូ:S-off	Mall:Successionsbox uppdrag
ចំណាត់ថ្នាក់ក្រុម:សមីការ	Kategori:Ekvationer
ពន្ធលើប្រាក់បៀវត្ស	Arbetsgivaravgift
ចំណាត់ថ្នាក់ក្រុម:ស្ពាននៅប្រទេសជប៉ុន	Kategori:Broar i Japan
ចំណាត់ថ្នាក់ក្រុម:សិទ្ធិ	Kategori:Rättigheter
ទំព័រគំរូ:Hexadecimal	Mall:Hex
ចំណាត់ថ្នាក់ក្រុម:វិភាគគណិតវិទ្យា	Kategori:Matematisk analys
ចំណាត់ថ្នាក់ក្រុម:វិសមភាព	Kategori:Olikheter
ចំណាត់ថ្នាក់ក្រុម:ឧទ្យានជាតិ	Kategori:Nationalparker
ចំណាត់ថ្នាក់ក្រុម:កោះស៊ូម៉ាត្រា	Kategori:Sumatra
ចំណាត់ថ្នាក់ក្រុម:មីក្រូសេដ្ឋកិច្ច	Kategori:Mikroekonomi
ចំណាត់ថ្នាក់ក្រុម:អាស៊ីហ្គេម	Kategori:Asiatiska spelen
ចំណាត់ថ្នាក់ក្រុម:អេឡិចត្រូស្តាទិច	Kategori:Elektrostatik
ចំណាត់ថ្នាក់ក្រុម:អ៊ីសាក់ ញូតុន	Kategori:Isaac Newton
ចំណាត់ថ្នាក់ក្រុម:អាកាសចរណ៍	Kategori:Transport
ចំណាត់ថ្នាក់ក្រុម:ទ្រឹស្តីបទលេខ	Kategori:Talteori
ទំព័រគំរូ:ប្រអប់ព័ត៌មាន ភាសា	Mall:Språk
ទំព័រគំរូ:អត្ថបទខ្លី អំពីកូរ៉េខាងត្បូង	Mall:Sydkoreastub
ទំព័រគំរូ:Wikiversity	Mall:Wikiversity
ចំណាត់ថ្នាក់ក្រុម:ភាសាអ៊ីតាលី	Kategori:Italienska
ចំណាត់ថ្នាក់ក្រុម:ភាសាអេស្ប៉ាញ	Kategori:Spanska
ចំណាត់ថ្នាក់ក្រុម:រថក្រោះ	Kategori:Stridsvagnar
ខេត្តនៃកម្ពុជា	Kambodjas provinser
ចំណាត់ថ្នាក់ក្រុម:កោះរបស់ឥណ្ឌូនេស៊ី	Kategori:Indonesiens öar
ទំព័រគំរូ:Update after	Mall:Bäst före
ខេត្តលង់ហោរ	Vinh Long (provins)
ចំណាត់ថ្នាក់ក្រុម:ភ្នំពេញ	Kategori:Phnom Penh
ទំព័រគំរូ:CountryAbbr	Mall:CountryAbbr
ទំព័រគំរូ:Split	Mall:Dela upp
ចំណាត់ថ្នាក់ក្រុម:ធរណីមាត្រអ៊ីពែបូលីក	Kategori:Hyperbolisk geometri
ទំព័រគំរូ:Tnavbar-navframe	Mall:Navbar-navframe
តូក្យូ	Tokyo
ចំណាត់ថ្នាក់ក្រុម:ក្រលាផ្ទៃ	Kategori:Area
ទំព័រគំរូ:File title	Mall:Bildnamn
ចំណាត់ថ្នាក់ក្រុម:លោការីត	Kategori:Logaritmer
ទំព័រគំរូ:CURRENTMINUTE	Mall:CURRENTMINUTE
ទំព័រគំរូ:ទិន្នន័យ​នៃប្រទេសអ៊ូបេគីស្ថាន	Mall:UZB
ទំព័រគំរូ:OnHold	Mall:Avvaktar
បញ្ជីរាយនាម ជ័យលាភីរង្វាន់ណូបែល ផ្នែកគីមីវិទ្យា	Lista över nobelpristagare i kemi
ទំព័រគំរូ:ទិន្នន័យ នៃប្រទេសអេស្ប៉ាញ	Mall:Landsdata Spanien
ទំព័រគំរូ:ទិន្នន័យប្រទេស កាណាដា	Mall:Landsdata Kanada
ទំព័រគំរូ:Council of Europe	Mall:Europarådet
ទំព័រគំរូ:Flag	Mall:Flagga
ទំព័រគំរូ:ទិន្នន័យប្រទេស ម៉ាល់ឌីវ	Mall:Landsdata Maldiverna
ទំព័រគំរូ:ទិន្នន័យ នៃប្រទេសសិង្ហបុរី	Mall:Landsdata Singapore
ទំព័រគំរូ:ទិន្នន័យប្រទេស យេម៉ែន	Mall:Landsdata Jemen
ទំព័រគំរូ:Lang-pl	Mall:Lang-pl
ទំព័រគំរូ:Diff	Mall:Diff
ចំណាត់ថ្នាក់ក្រុម:ភាសាអង់គ្លេស	Kategori:Engelska
ទំព័រគំរូ:G8	Mall:G8
ទំព័រគំរូ:Guideline list	Mall:Riktlinjer
ទំព័រគំរូ:Nature nav	Mall:Natur
ទំព័រគំរូ:Infobox country Olympics	Mall:Fakta Land i olympiska spelen
ទំព័រគំរូ:User vi-1	Mall:Användare vi-1
ទំព័រគំរូ:OMIM2	Mall:OMIM2
ទំព័រគំរូ:Lang-th	Mall:Lang-th
ទំព័រគំរូ:Lang-sq	Mall:Lang-al
ទំព័រគំរូ:Lang-es	Mall:Lang-es
ទំព័រគំរូ:Lang-ca	Mall:Lang-ca
ទំព័រគំរូ:Lang-az	Mall:Lang-az
ទំព័រគំរូ:ISO 3166	Mall:Navigationsruta ISO 3166
ទំព័រគំរូ:Mammal-stub	Mall:Däggdjursstub
ចំណាត់ថ្នាក់ក្រុម:នាមត្រូលជនជាតិជប៉ុន	Kategori:Japanska efternamn
ចំណាត់ថ្នាក់ក្រុម:ក្រុមហ៊ុនអាកាសចរណ៍	Kategori:Passagerarflygplan
ចំណាត់ថ្នាក់ក្រុម:ពិជគណិត	Kategori:Algebra
ចំណាត់ថ្នាក់ក្រុម:មុំ	Kategori:Vinkel
ចំណាត់ថ្នាក់ក្រុម:នព្វន្ធ	Kategori:Aritmetik
ចំណាត់ថ្នាក់ក្រុម:User ko-0	Kategori:Användare ko-0
ចំណាត់ថ្នាក់ក្រុម:ស្ពាននៅអាស៊ី	Kategori:Broar i Asien
ចំណាត់ថ្នាក់ក្រុម:អត្ថបទខ្លីមិនពេញលេញ អំពីព្រះពុទ្ធសាសនា	Kategori:Buddhismstubbar
ចំណាត់ថ្នាក់ក្រុម:អេឡិចត្រូម៉ាញ៉េទិច	Kategori:Elektromagnetism
ទំព័រគំរូ:Lang-mn	Mall:Lang-mn
ទំព័រគំរូ:Lang-sa	Mall:Lang-sa
ទំព័រគំរូ:Lang-sv	Mall:Lang-sv
វិគីភីឌា:វិគីគម្រោងប្រវត្តិសាស្ត្រ	Wikipedia:Projekt historia
ចំណាត់ថ្នាក់ក្រុម:រាជរដ្ឋាភិបាលកម្ពុជា	Kategori:Kambodjas administration
ទំព័រគំរូ:Precision/tz	Mall:Precision/tz
ចំណាត់ថ្នាក់ក្រុម:បណ្ណាល័យ	Kategori:Bibliotek
ជំនួយ:Books/Frequently Asked Questions	Wikipedia:Vanliga frågor om böcker
ជំនួយ:Books/Printed books	Wikipedia:Tryckta böcker
វិគីភីឌា:Link color	Wikipedia:Länkfärg
ទំព័រគំរូ:Tech-stub	Mall:Teknikstub
ទំព័រគំរូ:ទិន្នន័យ​នៃប្រទេសម៉ុងហ្គោល	Mall:MNG
ចំណាត់ថ្នាក់ក្រុម:ចំនួនកុំផ្លិច	Kategori:Komplexa tal
ចំណាត់ថ្នាក់ក្រុម:Subtemplates of Template Convert	Kategori:Undermallar till Mall:Convert
ចំណាត់ថ្នាក់ក្រុម:ទំព័រគំរូTOC	Kategori:Innehållsförteckningsmallar
ទំព័រគំរូ:Image label begin	Mall:Image label begin
ចំណាត់ថ្នាក់ក្រុម:រង្វង់និងស៊្វែរ	Kategori:Cirklar
ទំព័រគំរូ:Bg icon	Mall:Bg ikon
ចំណាត់ថ្នាក់ក្រុម:សាកលវិទ្យាល័យនៅប្រទេសជប៉ុន	Kategori:Universitet och högskolor i Japan
វិគីភីឌា:សារ ទំព័រគំរូ/បោសសំអាត	Wikipedia:Layoutlista över mallar om artikelkvalitet
ចំណាត់ថ្នាក់ក្រុម:User es-0	Kategori:Användare es-0
ចំណាត់ថ្នាក់ក្រុម:វប្បធម៌ខ្មែរ	Kategori:Kultur i Kambodja
ចំណាត់ថ្នាក់ក្រុម:User en-1	Kategori:Användare en-1
ចំណាត់ថ្នាក់ក្រុម:User de-1	Kategori:Användare de-1
ទំព័រគំរូ:Nowrap begin	Mall:Nowrap begin
ទំព័រគំរូ:Split section	Mall:Bryt ut
ទំព័រគំរូ:Thank you	Mall:Tack
ទំព័រគំរូ:សង្គ្រាមត្រជាក់	Mall:Kalla kriget
ទំព័រគំរូ:Pipe	Mall:Pipe
វិគីភីឌា:Tutorial/Keep in mind	Wikipedia:Kom ihåg
ចំណាត់ថ្នាក់ក្រុម:កោះជ្វា	Kategori:Java
ទំព័រគំរូ:Frac	Mall:Frac
ទំព័រគំរូ:Ntsh	Mall:Ntsh
ទំព័រគំរូ:Start date	Mall:Startdatum
ទំព័រគំរូ:WW2InfoBox	Mall:Faktaruta andra världskriget
ទំព័រគំរូ:SMS	Mall:SMS
ទំព័រគំរូ:Bio-stub	Mall:Personstub
វិគីភីឌា:Owl	Mall:Ugglan
ទំព័រគំរូ:Isfdb name	Mall:ISFDB-namn
ទំព័រគំរូ:Infobox Cambodian Province	Mall:Infobox Provins Kambodja
ទំព័រគំរូ:WikiProject Footer	Mall:WikiProject sidfot
វិគីភីឌា:Project namespace	Wikipedia:Namnrymder/Wikipedia
ទំព័រគំរូ:Infobox file format	Mall:Infobox filformat
វិគីភីឌា:WikiProject Military history/Military navigation	Mall:Military navigation
វិគីភីឌា:Version 1.0 Editorial Team	Wikipedia:Wikipedia 1.0
ទំព័រគំរូ:User id-1	Mall:Användare id-1
ទំព័រគំរូ:S-inc	Mall:S-inc
ទំព័រគំរូ:Finance-stub	Mall:Finansstub
ទំព័រគំរូ:The Sun	Mall:Solen
ទំព័រគំរូ:Politics sidebar	Mall:Politikmall
ទំព័រគំរូ:Efn	Mall:Anmärkning
ទំព័រគំរូ:S-ppo	Mall:Successionsbox partiuppdrag
វិគីភីឌា:Babel/km-0	Wikipedia:Babel/sv-0
ចំណាត់ថ្នាក់ក្រុម:យន្តហោះប្រដេញ	Kategori:Jaktflygplan
ទំព័រគំរូ:Str len/core	Mall:Str len/core
ទំព័រគំរូ:Rnd/-	Mall:Rnd/-
ទំព័រគំរូ:Noitalic	Mall:Noitalic
ទំព័រគំរូ:Harvard citation/core	Mall:Harvard citation/core
ទំព័រគំរូ:IPA-ca	Mall:IPA-ca
ទំព័រគំរូ:Shipboxflag	Mall:Shipboxflag
ទំព័រគំរូ:Multi-listen item	Mall:Multi-listen item
រូបភាពដែលបាត់បង់	L'Image manquante
ទំព័រគំរូ:Earth's landforms	Mall:Jordens landformer
ទំព័រគំរូ:Howto	Mall:Instruktion
ទំព័រគំរូ:Refimprove section	Mall:Fler källor avsnitt
កំប្រុកព័ណ៌	Prevostekorre
ទំព័រគំរូ:Style/IPA	Mall:Style/IPA
ទំព័រគំរូ:Style/yid	Mall:Style/yid
ទំព័រគំរូ:Project header	Mall:Projekt
ទំព័រគំរូ:ទិន្នន័យប្រទេស អូម៉ង់	Mall:Landsdata Oman
ទំព័រគំរូ:ទិន្នន័យប្រទេស កាមេរូន	Mall:Landsdata Kamerun
ព្យុះហៃយ៉ាន	Tyfonen Haiyan
ពិសេស:បំលាស់ប្ដូរថ្មីៗ	Special:Senaste ändringar
មន្ទារ	Magnolia liliifera
Module:HtmlBuilder	Modul:HtmlBuilder
Module:Coordinates	Modul:Coordinates
Module:Navbox	Modul:Navbox
ទ្រឹស្តីបទការ៉េបី	Legendres trekvadraterssats
Call of Duty: Advanced Warfare	Call of Duty: Advanced Warfare
បញ្ជីនៃទង់ជាតិអង្គភាពរដ្ឋបាលរាជវង្សង្វៀនរបស់	Lista över Nguyendynastins förvaltningars flaggor
