Afrika	Afrika
Ġappun	Japan
Norveġja	Norge
Ingilterra	England
Skozja	Skottland
Irlanda ta' Fuq	Nordirland
Repubblika tal-Irlanda	Irland
Ungerija	Ungern
Spanja	Spanien
Stati Uniti	USA
Belġju	Belgien
Lussemburgu	Luxemburg
Art	Jorden
Mewt	Döden
Bniedem	Människa
Tim Berners-Lee	Tim Berners-Lee
Finlandja	Finland
Żvezja	Sverige
Danimarka	Danmark
Polonja	Polen
Litwanja	Litauen
Italja	Italien
Żvizzera	Schweiz
Awstrija	Österrike
Greċja	Grekland
Turkija	Turkiet
Portugall	Portugal
Ewropa	Europa
Asja	Asien
Wikipedija	Wikipedia
Pajjiżi l-Baxxi	Nederländerna
Berlin	Berlin
Kompjuter	Dator
Barack Obama	Barack Obama
Urugwaj	Uruguay
Londra	London
Messiku	Mexiko
Oċean Atlantiku	Atlanten
Oċean Paċifiku	Stilla havet
Jannar	Januari
Frar	Februari
Marzu	Mars (månad)
Marte (pjaneta)	Mars (planet)
Kenja	Kenya
Etjopja	Etiopien
Gana	Ghana
April	April
Mejju	Maj
Ġunju	Juni
Lulju	Juli
Awwissu	Augusti
Settembru	September
Ottubru	Oktober
Novembru	November
Diċembru	December
Iljun	Lejon
Franza	Frankrike
Kelb	Hund
Renju Unit	Storbritannien
Qattus	Katt
Ċina	Kina
Wikizzjunarju	Wiktionary
Brażil	Brasilien
François Hollande	François Hollande
Russja	Ryssland
Wiki	Wiki
Fondazzjoni Wikimedia	Wikimedia Foundation
Jimmy Wales	Jimmy Wales
Ġermanja	Tyskland
Bjelorussja	Vitryssland
Il Canto degli italiani	Il Canto degli Italiani
Iżlanda	Island
Estonja	Estland
Saturnu (pjaneta)	Saturnus
Latvja	Lettland
Ukraina	Ukraina
Ċekja	Tjeckien
Slovakkja	Slovakien
Slovenja	Slovenien
Vilnius	Vilnius
Moldova	Moldavien
Rumanija	Rumänien
Bulgarija	Bulgarien
Ruma	Rom
Repubblika tal-Maċedonja	Makedonien
Albanija	Albanien
Kroazja	Kroatien
Bożnija u Ħerżegovina	Bosnien och Hercegovina
Ażerbajġan	Azerbajdzjan
Andorra	Andorra
Ċipru	Cypern
Ġeorġja	Georgien
Każakistan	Kazakstan
Malta	Malta
Monako	Monaco
Montenegro	Montenegro
Belt tal-Vatikan	Vatikanstaten
San Marino	San Marino
Brussell	Bryssel (kommun)
Kuba	Kuba
Beliże	Belize
Torri Eiffel	Eiffeltornet
Barbados	Barbados
Volkswagen	Volkswagen
Indoneżja	Indonesien
Wolfgang Amadeus Mozart	Wolfgang Amadeus Mozart
Ludwig van Beethoven	Ludwig van Beethoven
Afrika t'Isfel	Sydafrika
Alġerija	Algeriet
Wikisors	Wikisource
Varsavja	Warszawa
Festival tal-Eurovision	Eurovision Song Contest
Injam	Trä
Pornografija	Pornografi
Ċili	Chile
Ġesù	Jesus
Galileo Galilei	Galileo Galilei
Merkurju (pjaneta)	Merkurius
Storja	Historia
Venere (pjaneta)	Venus
Imħabba	Kärlek
Ġove (pjaneta)	Jupiter
Triq ta' Sant'Anna	Vintergatan
Uranu (pjaneta)	Uranus
Nettunu (pjaneta)	Neptunus
Astronomija	Astronomi
Singapor	Singapore
Xjenza	Vetenskap
Liechtenstein	Liechtenstein
Sport	Sport
Adolf Hitler	Adolf Hitler
Facebook	Facebook
L-Ewwel Gwerra Dinjija	Första världskriget
It-Tieni Gwerra Dinjija	Andra världskriget
Wikotba	Wikibooks
Wikikwota	Wikiquote
Wikiversità	Wikiversity
Skopje	Skopje
Szczecin	Szczecin
Matematika	Matematik
Lingwa Latina	Latin
Baħrejn	Bahrain
Armenja	Armenien
Serbja	Serbien
Qamar	Månen
Awstralja	Australien
Arġentina	Argentina
Perù	Peru
Bijoloġija	Biologi
Kambodja	Kambodja
Faxxa ta' Kuiper	Kuiperbältet
Koran	Koranen
Dinosawru	Dinosaurier
Iżlam	Islam
Ljubljana	Ljubljana
Unjoni Ewropea	Europeiska unionen
Plovdiv	Plovdiv
Mara	Kvinna
Poeżija	Poesi
Lumija	Citron
Émile Zola	Émile Zola
Napuljun I ta' Franza	Napoleon I
Vesuvju	Vesuvius
Xemx	Solen
Sena dawl	Ljusår
Oċeanja	Oceanien
Sistema Solari	Solsystemet
Idroġenu	Väte
Wikimedia Commons	Wikimedia Commons
Lejl	Natt
Oslo	Oslo
Katowice	Katowice
Toqba sewda	Svart hål
Lionel Messi	Lionel Messi
Karbonju	Kol
Ażotu	Kväve
Ossiġenu	Syre
Inter Milan	FC Internazionale Milano
Pjaneta	Planet
Kleopatra VII	Kleopatra VII av Egypten
Mużika	Musik
Moska	Moskva
Lingwa Taljana	Italienska
Ċad	Tchad
New Zealand	Nya Zeeland
Indja	Indien
Tuvalu	Tuvalu
Ħadid	Järn
Tonga	Tonga
Samoa	Samoa
Gżejjer Solomon	Salomonöarna
Vanwatu	Vanuatu
Molière	Molière
Papwa Gwinea l-Ġdida	Papua Nya Guinea
William Shakespeare	William Shakespeare
Nawru	Nauru
Kiribati	Kiribati
Fiġi	Fiji
Veneżwela	Venezuela
Genghis Khan	Djingis khan
Żiemel	Häst
Annimal	Djur
Surinam	Surinam
Paragwaj	Paraguay
Gujana	Guyana
Arti	Konst
Ekwador	Ecuador
Kolombja	Colombia
Buddiżmu	Buddhism
Bolivja	Bolivia
Trinidad u Tobago	Trinidad och Tobago
Saint Vincent u l-Grenadini	Saint Vincent och Grenadinerna
Santa Luċija	Saint Lucia
Leonardo da Vinci	Leonardo da Vinci
Saint Kitts u Nevis	Saint Kitts och Nevis
Ġamajka	Jamaica
Grenada	Grenada
Gwatemala	Guatemala
Baħamas	Bahamas
Antigwa u Barbuda	Antigua och Barbuda
Ħonduras	Honduras
Dominika	Dominica
Repubblika Dominikana	Dominikanska republiken
Ħaiti	Haiti
El Salvador	El Salvador
Iran	Iran
Iraq	Irak
Kosta Rika	Costa Rica
Iżrael	Israel
Panama	Panama
Jemen	Jemen
Lingwa pollakka	Polska
Ġordan	Jordanien
Nikaragwa	Nicaragua
Libanu	Libanon
Maldive	Maldiverna
Malażja	Malaysia
Burma	Burma
Pakistan	Pakistan
Qatar	Qatar
Arabja Sawdija	Saudiarabien
Sri Lanka	Sri Lanka
Josif Stalin	Josef Stalin
YouTube	Youtube
Aristotli	Aristoteles
Emirati Għarab Magħquda	Förenade Arabemiraten
Vjetnam	Vietnam
Korea t'Isfel	Sydkorea
Afganistan	Afghanistan
Bangladexx	Bangladesh
Mali	Mali
Angola	Angola
Butan	Bhutan
Brunej	Brunei
Tanżanija	Tanzania
Repubblika Ċentru-Afrikana	Centralafrikanska republiken
Isaac Newton	Isaac Newton
Isfar	Gul
Mekkanika kwantistika	Kvantmekanik
Togo	Togo
Tuneżija	Tunisien
Żambja	Zambia
Żimbabwe	Zimbabwe
Sudan t'Isfel	Sydsudan
Benin	Benin
Botswana	Botswana
Wikiħbarijiet	Wikinews
Burkina Faso	Burkina Faso
Burundi	Burundi
Komoros	Komorerna
Repubblika tal-Kongo	Kongo-Brazzaville
Repubblika Demokratika tal-Kongo	Kongo-Kinshasa
Ġibuti	Djibouti
Bavarja	Bayern
Ginea Ekwatorjali	Ekvatorialguinea
Eritrea	Eritrea
Papa Ġwanni Pawlu II	Johannes Paulus II
Gabon	Gabon
Mahatma Gandhi	Mahatma Gandhi
Gambja	Gambia
Ginea	Guinea
Ginea Bissaw	Guinea-Bissau
Kosta tal-Avorju	Elfenbenskusten
Kamerun	Kamerun
Kap Verde	Kap Verde
Lesoto	Lesotho
Liberja	Liberia
Libja	Libyen
Madagaskar	Madagaskar
Malawi	Malawi
Mawritanja	Mauretanien
Mawrizju	Mauritius
Marokk	Marocko
Możambik	Moçambique
Namibja	Namibia
Niġer	Niger
Niġerja	Nigeria
Charles Darwin	Charles Darwin
Uganda	Uganda
Rwanda	Rwanda
São Tomé u Príncipe	São Tomé och Príncipe
Senegal	Senegal
Seychelles	Seychellerna
Sierra Leone	Sierra Leone
Somalja	Somalia
Sudan	Sudan
Sważiland	Swaziland
Amburgu	Hamburg
Evoluzzjoni	Evolution
Ġnus Magħquda	Förenta nationerna
Dante Alighieri	Dante Alighieri
Ġeografija	Geografi
Qalb	Hjärta
Praga	Prag
Ikħal	Blå
Limburgu (Belġju)	Limburg (Belgien)
Fjandri tal-Punent	Västflandern
Fjandri tal-Lvant	Östflandern
Antwerp (provinċja)	Antwerpen (provins)
Brabant Fjamming	Flamländska Brabant
Merkurju (mitoloġija)	Mercurius
Hector Berlioz	Hector Berlioz
Giorgio Napolitano	Giorgio Napolitano
Francesco Cossiga	Francesco Cossiga
Oċean Indjan	Indiska oceanen
Kosovo	Kosovo
Frédéric Chopin	Frédéric Chopin
Kategorija:Prinċipali	Kategori:Topp
Dortmund	Dortmund
The Beatles	The Beatles
Osama Bin Laden	Usama bin Ladin
Lingwa Spanjola	Spanska
Montevideo	Montevideo
Johann Sebastian Bach	Johann Sebastian Bach
Brimba	Spindlar
Virġilju	Vergilius
Uetersen	Uetersen
Karozza	Bil
Żagreb	Zagreb
Sqallija	Sicilien
Maurits Cornelis Escher	M.C. Escher
Buenos Aires	Buenos Aires
Belt tal-Messiku	Mexico City
Tokjo	Tokyo prefektur
Barċellona	Barcelona
Ateni	Aten
AC Milan	AC Milan
Ħavana	Havanna
Édith Piaf	Édith Piaf
Kopenħagen	Köpenhamn
Stokkolma	Stockholm
Ħelsinki	Helsingfors
Dublin	Dublin
Rejkjavik	Reykjavik
Tallinn	Tallinn
Riga	Riga
Bratislava	Bratislava
Gdańsk	Gdańsk
Lussemburgu (belt)	Luxemburg (stad)
Bibbja	Bibeln
Ho Chi Minh (belt)	Ho Chi Minh-staden
Knisja Vera ta' Ġesù	The True Jesus Church
Dong Hoi	Dong Hoi
Concepción (Ċili)	Concepción, Chile
Atalanta BC	Atalanta BC
Bolonja	Bologna
Bologna FC 1909	Bologna FC 1909
Cagliari	Cagliari
Kiev	Kiev
Cagliari Calcio	Cagliari Calcio
Karim Benzema	Karim Benzema
Patrice Evra	Patrice Evra
Końskowola	Końskowola
2014	2014
2015	2015
2007	2007
ACF Fiorentina	ACF Fiorentina
Serp	Ormar
1 ta' Jannar	1 januari
2 ta' Jannar	2 januari
Rivoluzzjoni Industrijali	Industriella revolutionen
Imperu Ruman	Romerska kejsardömet
Minsk	Minsk
Microsoft	Microsoft
8 ta' Diċembru	8 december
Kurów	Kurów
Kimika	Kemi
19 ta' Marzu	19 mars
Papa Benedittu XVI	Benedictus XVI
Papa Piju XII	Pius XII
Watford FC	Watford FC
Futbol	Fotboll
L-Olokawst	Förintelsen
Madrid	Madrid
Michael Jackson	Michael Jackson
5 ta' Settembru	5 september
4 ta' Settembru	4 september
Santiago (Ċili)	Santiago de Chile
25 ta' Ottubru	15 oktober
5 ta' Novembru	5 november
22 ta' Novembru	22 november
Aħdar	Grön
Aħmar	Röd
Lourdes	Lourdes
Rabat (Marokk)	Rabat
Kometa	Komet
Belgrad	Belgrad
Kategorija:Mudelli	Kategori:Mallar
George Sand	George Sand
Nikosija	Nicosia
Asterojde	Asteroid
Manama	Manama
Eklissi solari	Solförmörkelse
Wikipedija:Paġna tal-provi	Wikipedia:Sandlådan
Nettunu (mitoloġija)	Neptunus (mytologi)
Alġebra	Algebra
Ajruport Dong Hoi	Dong Hoi flygplats
Miley Cyrus	Miley Cyrus
Curitiba	Curitiba
Pangea	Pangaea
Kategorija:1888	Kategori:1888
Pika Alpina	Fjällpiphare
Konfuċju	Konfucius
Corbin Bleu	Corbin Bleu
Kategorija:Matematika	Kategori:Matematik
Gżejjer Faroe	Färöarna
Mudell:Dati pajjiż Iran	Mall:Landsdata Iran
Ġove (mitoloġija)	Jupiter (gud)
Sherlock Holmes	Sherlock Holmes
Rinaxximent	Renässansen
Kategorija:Twieldu fl-1888	Kategori:Födda 1888
Ewro	Euro
Baħar Mediterran	Medelhavet
Kristjaneżmu	Kristendom
Għasfur	Fåglar
Belt kapitali	Huvudstad
Monzón	Monzón
Mustafa Kemal Atatürk	Mustafa Kemal Atatürk
Mudell:Portal	Mall:Portal
Huang Xianfan	Huang Xianfan
Bill Gates	Bill Gates
Struttura .NET	.NET Framework
Enċiklopedija	Uppslagsverk
Il-Paġna prinċipali	Portal:Huvudsida
Baskitbol	Basket
Francisco Goya	Francisco de Goya
Albrecht Dürer	Albrecht Dürer
Frida Kahlo	Frida Kahlo
Mikelanġlu	Michelangelo
Miguel de Cervantes	Miguel Cervantes
Charles Dickens	Charles Dickens
Mekka	Mecka
Che Guevara	Che Guevara
Mao Zedong	Mao Zedong
Johann Wolfgang von Goethe	Johann Wolfgang von Goethe
Filosofija	Filosofi
Jimi Hendrix	Jimi Hendrix
Kategorija:Proposti għat-tħassir minnufih	Kategori:Snabbraderingar
Hebe Camargo	Hebe Camargo
Komuniżmu	Kommunism
Saħara tal-Punent	Västsahara
Pajjiż	Land
Kartaġni	Karthago
Kategorija:Astronomija	Kategori:Astronomi
Søren Kierkegaard	Søren Kierkegaard
Bolzano	Bolzano
Rivoluzzjoni Franċiża	Franska revolutionen
Saħara	Sahara
Strażburgu	Strasbourg
Lingwa Kroata	Kroatiska
Omeru	Homeros
Lena Meyer-Landrut	Lena Meyer-Landrut
Seklu XVII	1600-talet
Ateiżmu	Ateism
Ekoloġija	Ekologi
FC Barcelona	FC Barcelona
Marie Curie	Marie Curie
Premju Nobel	Nobelpriset
Alan Turing	Alan Turing
Ideoloġija	Ideologi
Ada Lovelace	Ada Lovelace
Franz Schubert	Franz Schubert
Igor' Stravinskij	Igor Stravinskij
Pëtr Il'ič Čajkovskij	Pjotr Tjajkovskij
Giuseppe Verdi	Giuseppe Verdi
Kristofru Kolombu	Christofer Columbus
Nagħġa	Tamfår
Mammiferu	Däggdjur
Speċi	Art
Tifel	Barn
Napuljun III	Napoleon III
Vladimir Putin	Vladimir Putin
Analisi matematika	Matematisk analys
Commonwealth tan-Nazzjonijiet	Samväldet
Organizzazzjoni Dinjija tas-Saħħa	Världshälsoorganisationen
Demm	Blod
Pulmun	Lunga
Casablanca	Casablanca
Xjenza Naturali	Naturvetenskap
Santu Wistin	Augustinus
Nelson Mandela	Nelson Mandela
Martin Luther King Jr.	Martin Luther King
Ġeometrija	Geometri
Atmosfera	Atmosfär
Kategorija:Bulgarija	Kategori:Bulgarien
Kategorija:Franza	Kategori:Frankrike
Kategorija:Mużika	Kategori:Musik
Elf Lejla u Lejla	Tusen och en natt
Kategorija:Letteratura	Kategori:Litteratur
Ilijade	Iliaden
Alessandru Manju	Alexander den store
Edukazzjoni	Bildning
Hugo Chávez	Hugo Chávez
Raġel	Man
Otto von Bismarck	Otto von Bismarck
Abort	Abort
Skjavitù	Slaveri
Logħob Olimpiku tas-sajf 2008	Olympiska sommarspelen 2008
US Sassuolo Calcio	US Sassuolo Calcio
Logħob Olimpiku tas-sajf 2016	Olympiska sommarspelen 2016
Gwerra Ċivili Amerikana	Amerikanska inbördeskriget
Imperu Brittaniku	Brittiska imperiet
Real Madrid CF	Real Madrid
Sivilja	Sevilla
Rivoluzzjoni Russa	Ryska revolutionen
Arkimede	Arkimedes
Thomas Edison	Thomas Edison
Ewklide	Euklides
Bit	Bit
Parlament Ewropew	Europaparlamentet
Kostellazzjoni	Stjärnbild
Karl Marx	Karl Marx
Voltaire	Voltaire
Ħinduiżmu	Hinduism
Erwin Schrödinger	Erwin Schrödinger
Lingwa Maltija	Maltesiska
Reliġjon	Religion
René Descartes	René Descartes
Pawlu minn Tarsu	Paulus
Immanuel Kant	Immanuel Kant
Guy de Maupassant	Guy de Maupassant
Friedrich Nietzsche	Friedrich Nietzsche
Fwied	Lever
Kilwa	Njure
Fenek	Kaniner
Psikoloġija	Psykologi
Gautama Buddha	Buddha
Premier League	Premier League
Muħammed	Muhammed
Probabbiltà	Sannolikhet
Martin Luteru	Martin Luther
Xigħa	Shia
Knisja Kattolika	Romersk-katolska kyrkan
Chelsea FC	Chelsea FC
Arsenal FC	Arsenal FC
Sistema diġestiva	Mag- och tarmkanalen
Logħob Olimpiku tax-xitwa 2010	Olympiska vinterspelen 2010
Reġina Eliżabetta II	Elizabeth II
Alfabett	Alfabet
Ronald Reagan	Ronald Reagan
Francisco Varallo	Francisco Varallo
Festival tal-Eurovision 2005	Eurovision Song Contest 2005
Festival tal-Eurovision 2006	Eurovision Song Contest 2006
Festival tal-Eurovision 2007	Eurovision Song Contest 2007
Festival tal-Eurovision 2008	Eurovision Song Contest 2008
Festival tal-Eurovision 2009	Eurovision Song Contest 2009
Festival tal-Eurovision 2010	Eurovision Song Contest 2010
Festival tal-Eurovision 2011	Eurovision Song Contest 2011
Festival tal-Eurovision 2012	Eurovision Song Contest 2012
Festival tal-Eurovision 2013	Eurovision Song Contest 2013
Main-Spessart	Landkreis Main-Spessart
Catherine Middleton	Catherine, hertiginna av Cambridge
David Beckham	David Beckham
Ryan Giggs	Ryan Giggs
Frankonja t'Isfel	Unterfranken
Tom Cleverley	Tom Cleverley
Ben Foster	Ben Foster (fotbollsspelare)
Ashley Young	Ashley Young
Kim Jong-il	Kim Jong Il
Kategorija:Veneżwela	Kategori:Venezuela
Belfast	Belfast
Tavla perjodika	Periodiska systemet
Tórshavn	Torshamn
Manuel Almunia	Manuel Almunia
Attakki tal-11 ta' Settembru	11 september-attackerna
Chordata	Ryggsträngsdjur
Kultura	Kultur
Trattat ta' Maastricht	Fördraget om Europeiska unionen
Mediċina	Medicinsk vetenskap
Sarajevo	Sarajevo
Ekwazzjoni differenzjali	Differentialekvation
Kategorija:Brażil	Kategori:Brasilien
Kategorija:Rumanija	Kategori:Rumänien
Element kimiku	Grundämne
Funzjonijiet (matematika)	Funktion
Kimika organika	Organisk kemi
Mekkanika klassika	Klassisk mekanik
Klassifikazzjoni bijoloġika	Vetenskapligt namn
Arti marzjali	Stridskonst
Rota	Cykel
Relatività ristretta	Speciella relativitetsteorin
Ħġieġ	Glas
Karta	Papper
Kilogramm	Kilogram
Cristiano Ronaldo	Cristiano Ronaldo
Metru	Meter
Pittura	Målarkonst
Skultura	Skulptur
Żfin	Dans
Pajjiżi tad-dinja	Lista över självständiga stater
Preistorja	Förhistorisk tid
Silvio Berlusconi	Silvio Berlusconi
Eric Saade	Eric Saade
4′33″	4′33″
Kolera	Kolera
Skerma	Fäktsport
Sfera ċelesti	Himmelssfären
Malarja	Malaria
AIDS	Aids
Tuberkulożi	Tuberkulos
Inna	Inna
Mona Lisa	Mona Lisa
Teorija tan-numri	Talteori
Kileb	Kragsten
Biżantini	Bysantinska riket
Kruċjata	Korståg
Imperu Ottoman	Osmanska riket
Malgrat de Mar	Malgrat de Mar
Stephan El Shaarawy	Stephan El Shaarawy
Tuta tal-għollieq	Björnbär
Kurgan (belt)	Kurgan (stad)
Trapani	Trapani
Wikispeċi	Wikispecies
Lingwa Għarbija	Arabiska
Jum ir-Ringrazzjament	Thanksgiving
Lingwa Oċċitanija	Occitanska
Lingwa tas-Sinjali Amerikana	Amerikanskt teckenspråk
Alkoħoliżmu	Alkoholism
FC Bayern Munich	FC Bayern München
Serie A	Serie A
Queen	Queen
Provinċja ta' Agrigento	Agrigento (provins)
Provinċja ta' Bergamo	Bergamo (provins)
Provinċja ta' Kaltanissetta	Caltanissetta (provins)
Provinċja ta' Lodi	Lodi (provins)
Wikipedija:Vetrina	Wikipedia:Utmärkta artiklar
Mudell:Link FA	Mall:Link FA
Dinja	Världen
Wikipedija:Pjazza	Wikipedia:Bybrunnen
Takson	Taxon
Papa Pawlu VI	Paulus VI
Etna	Etna
Clube de Regatas do Flamengo	Clube de Regatas do Flamengo
Gerard Piqué	Gerard Piqué
San Lawrenz	Sankt Lars
Martin Schulz	Martin Schulz
KAA Gent	KAA Gent
Mudell Standard	Standardmodellen
Teorija ta' kollox	Teori om allt
Tamworth FC	Tamworth FC
Mafja	Maffia
Manchester United FC	Manchester United FC
Aston Villa FC	Aston Villa FC
West Ham United FC	West Ham United FC
UEFA Champions League	Uefa Champions League
UEFA Europa League	Uefa Europa League
Fenek tal-istrixxi ta' Sumatra	Sumatrakanin
Tazza tad-Dinja tal-Futbol	Världsmästerskapet i fotboll
Daniel Parejo Muñoz	Daniel Parejo
Blackburn Rovers FC	Blackburn Rovers FC
Wolverhampton Wanderers FC	Wolverhampton Wanderers FC
Rafael Correa	Rafael Correa
R. Charleroi SC	R Charleroi SC
FC Twente	FC Twente
Motorhead	Motörhead
Milied	Jul
Lingwi Romaniċi	Romanska språk
Steve Jobs	Steve Jobs
Lady Gaga	Lady Gaga
Indoewropew	Indoeuropeiska språk
Muammar al-Gaddafi	Muammar al-Gaddafi
Francesco Totti	Francesco Totti
Chișinău	Chișinău
Soċjoloġija	Sociologi
Şalom	Şalom
Didelphidae	Pungråttor
Caenolestidae	Inkanäbbmöss
Trojja	Troja
The Pirate Bay	The Pirate Bay
Kampjonati Ewropej tal-Futbol 2012	Europamästerskapet i fotboll 2012
Dasyuridae	Rovpungdjur
Audi	Audi
Abkażja	Abchazien
Antropoloġija	Antropologi
Baħar l-Aħmar	Röda havet
Octave Mirbeau	Octave Mirbeau
Abjad	Vit
Iswed	Svart
Lordi	Lordi
Lingwa uffiċjali	Officiellt språk
Provinċja ta' Quảng Bình	Quang Binh
Entrena	Entrena
Mérida (Veneżwela)	Mérida, Venezuela
Benito Mussolini	Benito Mussolini
LOST (Serje televiżiva)	Lost
Ġebla tal-ġir	Kalksten
Valletta	Valletta
Papa Ġwanni XXIII	Johannes XXIII
Benetice (Světlá nad Sázavou)	Benetice (Světlá nad Sázavou)
Prixtina	Pristina
Curaçao	Curaçao
Coccinellidae	Nyckelpigor
Metatheria	Pungdjur
Pangolin	Myrkottar
Lagomorpha	Hardjur
Baqra tal-baħar	Sirendjur
Eutheria	Högre däggdjur
Fenek Ewropew	Europeisk kanin
Leporidae	Harar och kaniner
Imperu Kushan	Kushan
Qlugħ	Segel
Klaas-Jan Huntelaar	Klaas-Jan Huntelaar
Proboscidea	Elefantdjur
Università Niccolò Cusano	Università degli Studi Niccolò Cusano
Fażijiet lunari	Månfas
Fariżej	Fariséer
M'Baye Niang	M'Baye Niang
Liebru Ewropew	Fälthare
Lepisma saccharina	Silverfisk (insekt)
Laurasiatheria	Laurasiatheria
Afrotheria	Afrotheria
Ewropa t'Isfel	Sydeuropa
Ewropa Ċentrali	Centraleuropa
Kristadelfjani	Kristadelfianer
Tim nazzjonali tal-futbol tal-Eġittu	Egyptens herrlandslag i fotboll
Maja	Mayakulturen
Chow Chow	Chow chow
FC Kuban Krasnodar	FK Kuban Krasnodar
Derivata	Derivata
Kwalifikazzjoni għall-Kampjonati Ewropej tal-Futbol 2008	Kvalspelet till Europamästerskapet i fotboll för herrar 2008
Chris Smalling	Chris Smalling
Jonny Evans	Jonny Evans
Michael Carrick	Michael Carrick
Multilingwiżmu	Flerspråkighet
Lingwa Sileżjana	Schlesiska
Avril Lavigne	Avril Lavigne
Mikhail Gorbachev	Michail Gorbatjov
Slogan	Slogan
Madre Tereża ta' Kalkutta	Moder Teresa
UEFA Champions League 2013–14	Uefa Champions League 2013/2014
Rudolf Clausius	Rudolf Clausius
Auguste Rodin	Auguste Rodin
Blogg	Blogg
Oscar Wilde	Oscar Wilde
Krakovja	Kraków
Thylacinidae	Thylacinidae
Malala Yousafzai	Malala Yousafzai
Carlos Alonso González	Santillana
Marsa FC	Marsa FC
Valery Leontiev	Valerij Leontiev
Mużew	Museum
Du Fu	Du Fu
Popolazzjoni	Befolkning
Arċipelagu	Ögrupp
Lingwa Sqallija	Sicilianska
Valparaíso	Valparaíso
Nju	Niue
Tim nazzjonali tal-futbol tal-Iskozja	Skottlands herrlandslag i fotboll
Lingwa Leoniża	Leonesiska
Żews	Zeus
Lingwa tas-Sinjali	Teckenspråk
Astroloġija	Astrologi
Mošovce	Mošovce
Saint-Dié-des-Vosges	Saint-Dié-des-Vosges
Boris Yeltsin	Boris Jeltsin
Hirohito	Hirohito
Baħar Eġew	Egeiska havet
J.K. Rowling	J.K. Rowling
Hiroshima	Hiroshima
Mitoloġija Griega	Grekisk mytologi
Ġeneru (tassonomija)	Släkte
Xjenzi soċjali	Samhällsvetenskap
Lista ta' kodiċi telefoniċi	Landsnummer
Lista ta' bliet kapitali	Lista över huvudstäder
Noemi (kantanta)	Noemi (artist)
Sit elettroniku	Webbplats
Odissea	Odysséen
Lingwa Ido	Ido
Etimoloġija	Etymologi
Nikita Krushchev	Nikita Chrusjtjov
Kia Motors	Kia
Familja (bijoloġija)	Familj (biologi)
UEFA	Uefa
Arthur Conan Doyle	Arthur Conan Doyle
Sport Club Corinthians Paulista	Sport Club Corinthians Paulista
Lingwa Kopta	Koptiska
Folklor	Folklore
Siligo	Siligo
Mark Zuckerberg	Mark Zuckerberg
Lingwa tas-Sinjali Newzealander	Nyzeeländskt teckenspråk
Neolitiku	Neolitikum
Katerina II tar-Russja	Katarina II av Ryssland
Guglielmo Marconi	Guglielmo Marconi
Ordni (bijoloġija)	Ordning (biologi)
Cork	Cork
Renju (bijoloġija)	Rike (biologi)
Novial	Novial
Aung San Suu Kyi	Aung San Suu Kyi
Kompożitur	Kompositör
Influwenza tal-majjali	Svininfluensa
Serbja u Montenegro	Serbien och Montenegro
Romantiċiżmu	Romantiken
It-Trinita' Mqaddsa	Treenighetsläran
Faragħun	Farao
Mariupol	Mariupol
Tazza tad-Dinja tal-Futbol 2006	Världsmästerskapet i fotboll 2006
Klaus Ebner	Klaus Ebner
Klassi (bijoloġija)	Klass (biologi)
Campora San Giovanni	Campora San Giovanni
Bălţi	Bălți
Auckland Grammar School	Auckland Grammar School
Bolla postali	Frimärke
Era (mitoloġija)	Hera
Premju Nobel għall-Fiżika	Nobelpriset i fysik
Enya	Enya
Phylum	Fylum
Enriku VIII tal-Ingilterra	Henrik VIII av England
São Paulo FC	São Paulo Futebol Clube
Kelb tal-Fenek	Faraohund
Baħar Tirren	Tyrrenska havet
Leeds	Leeds
NK Čelik Zenica	NK Čelik Zenica
Surrealiżmu	Surrealism
Mosta	Mosta
Tas-Sliema	Sliema
Birkirkara	Birkirkara
Radio Studio 54 Network	Radio Studio 54 Network
Lamantin tal-Karibew	Lamantin
Atti ta' l-Appostli	Apostlagärningarna
Żodjaku	Zodiaken
Paulínia	Paulínia
Il-100 ktieb tas-seklu skont Le Monde	Århundradets 100 böcker enligt Le Monde
Fonoloġija	Fonologi
Kim Il-sung	Kim Il Sung
Jan Vermeer	Johannes Vermeer
Borussia Dortmund	Borussia Dortmund
Għenba tax-xewk	Krusbär
Michel de Montaigne	Michel de Montaigne
Golf ta' Biskaja	Biscayabukten
Sorċid	Näbbmöss
Feniċi	Fenicien
Akille	Akilles
Gramma	Gram
Michelangelo Merisi da Caravaggio	Caravaggio
Tim nazzjonali tal-futbol ta' Spanja	Spaniens herrlandslag i fotboll
Martin Weinek	Martin Weinek
Björk	Björk (musiker)
H. G. Wells	H.G. Wells
Tumas More	Thomas More
Fernando Torres	Fernando Torres
Lamantin	Manater
Baħar Liguri	Liguriska havet
Dima Bilan	Dima Bilan
Lega Anżejatika	Hansan
Kubiżmu	Kubism
Qawwiet tal-Assi tat-Tieni Gwerra Dinjija	Axelmakterna
Wikipedija:Mistoqsijiet rikorrenti	Wikipedia:Vanliga frågor
Għar ta' Thien Duong	Thien Duong
Arg-é Bam	Arg-é Bam
Tim nazzjonali tal-futbol tal-Ġermanja	Tysklands herrlandslag i fotboll
Gustave Flaubert	Gustave Flaubert
San Mattew	Matteus
Sant'Ambroġju	Ambrosius av Milano
Ġwanni Kriżostmu	Johannes Chrysostomos
Papa Piju X	Pius X
Papa Ljun XIII	Leo XIII
Rasputin	Grigorij Rasputin
San Girgor Nażjanżenu	Gregorios av Nazianzos
Egon Schiele	Egon Schiele
Duminku ta' Guzmán	Dominicus
Hamit Altıntop	Hamit Altıntop
Maximilien Robespierre	Maximilien de Robespierre
Ġlormu	Hieronymus
San Bażilju	Basileios den store
Michel Foucault	Michel Foucault
Daniel Van Buyten	Daniel Van Buyten
Ilarju ta' Poitiers	Hilarius av Poitiers
Rabat (Malta)	Rabat, Malta
John Henry Newman	John Henry Newman
Morus (botanika)	Mullbärssläktet
Son Doong	Son Dong
Alex Ferguson	Alex Ferguson
Arkanġlu Mikiel	Mikael (ärkeängel)
Titan	Titaner
Kardinal	Kardinal
Iżabella ta' Kastilja	Isabella I av Kastilien
Liebru	Harar (släkte)
Felix Mendelssohn	Felix Mendelssohn
Orikteropu	Jordsvin
Leonardo Araújo	Leonardo Nascimento de Araújo
Metodu xjentifiku	Vetenskaplig metod
Espoo	Esbo
Bijodiversità	Biologisk mångfald
Kannella (kulur)	Brun
Tizjanu	Tizian
Matteo Renzi	Matteo Renzi
Venere (mitoloġija)	Venus (gudinna)
Tazza tad-Dinja tal-Futbol 2002	Världsmästerskapet i fotboll 2002
Tim nazzjonali tal-futbol tal-Ingilterra	Englands herrlandslag i fotboll
Tim nazzjonali tal-futbol ta' Franza	Frankrikes herrlandslag i fotboll
Sid Vicious	Sid Vicious
Mario Monti	Mario Monti
Stojċiżmu	Stoicism
Martin Heidegger	Martin Heidegger
Tazza tad-Dinja tal-Futbol 1930	Världsmästerskapet i fotboll 1930
Università ta' New York	New York University
Giulio Andreotti	Giulio Andreotti
Park Ji-Sung	Park Ji-sung
Slaten Maġi	Tre vise männen
Charles de Foucauld	Charles de Foucauld
Pajjiżi Nordiċi	Norden
Kategorija:Mudelli tal-kimika	Kategori:Kemimallar
Trattat ta' Liżbona	Lissabonfördraget
Claudio Monteverdi	Claudio Monteverdi
Iraċ	Hyraxar
Sami Khedira	Sami Khedira
FC Baku	FK Baku
Provinċja ta' Soria	Soria (provins)
Arkanġlu Rafel	Rafael (ärkeängel)
Moħammed VI	Mohammed VI av Marocko
Jum l-Indipendenza	Nationaldag
Lawrence Gonzi	Lawrence Gonzi
Assedju ta' Malta (1565)	Belägringen av Malta (1565)
CONMEBOL	CONMEBOL
Erbivoru	Växtätare
Herbert von Bismarck	Herbert von Bismarck
Schönhausen	Schönhausen (Elbe)
Oskar Schindler	Oskar Schindler
Enejide	Aeneiden
Flamurtari Vlorë	Flamurtari Vlorë
Besa Kavajë	KS Besa Kavajë
KF Laçi	KF Laçi
Affiss	Affix
Norberto Murara Neto	Norberto Murara Neto
L-Għanja tal-Milied	En julsaga
Marrara	Gallblåsa
Sottospeċi	Underart
Ħassan II	Hassan II
It-Tielet Repubblika Franċiża	Tredje franska republiken
Joyeux Noël	Fiendeland: En dag utan krig
FK Kukësi	FK Kukësi
KF Skënderbeu Korçë	Skënderbeu Korçë
Carlos Bacca	Carlos Bacca
Yıldıray Baştürk	Yıldıray Baştürk
Alfred Wegener	Alfred Wegener
Juli Zeh	Juli Zeh
Edith Stein	Edith Stein
Friedrich Carl von Savigny	Friedrich Carl von Savigny
Walter Andreas Schwarz	Walter Andreas Schwarz
Wilhelm von Humboldt	Wilhelm von Humboldt
Wikipedija:Vetrina/Senjalazzjonijiet	Wikipedia:Artikelnomineringar
Tazza tad-Dinja tal-Futbol 2014	Världsmästerskapet i fotboll 2014
Coronel Fabriciano	Coronel Fabriciano
L-Integral	Integral
Miroslav Klose	Miroslav Klose
Alla Pugacheva	Alla Pugatjova
Dante Bonfim Costa Santos	Dante Bonfim Costa Santos
Isco	Isco
Fes	Fès
Liebru taż-żarbuna tas-silġ	Snöskohare
Greenpeace	Greenpeace
KS Vllaznia Shkodër	KS Vllaznia
Teuta Durrës	Teuta Durrës
Arkanġlu Gabrijel	Gabriel
Mata Hari	Mata Hari
Fußball-Bundesliga	Fußball-Bundesliga
Pressjoni tad-demm	Blodtryck
Enea	Aeneas
Politiku	Politiker
David Villa	David Villa
Demenzja	Demens
Jürgen Klopp	Jürgen Klopp
Tazza tan-Nazzjonijiet Afrikani	Afrikanska mästerskapet i fotboll
Romeo u Ġuljetta	Romeo och Julia
Konfederazzjoni Ażjatika tal-Futbol	Asian Football Confederation
Robin Williams	Robin Williams
Normanni	Normander
Tim nazzjonali tal-futbol tal-Brażil	Brasiliens herrlandslag i fotboll
Grupp (matematika)	Grupp (matematik)
Mesut Özil	Mesut Özil
Isabel Allende	Isabel Allende
Wes Brown	Wes Brown
It-Tempesta	Stormen
Jum l-Indipendenza (Stati Uniti)	USA:s självständighetsdag
Mudell:Ċita ktieb	Mall:Bokref
Robert Tappan Morris	Robert T. Morris
Divorzju	Skilsmässa
Chrzanów	Chrzanów
Medjugori	Međugorje
Suffiss	Suffix
Artiklu (grammatika)	Artikel (grammatik)
Australopithecus	Australopithecus
Festival tal-Eurovision tat-Tfal	Junior Eurovision Song Contest
Kaspar Capparoni	Kaspar Capparoni
Ħolma ta’ Lejla Sajfija	En midsommarnattsdröm
Berthe Morisot	Berthe Morisot
Manuel Neuer	Manuel Neuer
Penny Black	One Penny Black
Armistizju	Vapenstillestånd
KV Mechelen	KV Mechelen
Heiko Westermann	Heiko Westermann
Montenegro fil-Festival tal-Eurovision	Montenegros bidrag i Eurovision Song Contest
Papa Ċelestinu V	Celestinus V
Amedeo Modigliani	Amedeo Modigliani
Appendiċite	Blindtarmsinflammation
Marco Streller	Marco Streller
Hakan Yakın	Hakan Yakin
Ludovic Magnin	Ludovic Magnin
Diego Benaglio	Diego Benaglio
Daniel Bernoulli	Daniel Bernoulli
Jacob Bernoulli	Jakob Bernoulli
Stella Mwangi	Stella Mwangi
Dziecinów	Dziecinów
Pajjiż interkjuż	Inlandsstat
Marcel Bezençon	Marcel Bezençon
Jacob II Bernoulli	Jakob II Bernoulli
Johann III Bernoulli	Jean Bernoulli (astronom)
Nicolaus I Bernoulli	Nicolaus I Bernoulli
Johann II Bernoulli	Johann II Bernoulli
Nicolaus II Bernoulli	Nicolaus II Bernoulli
Gwerer Puniċi	Puniska krigen
Ġunone	Juno
Massimo Oddo	Massimo Oddo
Fraizer Campbell	Fraizer Campbell
Allianz Arena	Allianz Arena
San Ġużepp	Josef från Nasaret
Hidetoshi Nakata	Hidetoshi Nakata
FK Borac Banja Luka	FK Borac Banja Luka
L-Aħħar Ċena (Leonardo)	Nattvarden
Macroscelididae	Springnäbbmöss
Dugongu	Dugong
Galway	Galway
Mario Balotelli	Mario Balotelli
Fenek ta' denbu qotni tal-muntanji	Bergskanin
Macbeth	Macbeth
Theria	Theria
Akropoli ta' Ateni	Akropolis, Aten
Filatelija	Filateli
Stromboli	Stromboli
The Fame	The Fame
FK Austria Wien	FK Austria Wien
SK Rapid Wien	SK Rapid Wien
IMMAGINE&POESIA	Immagine & Poesia
Venere ta' Willendorf	Venus från Willendorf
Bandiera ta' Malta	Maltas flagga
Teorija tal-grafi	Grafteori
Lola Pagnani	Lola Pagnani
Bitcoin	Bitcoin
Tim nazzjonali tal-futbol tad-Danimarka	Danmarks herrlandslag i fotboll
Black metal	Black metal
Pika ta' Kozlov	Ochotona koslowi
Sataniżmu	Satanism
Grawnd Nazzjonali ta' Bejġing	Pekings Nationalstadion
Stadio Giuseppe Meazza	Stadio Giuseppe Meazza
Plotinu	Plotinos
Tim nazzjonali tal-futbol tal-Kroazja	Kroatiens herrlandslag i fotboll
Tim nazzjonali tal-futbol tal-Greċja	Greklands herrlandslag i fotboll
Pika ta' Muli	Ochotona muliensis
Tazza tad-Dinja tal-Futbol tal-Klabbs 2006	Världsmästerskapet i fotboll för klubblag 2006
Tazza tad-Dinja tal-Futbol tal-Klabbs 2007	Världsmästerskapet i fotboll för klubblag 2007
Tazza tad-Dinja tal-Futbol tal-Klabbs 2009	Världsmästerskapet i fotboll för klubblag 2009
Tazza tad-Dinja tal-Futbol tal-Klabbs 2008	Världsmästerskapet i fotboll för klubblag 2008
Fenek tal-bassasa	Träskkanin
Fenek ta' denbu qotni tal-muntanji ta' Appalach	Sylvilagus obscurus
Fenek ta' denbu qotni tal-muntanji ta' Manzano	Sylvilagus cognatus
Eklissi	Eklips
Neymar	Neymar
Brendi	Brandy (spritdryck)
Dominju (bijoloġija)	Domän (biologi)
Kassisa	Svarta vinbär
Daniel Schneidermann	Daniel Schneidermann
Dragan Đokanović	Dragan Đokanović
David de Gea	David de Gea
Westfalenstadion	Signal Iduna Park
Robert Lewandowski	Robert Lewandowski
Kunflitt Iżraeli-Palestinjan	Israel–Palestina-konflikten
Għajnuna:Kif timmodifika artiklu	Wikipedia:Redigering
Lidl	Lidl
Jupp Heynckes	Jupp Heynckes
Plutone (mitoloġija)	Pluton (mytologi)
Eddie Fenech Adami	Edward Fenech Adami
Riccardo Montolivo	Riccardo Montolivo
Tazza tad-Dinja tal-Futbol tal-Klabbs 2010	Världsmästerskapet i fotboll för klubblag 2010
Cristian Zaccardo	Cristian Zaccardo
Gwerra totali	Total krigföring
Nickelodeon	Nickelodeon
Ugo Grozju	Hugo Grotius
René Adler	René Adler
Eruka	Senapskål
Ablativ	Ablativ
Tazza Ażjatika tal-Futbol	Asiatiska mästerskapet i fotboll
Boomerang TV	Boomerang (TV-kanal)
Internazzjonali Soċjalista	Socialistinternationalen
Nannakola tas-seba' tikek	Sjuprickig nyckelpiga
Santa Sede	Heliga stolen
Ettore	Hektor
WK	Efter Kristus
Reġina ta' Saba	Drottningen av Saba
Alġebra astratta	Abstrakt algebra
CONCACAF	CONCACAF
Skanderbeg	Skanderbeg
Tim nazzjonali tal-futbol tal-Iżvezja	Sveriges herrlandslag i fotboll
Raducz	Raducz
Paul Allen	Paul Allen
Eroj	Hjälte
Kuopio	Kuopio
Sirt	Sirt
Soccer City	Soccer City
Tim nazzjonali tal-futbol tal-Awstrija	Österrikes herrlandslag i fotboll
Tim nazzjonali tal-futbol tal-Irlanda	Irlands herrlandslag i fotboll
Nemanja Vidić	Nemanja Vidić
Derry	Londonderry
Ġuvni	Kandidatexamen
Drużiżmu	Druser
Carlos Vidal	Carlos Vidal
Omnivoru	Allätare
George Best	George Best
Oliver Twist	Oliver Twist
Juan Carreño	Juan Carreño
Javier Hernández Balcázar	Javier Hernández
Tim nazzjonali tal-futbol tal-Iżvizzera	Schweiz herrlandslag i fotboll
Ekwazzjoni ta' Schrödinger	Schrödingerekvationen
Priżma	Prisma (optik)
Ballun tad-Deheb	Ballon d'Or
Tim nazzjonali tal-futbol tal-Polonja	Polens herrlandslag i fotboll
Foviżmu	Fauvism
Tim nazzjonali tal-futbol tal-Belġju	Belgiens herrlandslag i fotboll
Dom Mintoff	Dom Mintoff
Sant'Antnin ta' Padova	Antonius av Padua
Eredivisie	Eredivisie i fotboll för herrar
Pawlu Xuereb	Paul Xuereb
Liebru iswed	Svart åsnehare
Ċensu Tabone	Ċensu Tabone
Konfederazzjoni Afrikana tal-Futbol	CAF
Agatha Barbara	Agatha Barbara
Tim nazzjonali tal-futbol tar-Rumanija	Rumäniens herrlandslag i fotboll
Dimitar Berbatov	Dimitar Berbatov
Tim nazzjonali tal-futbol tal-Ukrajna	Ukrainas herrlandslag i fotboll
Għawdex	Gozo
Tim nazzjonali tal-futbol tal-Ungerija	Ungerns herrlandslag i fotboll
Natura mejta	Stilleben
Laura Pausini	Laura Pausini
Gwerra Anglo-Żanżibarjana	Anglo-zanzibariska kriget
Children of Bodom	Children of Bodom
Festival tal-Eurovision 1956	Eurovision Song Contest 1956
Tazza tal-Konfederazzjonijiet	Fifa Confederations Cup
Tim nazzjonali tal-futbol tas-Slovenja	Sloveniens herrlandslag i fotboll
Darren Fletcher	Darren Fletcher
Gowler	Målvakt
Mary Cassatt	Mary Cassatt
Frankinċens	Olibanum
Cape Town Stadium	Green Point Stadium
Xenarthra	Trögdjur
Lista ta' kimiċi organiċi	Kolföreningar
Lira Maltija	Maltesisk lira
Antonio Valencia	Antonio Valencia
Tim nazzjonali tal-futbol tas-Slovakkja	Slovakiens herrlandslag i fotboll
Tereża ta' Ávila	Teresa av Ávila
Guernica (pittura)	Guernica (målning)
Tim nazzjonali tal-futbol ta' New Zealand	Nya Zeelands herrlandslag i fotboll
Kompjuter kwantistiku	Kvantdator
Tazza tad-Dinja tal-Futbol 2010	Världsmästerskapet i fotboll 2010
Kantant	Sångare
Andrea Palladio	Andrea Palladio
Heurelho Gomes	Heurelho Gomes
Moviment Brownjan	Brownsk rörelse
Filosofija Presokratika	Försokratisk filosofi
Apparat Periferali	Kringutrustning
Meknès	Meknès
Copa América	Copa América
Serje ta' Fourier	Fourierserie
Santa Katarina ta' Lixandra	Katarina av Alexandria
Lipari	Eoliska öarna
Liebru tal-muntanji	Skogshare
Konfederazzjoni Oċeanika tal-Futbol	OFC
Kwalifikazzjoni għall-Kampjonati Ewropej tal-Futbol 2012	Kvalspelet till Europamästerskapet i fotboll 2012
Tim nazzjonali tal-futbol tal-Andorra	Andorras herrlandslag i fotboll
Tim nazzjonali tal-futbol tal-Ażerbajġan	Azerbajdzjans herrlandslag i fotboll
Klassifika dinjija tal-FIFA	Fifas världsranking för herrar
Charlotte Perrelli	Charlotte Perrelli
Tim nazzjonali tal-futbol tal-Bulgarija	Bulgariens herrlandslag i fotboll
Tim nazzjonali tal-futbol ta' Wales	Wales herrlandslag i fotboll
Atomium	Atomium
Tim nazzjonali tal-futbol tal-Bożnija u Ħerżegovina	Bosnien och Hercegovinas herrlandslag i fotboll
Tereża ta' Lisieux	Thérèse av Jesusbarnet
Tabella tal-midalji tal-Logħob Olimpiku tas-sajf 2008	Medaljfördelning vid olympiska sommarspelen 2008
Ellis Park Stadium	Ellis Park Stadium
Tazza Interkontinentali (futbol)	Interkontinentala cupen
Bing	Bing (sökmotor)
Plejer tas-Sena tal-FIFA	FIFA World Player of the Year
Santa Luċija (qaddisa)	Lucia (helgon)
Tim nazzjonali tal-futbol tal-Armenja	Armeniens herrlandslag i fotboll
San Bastjan	Sebastian (helgon)
Kolugo	Pälsfladdrare
Tim nazzjonali tal-futbol tal-Każakistan	Kazakstans herrlandslag i fotboll
Tazza tal-Konfederazzjonijiet 2009	Fifa Confederations Cup 2009
Pika	Pipharar
Thomas Vermaelen	Thomas Vermaelen
UEFA Champions League 2009–10	Uefa Champions League 2009/2010
Tim nazzjonali tal-futbol tal-Lussemburgu	Luxemburgs herrlandslag i fotboll
Diġitigrad	Tågångare
Gareth Bale	Gareth Bale
Glen Johnson	Glen Johnson
Manuel Rivera-Ortiz	Manuel Rivera-Ortiz
Tim nazzjonali tal-futbol ta' San Marino	San Marinos herrlandslag i fotboll
Pika tal-kullar	Alaskapiphare
Immakulata Kunċizzjoni	Obefläckade avlelsen
Nigel de Jong	Nigel de Jong
Tim nazzjonali tal-futbol tal-Bjelorussja	Vitrysslands herrlandslag i fotboll
Tim nazzjonali tal-futbol tal-Albanija	Albaniens herrlandslag i fotboll
Tim nazzjonali tal-futbol tal-Ġeorġja	Georgiens herrlandslag i fotboll
Tim nazzjonali tal-futbol tal-Litwanja	Litauens herrlandslag i fotboll
Karmelitani	Karmelitorden
UEFA Champions League 2007–08	Uefa Champions League 2007/2008
Tim nazzjonali tal-futbol tal-Finlandja	Finlands herrlandslag i fotboll
Tim nazzjonali tal-futbol tal-Liechtenstein	Liechtensteins herrlandslag i fotboll
Premier League 2008–09	Premier League 2008/2009
Tim nazzjonali tal-futbol tal-Estonja	Estlands herrlandslag i fotboll
Premier League 2010–11	Premier League 2010/2011
Ħin supplementari	Förlängning
Peter Mokaba Stadium	Peter Mokaba Stadium
Joe Hart	Joe Hart
Malena Ernman	Malena Ernman
Liechtenstein fil-Festival tal-Eurovision	Liechtensteins bidrag i Eurovision Song Contest
Premier League 2007–08	Premier League 2007/2008
RSC Anderlecht	RSC Anderlecht
Barriera	Stenbrott
Oroskopju	Horoskop
Eġizzjan demotiku	Demotisk skrift
Fatt	Faktum
FK Partizan	FK Partizan Belgrad
Tim nazzjonali tal-futbol ta' Malta	Maltas herrlandslag i fotboll
Supereroj	Superhjälte
UEFA Champions League 2008–09	Uefa Champions League 2008/2009
Tim nazzjonali tal-futbol ta' Ċipru	Cyperns herrlandslag i fotboll
Premier League 2009–10	Premier League 2009/2010
Tim nazzjonali tal-futbol tal-Montenegro	Montenegros herrlandslag i fotboll
Andrey Korotayev	Andrej Korotajev
UEFA Champions League 2010–11	Uefa Champions League 2010/2011
Rafael Pereira da Silva (twieled fl-1990)	Rafael Pereira da Silva
FA Community Shield	FA Community Shield
Tim nazzjonali tal-futbol tal-Iżlanda	Islands herrlandslag i fotboll
Tim nazzjonali tal-futbol tal-Unjoni Sovjetika	Sovjetunionens herrlandslag i fotboll
Soċjaliżmu Demokratiku	Demokratisk socialism
Tim nazzjonali tal-futbol tal-Latvja	Lettlands herrlandslag i fotboll
CONCACAF Gold Cup	CONCACAF Gold Cup
Pont du Gard	Pont du Gard
Sligo	Sligo
Emblema ta' Malta	Maltas statsvapen
Benvenuto Cellini	Benvenuto Cellini
Ordni Militari Sovran ta' Malta	Malteserorden
Standard Liège	Standard Liège
Club Brugge KV	Club Brügge KV
Jóhanna Guðrún Jónsdóttir	Jóhanna Guðrún Jónsdóttir
Tim nazzjonali tal-futbol tal-Irlanda ta' Fuq	Nordirlands herrlandslag i fotboll
Edward Sapir	Edward Sapir
Kemmuna	Comino
FC BATE Borisov	FK BATE Borisov
Lucrezia Borgia	Lucrezia Borgia
Klara ta' Assisi	Klara av Assisi
Tim nazzjonali tal-futbol tal-Iżrael	Israels herrlandslag i fotboll
Gareth Barry	Gareth Barry
San Valentinu	Sankt Valentin
FK Ekranas	FK Ekranas
Mini ta' Cu Chi	Cu Chi-tunnlarna
L-Innu Malti	L-Innu Malti
Midfilder	Mittfältare (fotboll)
Kwalifikazzjoni għat-Tazza tad-Dinja tal-Futbol 2010	Kvalspelet till världsmästerskapet i fotboll 2010
Kate Ryan	Kate Ryan
Lys Assia	Lys Assia
Patri Piju	Padre Pio
Analisi komplessa	Komplex analys
Martín Cáceres	Martín Cáceres
Opossum irqiq ta' rasu dejqa	Marmosops cracens
Phascomurexia	Phascomurexia naso
Opossum ġurdien tal-Messiku	Marmosa mexicana
Opossum sufi ta' Derby	Caluromys derbianus
Opossum grazzjuż ta' Aceramarca	Gracilinanus aceramarcae
Opossum ġurdien ta' Robinson	Robinsons muspungråtta
Thylacinus	Thylacinus
Opossum ġurdien ta' Anderson	Marmosa andersoni
Opossum nanu mistur ta' żaqqu ħamra	Gracilinanus ignitus
Opossum nanu mistur ta' Agricola	Gracilinanus agricolai
Opossum ġurdien ta' Quechua	Marmosa quichua
Opossum ġurdien ta' Guajira	Marmosa xerophila
Opossum grazzjuż ta' Emilia	Gracilinanus emiliae
Opossum ġurdien ta' denbu oħxon eleganti	Thylamys elegans
Opossum irqiq ta' żaqqu bajda	Marmosops noctivagus
Murexechinus	Murexechinus melanurus
Opossum ġurdien sufi ta' denbu għarwien	Micoureus regina
Opossum irqiq ta' Pinheiro	Marmosops pinheiroi
Opossum bugeddum skur	Caenolestes fuliginosus
Opossum grazzjuż ħafif	Gracilinanus agilis
Opossum sufi ta' denbu għarwien	Caluromys philander
Opossum ġurdien sufi ta' żaqqu bajda	Micoureus constantiae
Opossum ta' denbu qasir tal-ġnub ħomor tat-Tramuntana	Monodelphis brevicaudata
Opossum ta' denbu qasir tat-tlett strixxi aħmar	Monodelphis umbristriata
Opossum ta' denbu qasir tat-tlett strixxi ta' Nofsinhar	Monodelphis theresa
Opossum ta' denbu qasir tat-tlett strixxi tat-Tramuntana	Monodelphis americana
Opossum ġurdien sufi żgħir	Micoureus phaeus
Opossum ta' denbu qasir griż	Monodelphis domestica
Opossum ta' denbu qasir pigmew	Monodelphis kunsi
Opossum ta' denbu qasir tat-tlett strixxi ta' Ihering	Monodelphis iheringi
Opossum ta' denbu qasir tal-ġnub ħomor ta' Nofsinhar	Monodelphis sorex
Opossum ta' denbu qasir tal-istrixxi kannella ċar	Monodelphis rubida
Opossum ta' denbu qasir ta' Osgood	Monodelphis osgoodi
Opossum ta' denbu qasir tal-ġnub ħomor tal-Amażonja	Monodelphis glirina
Opossum ta' denbu qasir ta' imnieħru twil	Monodelphis scalops
Opossum ġurdien ta' denbu oħxon komuni	Thylamys pusillus
Opossum sufi ta' widnejh kannella	Caluromys lanatus
Opossum ġurdien ta' Linnaeus	Marmosa murina
Opossum ġurdien aħmar	Marmosa rubra
Fenek ta' denbu qotni tal-muntanji ta' Davis	Sylvilagus robustus
Opossum grazzjuż tat-Tramuntana	Gracilinanus marica
Opossum grazzjuż tal-Brażil	Gracilinanus microtarsus
Opossum ta' denbu qasir tal-ġnub sofor	Monodelphis dimidiata
Opossum grazzjuż ta' Wood Sprite	Gracilinanus dryas
Opossum ġurdien ta' Tyleria	Marmosa tyleriana
Opossum irqiq ta' Tschudi	Marmosops impavidus
Opossum ġurdien ħamrani	Marmosa lepida
Opossum ġurdien sufi ta' Alston	Micoureus alstoni
Opossum ta' denbu qasir ta' Emilia	Monodelphis emiliae
Opossum ta' denbu qasir ta' Marajó	Monodelphis maraxina
Opossum irqiq griż	Marmosops incanus
Opossum ġurdien ta' denbu oħxon ta' Karimi	Thylamys karimii
Opossum ġurdien ta' denbu oħxon nanu	Thylamys velutinus
Opossum irqiq tal-Brażil	Marmosops paulensis
Opossum ġurdien ta' denbu oħxon ta' żaqqu kannella fl-isfar	Thylamys venustus
Opossum irqiq ta' Bishop	Marmosops bishopi
Opossum irqiq ta' Dorothy	Marmosops dorothea
Opossum ġurdien ta' denbu oħxon ta' Tate	Thylamys tatei
Opossum irqiq ta' Junin	Marmosops juninensis
Opossum ġurdien ta' denbu oħxon ta' żaqqu bajda	Thylamys pallidior
Opossum ġurdien ta' denbu oħxon ta' Cinderella	Thylamys cinderella
Opossum ġurdien ta' denbu oħxon tal-Arġentina	Thylamys sponsorius
Opossum ġurdien sufi ta' Tate	Micoureus paraguayanus
Opossum irqiq ta' Neblina	Marmosops neblina
Opossum ġurdien ta' denbu oħxon tal-Paragwaj	Thylamys macrurus
Opossum ġurdien sufi tal-pil twil	Micoureus demerarae
Opossum ta' denbu qasir tal-ġnub ħomor tal-kappa	Monodelphis palliolata
Opossum irqiq delikat	Marmosops parvidens
Opossum irqiq ta' Panama	Marmosops invictus
Opossum irqiq ta' Hendley	Marmosops handleyi
Opossum irqiq skur	Marmosops fuscatus
Opossum ta' denbu qasir sepja	Monodelphis adusta
Łobez	Łobez
Fertilizzazzjoni ''in vitro''	In vitro-fertilisering
Tim nazzjonali tal-futbol tal-Gżejjer Faroe	Färöarnas herrlandslag i fotboll
Magnificat	Magnificat
Gowler (futbol)	Fotbollsmålvakt
Theofanis Gekas	Theofanis Gekas
Ażerbajġan fil-Festival tal-Eurovision	Azerbajdzjans bidrag i Eurovision Song Contest
Papat ta' Avignon	Avignonpåvedömet
G-14	G-14
Glen Vella	Glen Vella
Armenja fil-Festival tal-Eurovision	Armeniens bidrag i Eurovision Song Contest
Tereza Kerndlová	Tereza Kerndlová
Albanija fil-Festival tal-Eurovision	Albaniens bidrag i Eurovision Song Contest
Rush	Rush (musikgrupp)
Dundalk	Dundalk
Kumitat tar-Reġjuni	Regionkommittén
Mandejżmu	Mandeism
'O sole mio	O sole mio
SK Sturm Graz	SK Sturm Graz
Il-Merkant ta’ Venezja	Köpmannen i Venedig
Hugo (film)	Hugo Cabret
Hapoel Tel Aviv FC	Hapoel Tel Aviv FC
UEFA Europa League 2009–10	Uefa Europa League 2009/2010
Phil Jones	Phil Jones
UEFA Europa League 2010–11	Uefa Europa League 2010/2011
Olympe de Gouges	Olympe de Gouges
Giovanni Falcone	Giovanni Falcone
Mdina	Mdina
Vulcano	Vulcano
Tranquillo Barnetta	Tranquillo Barnetta
Liġi tan-numri kbar	De stora talens lag
Andorra fil-Festival tal-Eurovision	Andorras bidrag i Eurovision Song Contest
Batterija	Battery
Kung fu	Kung fu
San Marino fil-Festival tal-Eurovision	San Marinos bidrag i Eurovision Song Contest
Federico Macheda	Federico Macheda
Regola tal-gowls barra mid-dar	Bortamålsregeln
Las Meninas	Las Meninas
Ingólfr Arnarson	Ingolf Arnarson
Talpa marsupjal ta' Nofs in-nhar	Sydlig pungmullvad
Talpa marsupjal tat-Tramuntana	Nordvästlig pungmullvad
Elezzjonijiet Ewropej 2009	Europaparlamentsvalet 2009
KF Tirana	KF Tirana
Superliga Albaniża	Kategoria Superiore
Kewkba ta' Betlehem	Betlehemsstjärnan
FC Dinamo Minsk	FK Dinamo Minsk
Nick Drake	Nick Drake
Marokk fil-Festival tal-Eurovision	Marockos bidrag i Eurovision Song Contest
Zoran Tošić	Zoran Tošić
Golf	Golf (olika betydelser)
Kwalifikazzjoni għat-Tazza tad-Dinja tal-Futbol 2010 (UEFA)	Kvalspelet till världsmästerskapet i fotboll 2010 (Uefa)
Palazz Belvedere	Schloss Belvedere
Andrea Poli	Andrea Poli
Bjelorussja fil-Festival tal-Eurovision	Vitrysslands bidrag i Eurovision Song Contest
Artemisia Gentileschi	Artemisia Gentileschi
Gżejjer Aran	Aranöarna
André Villas-Boas	André Villas-Boas
Samir Handanovič	Samir Handanovič
Ignazio Abate	Ignazio Abate
Gelson Fernandes	Gelson Fernandes
Idriss Carlos Kameni	Idriss Carlos Kameni
Marlee Matlin	Marlee Matlin
Dasyuromorphia	Rovlevande pungdjur
Football League	The Football League
Fábio Pereira da Silva	Fábio Pereira da Silva
Antonio Nocerino	Antonio Nocerino
Mohamed Bouazizi	Mohammed Bouazizi
Anna Bergendahl	Anna Bergendahl
Denílson Pereira Neves	Denílson Pereira Neves
Emerson Ferreira da Rosa	Emerson Ferreira da Rosa
L-Ewwel Diviżjoni Belġjana	Jupiler League
KRC Genk	KRC Genk
Lied	Romans (musik)
Kalkulu tal-varjazzjonijiet	Variationskalkyl
Ġgantija	Ggantija
UNCLOS Konvenzjoni tal-Ġnus Magħquda dwar id-Dritt tal-Baħar	Förenta nationernas havsrättskonvention
Trama (narrattiva)	Handling (narratologi)
Filippu Neri	Filippo Neri
Neftchi Baku PFC	Nefttji Baku
Fenek ta' denbu qotni tal-artijiet baxxi tal-Veneżwela	Sylvilagus varynaensis
Bundesliga (Awstrija)	Österrikiska Bundesliga i fotboll
Al-Fatiħa	Al-Fatiha
Tazza tal-Konfederazzjonijiet 2013	Fifa Confederations Cup 2013
Giuseppe Rossi	Giuseppe Rossi
Darron Gibson	Darron Gibson
Russja fil-Festival tal-Eurovision	Rysslands bidrag i Eurovision Song Contest
Enzo Scifo	Enzo Scifo
Air Malta	Air Malta
Kwalifikazzjoni għat-Tazza tad-Dinja tal-Futbol 2010 (CONCACAF)	Kvalspelet till världsmästerskapet i fotboll 2010 (CONCACAF)
F91 Dudelange	F91 Dudelange
KSC Lokeren Oost-Vlaanderen	KSC Lokeren
Tito Vilanova	Tito Vilanova
Kwalifikazzjoni għat-Tazza tad-Dinja tal-Futbol 2010 (OFC)	Kvalspelet till världsmästerskapet i fotboll 2010 (OFC)
Tazza tad-Dinja tal-Futbol tal-Klabbs	Världsmästerskapet i fotboll för klubblag
No (teatru)	No-teater
AFC	AFC
CAF	CAF (olika betydelser)
Alessandro Nesta	Alessandro Nesta
Johann Bernoulli	Johann Bernoulli
Tribù (bijoloġija)	Tribus
Santa Katerina ta' Siena	Katarina av Siena
Alexa Internet	Alexa Internet
Tupaja	Spetsekorrar
Liebru tal-Artiku	Polarhare
Żarbuna tad-Deheb	Guldskon
Denis Law	Denis Law
Al-Iħlas	Al-Ikhlāṣ
Notoryctemorphia	Pungmullvadar
Daniele Bonera	Daniele Bonera
Incertae sedis	Incertae sedis
Ġużeppina Bakhita	Josephine Bakhita
Susanne Georgi	Susanne Georgi
Sofonisba Anguissola	Sofonisba Anguissola
Diana Gurtskaya	Diana Ghurtskaia
Elena Gheorghe	Elena Gheorghe
Hadise	Hadise
Lavinia Fontana	Lavinia Fontana
Marie Myriam	Marie Myriam
Nicole Hohloch	Nicole Seibert
Amanda Michalka	Amanda Michalka
Chiara Siracusa	Chiara Siracusa
Alyson Michalka	Alyson Michalka
Aysel Teymurzadeh	Aysel Teymurzadeh
Olta Boka	Olta Boka
Magdalena Tul	Magdalena Tul
Premier League Armen	Armeniska fotbollsligan
Andrea Demirović	Andrea Demirović
Thea Garrett	Thea Garrett
Rosalba Carriera	Rosalba Carriera
4FUN	4Fun
Ġeorġja fil-Festival tal-Eurovision	Georgiens bidrag i Eurovision Song Contest
FK Sarajevo	FK Sarajevo
Konvenzjoni ta' Vjenna dwar id-Dritt tat-Trattati	Wienkonventionen om traktaträtten
Muniti tal-ewro ta' Malta	Malta och eurosamarbetet
Kampjonati Ewropej tal-Futbol 2008	Europamästerskapet i fotboll 2008
Myrmecobiidae	Myrpungdjur
Papessa Ġovanna	Johanna (påvinna)
Ġwann Marija Vianney	Jean-Marie Vianney
Ottorino Respighi	Ottorino Respighi
Storja ta' Malta	Maltas historia
Marmosa	Dvärgpungråttor
Fenek pigmew	Dvärghare
FC Pyunik	FC Pjunik
Mikrostat	Mikrostat
Vinċenz de Paul	Vincent de Paul
Linfield FC	Linfield FC
Peramelemorphia	Grävlingpungdjur
Anders Lindegaard	Anders Lindegaard
Florentino Pérez	Florentino Pérez
Ċipru fil-Festival tal-Eurovision	Cyperns bidrag i Eurovision Song Contest
Diżugwaljanza ta' Čebyšëv	Tjebysjovs olikhet
Rabat	Rabat (olika betydelser)
Anton Buttigieg	Anton Buttigieg
Kwalifikazzjoni għat-Tazza tad-Dinja tal-Futbol 2010 (UEFA) - Grupp 2	Grupp 2 i kvalspelet till världsmästerskapet i fotboll 2010 (Uefa)
Halloween	Halloween
Kuruna tal-Avvent	Adventsljusstake
FIFA	Fifa
Liebru Etjopjan	Lepus fagani
Liebru tal-altipjan tal-Etjopja	Etiopisk hare
Birżebbuġa	Birżebbuġa
Imblokk Kontinentali	Kontinentalsystemet
Tupaia	Tupaia
Lista ta' pajjiżi skont l-erja	Lista över länder efter yta
Kampjonati Ewropej tal-Futbol	Europamästerskapet i fotboll
FC Wacker Innsbruck (2002)	FC Wacker Innsbruck (2002)
Constant Vanden Stock Stadium	Constant Vanden Stock-stadion
Pangolin ta' denbu twil	Långsvansad myrkott
SV Mattersburg	SV Mattersburg
Jean Parisot de la Valette	Jean Parisot de la Valette
Fażi eliminatorja tal-UEFA Champions League 2012–13	Slutspelet i Uefa Champions League 2012/2013
Wayne Rooney	Wayne Rooney
Kwalifikazzjoni għat-Tazza tad-Dinja tal-Futbol 2010 (UEFA) - Grupp 1	Grupp 1 i kvalspelet till världsmästerskapet i fotboll 2010 (Uefa)
Tim nazzjonali tal-futbol tal-Awstralja	Australiens herrlandslag i fotboll
Finali tat-Tazza tad-Dinja tal-Futbol 2006	Finalen av världsmästerskapet i fotboll 2006
Pangolin Malajan	Malajisk myrkott
Nouvelle Fédération-Board	NF-Board
Alfonsu Marija de Liguori	Alfonso dei Liguori
Bulgarija fil-Festival tal-Eurovision	Bulgariens bidrag i Eurovision Song Contest
Ukraina fil-Festival tal-Eurovision	Ukrainas bidrag i Eurovision Song Contest
Bożnija u Ħerżegovina fil-Festival tal-Eurovision	Bosnien och Hercegovinas bidrag i Eurovision Song Contest
Gwen John	Gwen John
Attakkant	Anfallare (fotboll)
Nihat Kahveci	Nihat Kahveci
Christina Metaxa	Christina Metaxa
Jetty Paerl	Jetty Paerl
Ira Losco	Ira Losco
Ilary Blasi	Ilary Blasi
Olivia Lewis	Olivia Lewis
Nicoleta Matei	Nicoleta Matei
Pika ta' Forrest	Ochotona forresti
Didelphis	Didelphis
Hasse Jeppson	Hasse Jeppson
Morena Camilleri	Morena Camilleri
Oscar Romero	Óscar Romero
Karl Shuker	Karl Shuker
Lisandro López	Lisandro López
Chris Eagles	Chris Eagles
Gianluca Ramazzotti	Gianluca Ramazzotti
Robertu Bellarmino	Roberto Bellarmino
Fenek tax-xmara	Flodkanin
Opossum ta' spallejh suwed	Svartokspungråtta
Fenek ta' Assam	Borstkanin
Salve Reġina	Salve Regina
FK Liepājas Metalurgs	FHK Liepājas Metalurgs
Michael Mifsud	Michael Mifsud
John O'Shea	John O'Shea
Guillermo Stábile	Guillermo Stábile
Massimo Busacca	Massimo Busacca
Ritchie De Laet	Ritchie De Laet
Manucho Gonçalves	Manucho
Diego Cavalieri	Diego Cavalieri
Urby Emanuelson	Urby Emanuelson
Pika ta' Nubra	Ochotona nubrica
Pika ta' Gaoligong	Ochotona gaoligongensis
Liebru tad-deżert	Ökenhare
Cryptonanus	Cryptonanus
Pika ħamra taċ-Ċina	Ochotona erythrotis
Pika ta' Thomas	Ochotona thomasi
Pika sewda	Ochotona nigritia
Gracilinanus	Gracilinanus
Micromurexia	Micromurexia habbema
Pika ta' Tsing-ling	Ochotona huangensis
Pika tal-Ħimalaja	Ochotona himalayana
Paolo Borsellino	Paolo Borsellino
Jô	Jô
Grupp A tat-Tazza tad-Dinja tal-Futbol 2006	Världsmästerskapet i fotboll 2006 (grupp A)
Adem Ljajić	Adem Ljajić
Lucien Laurent	Lucien Laurent
Sebastian Prödl	Sebastian Prödl
Julien Faubert	Julien Faubert
Danny Simpson	Danny Simpson
Ruġġieru I ta' Sqallija	Roger I av Sicilien
Michael Mancienne	Michael Mancienne
Dong Fangzhuo	Dong Fangzhuo
San Ġennaru	Januarius
Carlos Eugênio Simon	Carlos Simon
Frans Sammut	Frans Sammut
Stanislav Šesták	Stanislav Šesták
Franco Di Santo	Franco Di Santo
Luis Monti	Luis Monti
Patrick Müller	Patrick Müller
Bachir Gemayel	Bashir Gemayel
Digão	Digão
Leonardo Sciascia	Leonardo Sciascia
Edward Maya	Edward Maya
Federazzjoni tal-Futbol tal-Andorra	Federació Andorrana de Futbol
Gonzalo Javier Rodríguez	Gonzalo Rodríguez
Tazza tad-Dinja VIVA	Viva World Cup
Serebro	Serebro
Nicolas Douchez	Nicolas Douchez
Kroazja fil-Festival tal-Eurovision	Kroatiens bidrag i Eurovision Song Contest
La Liga	La Liga
Joel Obi	Joel Obi
Premier League Ażerbajġan	Premjer Liqasy
Grupp Ġ tat-Tazza tad-Dinja tal-Futbol 2006	Världsmästerskapet i fotboll 2006 (grupp G)
Grupp Ċ tat-Tazza tad-Dinja tal-Futbol 2006	Världsmästerskapet i fotboll 2006 (grupp C)
Grupp E tat-Tazza tad-Dinja tal-Futbol 2006	Världsmästerskapet i fotboll 2006 (grupp E)
Grupp F tat-Tazza tad-Dinja tal-Futbol 2006	Världsmästerskapet i fotboll 2006 (grupp F)
Grupp D tat-Tazza tad-Dinja tal-Futbol 2006	Världsmästerskapet i fotboll 2006 (grupp D)
Alleati tat-Tieni Gwerra Dinjija	De allierade under andra världskriget
Repubblika Ċeka fil-Festival tal-Eurovision	Tjeckiens bidrag i Eurovision Song Contest
Valletta FC	Valletta FC
Serbja u Montenegro fil-Festival tal-Eurovision	Serbien och Montenegros bidrag i Eurovision Song Contest
Jerzy Grotowski	Jerzy Grotowski
FC Ararat Yerevan	FK Ararat Jerevan
Gustavo Gutiérrez	Gustavo Gutiérrez
Joe Sacco	Joe Sacco
Difensur	Försvarare (fotboll)
Liebru Abissinjan	Abessinsk hare
Eurovision (diżambigwazzjoni)	Eurovision (olika betydelser)
Jores Okore	Jores Okore
Gary Neville	Gary Neville
Johnny Leoni	Johnny Leoni
San Staniżlaw Martri	Stanislaus av Kraków
Emiliano Insúa	Emiliano Insúa
Ritratt ta' Adele Bloch-Bauer I	Porträtt av Adele Bloch-Bauer I
Anthony Mamo	Anthony Mamo
Paul Van Himst	Paul Van Himst
Cercle Brugge KSV	Cercle Brügge KSV
Adolfo Zumelzú	Adolfo Zumelzú
Assedju ta' Malta	Belägringen av Malta
Opossum ta' erba' għajnejn kannella	Brun fyrögonpungråtta
Kwalifikazzjoni għat-Tazza tad-Dinja tal-Futbol 2010 (UEFA) - Grupp 6	Grupp 6 i kvalspelet till världsmästerskapet i fotboll 2010 (Uefa)
Memorial Day	Memorial Day
Bloggosfera	Bloggosfär
Life of Pi	Berättelsen om Pi
Semih Şentürk	Semih Şentürk
Helder Camara	Hélder Câmara
Tupaja tat-Tramuntana	Tupaia belangeri
Dasyurus	Pungmårdar
Mattia De Sciglio	Mattia De Sciglio
San Gejtanu	Gaetano av Thiene
Kurt Calleja	Kurt Calleja
Krassimir Avramov	Krasimir Avramov
Deividas Šemberas	Deividas Šemberas
UEFA Europa League 2012–13	Uefa Europa League 2012/2013
Marsaxlokk FC	Marsaxlokk FC
Servizz Awstrijak barra l-pajjiż	Österreichischer Auslandsdienst
Pangolin Ġgant	Jättemyrkott
Jamāhīriyya	Jamahiriya
Lamantin Afrikan	Senegalmanat
Congratulations (Eurovision)	Congratulations (Eurovision)
Serbja fil-Festival tal-Eurovision	Serbiens bidrag i Eurovision Song Contest
Assoċjazzjoni tal-Futbol Albaniż	Federata Shqiptare e Futbollit
Inga u Anush Arshakyans	Inga & Anush
Lista ta' vulkani fl-Italja	Lista över vulkaner i Italien
Fenek ta' denbu qotni tal-Ingilterra l-Ġdida	Sylvilagus transitionalis
OFC	OFC (olika betydelser)
Liebru xkupa	Lepus castroviejoi
Ungerija fil-Festival tal-Eurovision	Ungerns bidrag i Eurovision Song Contest
Pika tal-fidda	Ochotona argentata
Kwalifikazzjoni għat-Tazza tad-Dinja tal-Futbol 2010 (UEFA) - Grupp 8	Grupp 8 i kvalspelet till världsmästerskapet i fotboll 2010 (Uefa)
Fredrik Stenman	Fredrik Stenman
Hilma af Klint	Hilma af Klint
Owen Hargreaves	Owen Hargreaves
Alternattiva Demokratika	Alternattiva Demokratika
Papa Franġisku	Franciskus (påve)
Roman Kienast	Roman Kienast
Lamantin Amazoniku	Amazonmanat
Preguinho	Preguinho
SV Ried	SV Ried
Petr Elfimov	Pjatro Jalfimau
Frederick Russell Burnham	Frederick Russell Burnham
Guillermo Subiabre	Guillermo Subiabre
Il-Ktieb ta' Mormon	Mormons bok
Youddiph	Youddiph
Eddie Gustafsson	Eddie Gustafsson
Slovakkja fil-Festival tal-Eurovision	Slovakiens bidrag i Eurovision Song Contest
Carlos Peucelle	Carlos Peucelle
Fud Leclerc	Fud Leclerc
Yulia Savicheva	Julija Savitjeva
Mattia Preti	Mattia Preti
It-Twerżiqa	Skriet
Fabrizio Faniello	Fabrizio Faniello
Euarchontoglires	Euarchontoglires
Paramore	Paramore
Pangolin ta' Temminck	Stäppmyrkott
Festival tal-Eurovision taż-Żgħar 2008	Junior Eurovision Song Contest 2008
Coritiba Foot Ball Club	Coritiba Foot Ball Club
Ajruport Internazzjonali ta' Tan Son Nhat	Tan Son Nhat internationella flygplats
L-Uffiċċju tal-Pubblikazzjonijiet tal-Unjoni Ewropea	Europeiska unionens publikationsbyrå
Nani	Nani
Edwin van der Sar	Edwin van der Sar
Paolo Maldini	Paolo Maldini
Loreen	Loreen
Gonzalo Higuaín	Gonzalo Higuaín
Tim nazzjonali tal-futbol tat-Turkija	Turkiets herrlandslag i fotboll
Tim nazzjonali tal-futbol tar-Repubblika Ċeka	Tjeckiens herrlandslag i fotboll
Tomasz Kuszczak	Tomasz Kuszczak
Anderson Luís de Abreu Oliveira	Anderson Luís de Abreu Oliveira
UEFA Champions League 2011–12	Uefa Champions League 2011/2012
Charles Manson	Charles Manson
UEFA Champions League 2012–13	Uefa Champions League 2012/2013
Arda Turan	Arda Turan
Patt tas-Sindki	Borgmästarkonventet
Renault Samsung Motors	Renault Samsung Motors
Galatasaray SK	Galatasaray SK
Tazza tad-Dinja tal-Futbol tal-Klabbs 2005	Världsmästerskapet i fotboll för klubblag 2005
Tazza tad-Dinja tal-Futbol tal-Klabbs 2000	Världsmästerskapet i fotboll för klubblag 2000
Moldova fil-Festival tal-Eurovision	Moldaviens bidrag i Eurovision Song Contest
Latvja fil-Festival tal-Eurovision	Lettlands bidrag i Eurovision Song Contest
Nichi Vendola	Nichi Vendola
Liebru ta' Yarkand	Yarkandhare
Kwalifikazzjoni għat-Tazza tad-Dinja tal-Futbol 2010 (CONMEBOL)	Kvalspelet till världsmästerskapet i fotboll 2010 (CONMEBOL)
KS Bylis Ballsh	KS Bylis Ballsh
Liebru ta' Granada	Lepus granatensis
Eurobandið	Eurobandið
Mircea Rednic	Mircea Rednic
Radja Nainggolan	Radja Nainggolan
Felipe Santana	Felipe Santana
André Maschinot	André Maschinot
Ronaldo	Ronaldo Luís Nazário de Lima
Patrick Ouchène	Patrick Ouchène
Kwalifikazzjoni għall-Kampjonati Ewropej tal-Futbol 2012 - Grupp Ċ	Kvalspelet till Europamästerskapet i fotboll 2012 (grupp C)
Kaká	Kaká
Wied il-Għajn (Marsaskala)	Marsaskala
Pika ta' Ladak	Ochotona ladacensis
Thomas Balvay	Thomas Balvay
Joseph Calleja	Joseph Calleja
Liebru l-ġebel aħmar ta' Smith	Smiths rödkanin
Planigale	Dvärgpungmöss
Liebru l-ġebel aħmar ta' Jameson	Jamesons rödkanin
Rumanija fil-Festival tal-Eurovision	Rumäniens bidrag i Eurovision Song Contest
Mario Evaristo	Mario Evaristo
Manuel Rosas	Manuel Rosas
Marcel Langiller	Marcel Langiller
Fenek tal-istrixxi ta' Annam	Annamitkanin
Finali tal-UEFA Champions League 2013	Finalen av Uefa Champions League 2012/2013
Tupaja ta' Horsfield	Tupaia javanica
Lista tal-kodiċi nazzjonali tal-FIFA	Lista över Fifas landskoder
Dun Karm Psaila	Dun Karm Psaila
Liebru antilop	Västlig antilophare
Liebru sufi	Ullig hare
Tupaja tal-Filippini	Everetts spetsekorre
Senġi tal-buxxveld	Sydvästafrikansk elefantnäbbmus
Tupaja ta' Madras	Indisk spetsekorre
Tupaja komuni	Tupaia glis
Senġi ħamrani	Röd elefantnäbbmus
Fenek tal-art mistgħadra	Kärrkanin
FC Mika	FC Mika
Pika tal-isteppa	Dvärgpiphare
Opossum nanu mistur ta' Rio Grande do Sul	Cryptonanus guahybae
Partit Nazzjonalista (Malta)	Partit Nazzjonalista
Francesco Azzopardi	Francesco Azzopardi
Coccinella	Coccinella
Urugan Felix (2007)	Orkanen Felix
Fenek ta' denbu qotni tad-deżert	Ökenkanin
FC Encamp	FC Encamp
FIFA Puskás Award	Fifa Puskás Award
Nunzjatura Appostolika	Apostolisk nuntiatur
Wikipedija:Abbrevjazzjoni	Wikipedia:Genvägar
Croagh Patrick	Croagh Patrick
Tupaja ta' żaqqu dehebi	Tupaia chrysogaster
UE Sant Julià	UE Sant Julià
The Kite Runner	Flyga drake
Fenek ta' Bunyoro	Centralafrikansk hare
TM-XML	TM-XML
Liebru ta' denbu iswed	Svartsvansad åsnehare
Senġi ta' Kap	Kapelefantnäbbmus
Beerschot AC	KFC Germinal Beerschot
Malta fil-Festival tal-Eurovision	Maltas bidrag i Eurovision Song Contest
Antechinus	Pungspetsekorrar
Tupaja ta' saqajħ twal	Tupaia longipes
Sminthopsis	Sminthopsis
Tupaja l-kbir	Tupaia tana
Alof de Wignacourt	Alof de Wignacourt
Pika ħamra tat-Turkestan	Röd piphare
Japok	Pungutter
Glires	Glires
Cinco de Mayo	Cinco de Mayo
Litwanja fil-Festival tal-Eurovision	Litauens bidrag i Eurovision Song Contest
Liebru ta' Tehuantepec	Tehuantepechare
Robert-Joseph Pothier	Robert-Joseph Pothier
Kwalifikazzjoni għat-Tazza tad-Dinja tal-Futbol 2010 (UEFA) - Grupp 7	Grupp 7 i kvalspelet till världsmästerskapet i fotboll 2010 (Uefa)
Fenek tal-vulkan	Vulkankanin
San Ġiljan (lokalità)	St. Julian's
Ouija Board	Ouija-bräda
Iqbal Masih	Iqbal Masih
San Franġisk t'Assisi	Franciskus av Assisi
Tim nazzjonali tal-futbol tal-Italja	Italiens herrlandslag i fotboll
European Border Breakers Awards	European Border Breakers Awards
Partit Laburista (Malta)	Partit Laburista
Pronolagus	Rödkaniner
Fenek ta' Amami	Amamikanin
Lovebugs	Lovebugs
Kolokolo	Chiloépungråtta
Opossum tal-Patagonja	Patagonisk pungråtta
FK Khazar Lankaran	FK Chazar Lenkoran
FC Admira Wacker Mödling	FC Admira Wacker Mödling
Cartoon Network	Cartoon Network
De facto	De facto
Lista ta' pajjiżi skont il-popolazzjoni	Lista över länder efter folkmängd
Klad	Klad
Kunsilli lokali ta' Malta	Maltas kommuner
Kwalifikazzjoni għall-Kampjonati Ewropej tal-Futbol 2012 - Grupp B	Kvalspelet till Europamästerskapet i fotboll 2012 (grupp B)
Tim nazzjonali tal-futbol tal-Komunità tal-Istati Indipendenti	Oberoende staters samväldes herrlandslag i fotboll
Kwalifikazzjoni għall-Kampjonati Ewropej tal-Futbol 2012 - Grupp A	Kvalspelet till Europamästerskapet i fotboll 2012 (grupp A)
Vadis Odjidja-Ofoe	Vadis Odjidja-Ofoe
Inter Baku PFC	FK Inter Baku
FK Qarabağ	FK Qarabağ
Lierse SK	Lierse SK
Tim nazzjonali tal-futbol tar-Russja	Rysslands herrlandslag i fotboll
Euarchonta	Euarchonta
Kwalifikazzjoni għall-Kampjonati Ewropej tal-Futbol 2012 - Grupp Ħ	Kvalspelet till Europamästerskapet i fotboll 2012 (grupp H)
Lorenzo Staelens	Lorenzo Staelens
Cobh	Cobh
Fażi tal-gruppi tal-UEFA Champions League 2012–13	Gruppspelet i Uefa Champions League 2012/2013
Gintaras Staučė	Gintaras Staučė
Nicolò Isouard	Nicolas Isouard
Kronoloġija tal-matematika	Tidsaxel över matematikens historia
Rhynchocyon	Snabelhundar
Dendrohyrax	Västlig träddasse
Filfla	Filfola
Ħal Tarxien	Tarxien
Tupaja ta' denbu pinna	Ptilocercus lowii
Liebru ta' Kap	Kaphare
Fenek ta' denbu qotni	Bomullssvanskaniner
Kwalifikazzjoni għall-Kampjonati Ewropej tal-Futbol 2012 - Grupp Ġ	Kvalspelet till Europamästerskapet i fotboll 2012 (grupp G)
Fond Soċjali Ewropew	Europeiska socialfonden
Birgu	Birgu
Pangolin tas-siġar	Vitbukig myrkott
Kwalifikazzjoni għall-Kampjonati Ewropej tal-Futbol 2012 - Grupp I	Kvalspelet till Europamästerskapet i fotboll 2012 (grupp I)
Kwalifikazzjoni għall-Kampjonati Ewropej tal-Futbol 2012 - Grupp F	Kvalspelet till Europamästerskapet i fotboll 2012 (grupp F)
Kwalifikazzjoni għall-Kampjonati Ewropej tal-Futbol 2012 - Grupp E	Kvalspelet till Europamästerskapet i fotboll 2012 (grupp E)
Kwalifikazzjoni għall-Kampjonati Ewropej tal-Futbol 2012 - Grupp D	Kvalspelet till Europamästerskapet i fotboll 2012 (grupp D)
Finali tal-Kampjonati Ewropej tal-Futbol 2008	Europamästerskapet i fotboll 2008 (final)
Pangolin Indjan	Indisk myrkott
Axxendent	Ascendent
L-Ewwel Diviżjoni tal-Football League	Football League First Division
FC Banants	Banants Jerevan
Varjetà (botanika)	Varietet (botanik)
It-Tieni Diviżjoni tal-Football League	Football League Second Division
Tupaja tal-muntanji	Tupaia montana
Fenek ta' denbu qotni tal-Lvant	Östlig bomullssvanskanin
Marsaxlokk	Marsaxlokk
Tlacuatzin	Tlacuatzin canescens
President ta' Malta	Maltas president
Birkirkara FC	Birkirkara FC
Trattat ta' Adeżjoni 2003	Anslutningsfördraget 2003
Dendrogale	Slätsvansspetsekorrar
Familja Bernoulli	Bernoulli
Furjana	Floriana (stad)
Grupp B tat-Tazza tad-Dinja tal-Futbol 2006	Världsmästerskapet i fotboll 2006 (grupp B)
Lingwa Awżiljari Internazzjonali	Internationellt hjälpspråk
Ulisses FC	Ulisses Jerevan
Regina (grupp)	Regina (musikgrupp)
Partizani Tirana	KF Partizani
Baħri fuku	Sailor fuku
Raħal Ġdid	Paola, Malta
Libanu fil-Festival tal-Eurovision	Libanons bidrag i Eurovision Song Contest
Liebru ta' Burma	Burmahare
Fenek ta' denbu qotni tal-foresta	Skogskanin
Liebru tal-Alaska	Alaskahare
UEFA Jubilee Awards	UEFA Jubilee Awards
Lemma ta’ Borel-Cantelli	Borel-Cantellis lemma
Transnistrija	Transnistrien
Brian Said	Brian Said
Kwalifikazzjoni għat-Tazza tad-Dinja tal-Futbol 2010 (UEFA) - Grupp 5	Grupp 5 i kvalspelet till världsmästerskapet i fotboll 2010 (Uefa)
Kwalifikazzjoni għat-Tazza tad-Dinja tal-Futbol 2010 (UEFA) - Grupp 3	Grupp 3 i kvalspelet till världsmästerskapet i fotboll 2010 (Uefa)
Nesolagus	Nesolagus
Għajnuna:Kontenut	Wikipedia:Hjälp
Għajnuna:Gwida essenzjali	Wikipedia:Introduktion
Logħob tal-Pajjiżi ż-Żgħar tal-Ewropa	Spelen för små stater i Europa
Pika ta' Turuchan	Ochotona turuchanensis
Kwalifikazzjoni għat-Tazza tad-Dinja tal-Futbol 2010 (UEFA) - Grupp 9	Grupp 9 i kvalspelet till världsmästerskapet i fotboll 2010 (Uefa)
Roberto Gayón	Roberto Gayón
Senġi ta' erbat iswaba	Fyrtåig elefantnäbbmus
Liebru Taljan	Italiensk hare
Liebru ta' denbu abjad	Vitsvansad åsnehare
Pika ta' Moupin	Ochotona thibetana
Tupaja ż-żgħir	Tupaia minor
Hibernians FC	Hibernians FC
Joseph Muscat	Joseph Muscat
Kwalifikazzjoni għat-Tazza tad-Dinja tal-Futbol 2010 (UEFA) - Grupp 4	Grupp 4 i kvalspelet till världsmästerskapet i fotboll 2010 (Uefa)
Malta fil-Festival tal-Eurovision taż-Żgħar	Malta i Junior Eurovision Song Contest
Senġi ta' saqajħ skuri	Mörkbrun elefantnäbbmus
Gipsy.cz	Gipsy.cz
Carmel Busuttil	Carmel Busuttil
Senġi skur	Elephantulus fuscus
Tupaja Kalamjan	Tupaia moellendorffi
Michael Essien	Michael Essien
Senġi ċċangjat	Ruttecknad snabelhund
Ġorġ Borg Olivier	Giorgio Borg Olivier
Ġiljan l-Ospitalier	Julian Hospitator
Melchiorre Gafà	Melchiorre Caffà
FC Red Bull Salzburg	FC Red Bull Salzburg
Liebru tax-xgħari	Klipphare
Opossum ta' denbu sufi	Plymsvanspungråtta
Pika ta' Sardinja	Prolagus sardus
Liebru l-ġebel aħmar ta' Natal	Större rödkanin
Achal Prabhala	Achal Prabhala
Chacodelphys	Chacodelphys formosa
Markapaġna	Bokmärke
Madonna tal-Karmnu	Vår Fru av berget Karmel
Statistika tat-Tazza tad-Dinja tal-Futbol 2010	Statistik över världsmästerskapet i fotboll 2010
Opossum bugeddum ta' mnieħru twil	Chileinkanäbbmus
Liebru Ċiniż	Kinesisk hare
Cynocephalus volans	Filippinsk pälsfladdrare
K. Waterschei SV Thor Genk	K. Waterschei S.V. Thor Genk
Senġi ta' wiċċu griż	Rhynchocyon udzungwensis
Luttu nazzjonali	Landssorg
Apolonia Fier	Apolonia Fier
Senġi ta' widnejh tondi tal-Karù	Kortörad elefantnäbbmus
Liverpool FC	Liverpool FC
Flor-de-Lis	Flor-de-Lis
FIFPro	FIFPro
Pika tat-Tramuntana	Sibirisk piphare
Antechinomys	Mindre australisk punghoppråtta
Malcolm Macdonald	Malcolm Macdonald
Waldo's People	Waldo's People
Plantigrad	Hälgångare
Djalett Grieg-Kalabriż	Kalabrisk grekiska
Subphylum	Understam
Liebru Korean	Koreansk hare
Pika ta' Daurian	Ogotona
Merlin (serje televiżiva)	Merlin (TV-serie)
Tim nazzjonali tal-futbol ta' Malta (nisa)	Maltas damlandslag i fotboll
Wikipedija:Ambaxxata	Wikipedia:Ambassaden
Fenek ta' denbu qotni ta' Dice	Sylvilagus dicei
Lutreolina	Tjocksvansad pungråtta
KS Lushnja	KS Lushnja
Philander	Philander
Sliema Wanderers FC	Sliema Wanderers FC
Liebru ta' Yunnan	Yunnanhare
Caenolestes	Caenolestes
Pika tal-Afganistan	Afghansk piphare
Elephantulus	Elephantulus
Scooch	Scooch
Senġi ta' taħt dahru dehebi	Gulstjärtad snabelhund
Tupaja ta' Nikobar	Tupaia nicobarica
Pangolin ta' Palaw	Manis culionensis
Opossum bugeddum Peruvjan	Peruinkanäbbmus
Shkumbini Peqin	KS Shkumbini
Grawnd Nazzjonali Ta' Qali	Ta’ Qali-stadion
Liebru ta' Hainan	Hainanhare
Liebru ta' Tolai	Lepus tolai
Liebru Ġappuniż	Japansk hare
Pika tax-xofftejn suwed	Ochotona curzoniae
Tazza tad-Dinja VIVA 2008	Viva World Cup 2008
ECHO (Kummissjoni Ewropea)	Generaldirektoratet för humanitärt bistånd och civilskydd
Ravan Baku FC	Ravan Baku
FK Rudar Prijedor	FK Rudar Prijedor
Wikipedija:Glossarju	Wikipedia:Ordlista
Pseudantechinus	Pseudantechinus
Opossum ġurdien ta' denbu oħxon	Thylamys
Kategorija:Ġermanja	Kategori:Tyskland
Kategorija:Italja	Kategori:Italien
Kategorija:Stati Uniti	Kategori:USA
Kategorija:Russja	Kategori:Ryssland
Kategorija:Renju Unit	Kategori:Storbritannien
Kategorija:Spanja	Kategori:Spanien
Kategorija:Indja	Kategori:Indien
Kategorija:Turkija	Kategori:Turkiet
Kategorija:New Zealand	Kategori:Nya Zeeland
Senġi iswed u aħmar	Peters snabelhund
Opossum ta' denbu qasir	Pungnäbbmöss
Phascolosorex	Phascolosorex
It-Tielet Diviżjoni tal-Football League	Football League Third Division
Ian Azzopardi	Ian Azzopardi
Kategorija:Afganistan	Kategori:Afghanistan
Kategorija:Alġerija	Kategori:Algeriet
Kategorija:Awstrija	Kategori:Österrike
Kategorija:Pajjiżi l-Baxxi	Kategori:Nederländerna
Kategorija:Niġerja	Kategori:Nigeria
Kategorija:Polonja	Kategori:Polen
Kategorija:Portugall	Kategori:Portugal
Kategorija:Żvizzera	Kategori:Schweiz
Kategorija:Ukraina	Kategori:Ukraina
Kategorija:Vjetnam	Kategori:Vietnam
Kategorija:Fiżika	Kategori:Fysik
Kategorija:Bijoloġija	Kategori:Biologi
Kategorija:Kimika	Kategori:Kemi
Kategorija:Storja	Kategori:Historia
Kategorija:Ġeografija	Kategori:Geografi
Kategorija:Reliġjon	Kategori:Religion
Kategorija:Sport	Kategori:Sport
Kategorija:Xjenza	Kategori:Vetenskap
Kategorija:Unjoni Ewropea	Kategori:Europeiska unionen
Kategorija:Ċinema	Kategori:Film
Kategorija:Komunikazzjoni	Kategori:Kommunikation
Liebru Indjan	Svartnackad hare
Liebru tal-ġnub bojod	Östlig antilophare
Liebru Manċurjan	Manchurisk hare
Dasycercus	Mulgara
Opossum sufi	Ullpungråttor
Myoictis	Myoictis
Premier League 2011–12	Premier League 2011/2012
Fenek xkupilja	Buskkanin
Marco Ureña	Marco Ureña
Paramurexia	Paramurexia rothschildi
Grupp	Grupp
Fenek ta' denbu qotni tal-Messiku	Mexikansk bomullssvanskanin
Liebru tas-savana Afrikana	Savannhare
Joseph Calleia	Joseph Calleia
Fenek ta' denbu qotni ta' Omiltemi	Omiltemekanin
Kategorija:Mietu fl-2012	Kategori:Avlidna 2012
Partit Nazzjonalista	Nationalistpartiet
Juvenes Translatores	Juvenes Translatores
Kevin Borg	Kevin Borg
Phascogale	Phascogale
Ningaui	Ningaui
Marmosops	Marmosops
Mudell:Portal tmiem	Mall:Box-footer
Senġi tal-blat tal-Punent	Västlig elefantnäbbmus
Tupaja ta' Palaw	Tupaia palawanensis
Pika ta' Glover	Ochotona gloveri
Fenek tat-Tres Marias	Tres Marias-kanin
Pika ta' Royle	Himalayapiphare
Tupaja rqiq	Tupaia gracilis
Tupaja mpitter	Tupaia picta
Senġi tas-Somalja	Elephantulus revoili
Pika ta' Pallas	Mongolisk piphare
Tupaja ta' denbu lixx tat-Tramuntana	Nordlig slätsvansspetsekorre
Tupaja ta' denbu lixx ta' Borneo	Sydlig slätsvansspetsekorre
Senġi ta' wiċċu qasir	Kortnosad elefantnäbbmus
Senġi tal-blat tal-Lvant	Östlig klippelefantnäbbmus
Pika ta' Hoffmann	Ochotona hoffmanni
Pika ta' Gansu	Ochotona cansus
Tupaja ħamrani	Tupaia splendidula
Fenek xkupilja ta' San Jose	San José-kanin
Tupaja strixxat	Tupaia dorsalis
Pika tal-widnejn kbar	Storörad piphare
Senġi tal-Afrika ta' Fuq	Nordafrikansk elefantnäbbmus
Ħin tal-Afrika tal-Lvant	Östafrikansk tid
Nicklas Helenius	Nicklas Helenius
Aleksandar Tonev	Aleksandar Tonev
Kategorija:Ekoloġija	Kategori:Ekologi
Kategorija:Diżambigwazzjoni	Kategori:Förgreningssidor
Kategorija:Olimpjadi	Kategori:Olympiska spelen
Kategorija:Filosofija	Kategori:Filosofi
Kategorija:Psikoloġija	Kategori:Psykologi
Kategorija:Buddiżmu	Kategori:Buddhism
Kategorija:Kristjaneżmu	Kategori:Kristendom
Kategorija:Induiżmu	Kategori:Hinduism
Kategorija:Iżlam	Kategori:Islam
Kategorija:Ġudaiżmu	Kategori:Judendom
Oġġett	Objekt
Opossum nanu mistur tal-Bolivja	Cryptonanus unduaviensis
Ronaldo (diżambigwazzjoni)	Ronaldo (olika betydelser)
Michy Batshuayi	Michy Batshuayi
Malta fil-Festival tal-Eurovision 2013	Malta i Eurovision Song Contest 2013
Bochotnica	Bochotnica
Stat Iżlamiku	Islamiska staten
Benedicta Boccoli	Benedicta Boccoli
Opossum nanu mistur ta' Chacoan	Cryptonanus chacoensis
Opossum ġurdien sufi	Micoureus
Għoti tal-penalties	Straffsparksläggning
Antonio Luna Rodríguez	Antonio Luna
Kategorija:Abbozzi	Kategori:Stubbar
Kategorija:Pjaneti	Kategori:Planeter
Kategorija:Abbozzi tal-mużika	Kategori:Musikstubbar
Kategorija:Abbozzi tal-kultura	Kategori:Kulturstubbar
Kategorija:Kultura	Kategori:Kultur
Kategorija:Snin	Kategori:Årtal
Kategorija:Xjenzi soċjali	Kategori:Humaniora
Kategorija:Kontinenti	Kategori:Världsdelar
Claudia Faniello	Claudia Faniello
12 Years a Slave	12 Years a Slave
Għajnuna:Gwida essenzjali/Editjar	Wikipedia:Introduktion till redigering
Mudell:SistemaSolari	Mall:Solsystemet
Wikipedija:Konvenzjonijiet ta' nomenklatura	Wikipedia:Artikelnamn
Opossum ta' denbu qasir tal-Perù	Monodelphis ronaldi
Opossum ta' denbu qasir ta' Reig	Monodelphis reigi
Galatasaray A2	Galatasaray A2
Tuneżija fil-Festival tal-Eurovision	Tunisiens bidrag i Eurovision Song Contest
Għajnuna:Wikiketta	Wikipedia:Etikett
Kategorija:Bots tal-Wikipedija	Kategori:Wikipedia:Robotar
Parteċipazzjoni fil-Festival tal-Eurovision	Länder som deltagit i Eurovision Song Contest
Mudell:Kwota	Mall:Citat
Kategorija:Nies Taljani	Kategori:Italienare
Kategorija:Mużiċisti Amerikani	Kategori:Amerikanska musiker
Kategorija:Futbolers Ġermaniżi	Kategori:Tyska fotbollsspelare
Mudell:Tl	Mall:Mall
Mudell:Kaxxa tal-utent	Mall:Användarbox
Sergio Mattarella	Sergio Mattarella
Kategorija:Pajjiżi	Kategori:Världens länder
Wikipedija:Amministraturi	Wikipedia:Administratörer
Kategorija:Każakistan	Kategori:Kazakstan
Wikipedija:Amministraturi/Kandidati	Wikipedia:Ansökan om administrativ behörighet
Kategorija:Kategoriji skont in-nazzjonalità	Kategori:Kategorier efter nationalitet
Wikipedija:Bot	Wikipedia:Robotar
Kategorija:Kategoriji moħbija	Kategori:Dolda kategorier
Kategorija:Internet	Kategori:Internet
Kategorija:Botanika	Kategori:Botanik
Kategorija:Politika	Kategori:Politik
Kategorija:Arti	Kategori:Konst
Eġittu	Egypten
Kategorija:2013	Kategori:2013
Mudell:Bot	Mall:Bot
Kanada	Kanada
Kategorija:Ungerija	Kategori:Ungern
Kategorija:Stati membri tal-Unjoni Ewropea	Kategori:Europeiska unionens medlemsstater
Kategorija:Belġju	Kategori:Belgien
Kategorija:Ċekja	Kategori:Tjeckien
Kategorija:Danimarka	Kategori:Danmark
Kategorija:Estonja	Kategori:Estland
Kategorija:Finlandja	Kategori:Finland
Kategorija:Latvja	Kategori:Lettland
Kategorija:Iżlanda	Kategori:Island
Kategorija:Litwanja	Kategori:Litauen
Kategorija:Malta	Kategori:Malta
Kategorija:Żvezja	Kategori:Sverige
Kategorija:Slovakkja	Kategori:Slovakien
Kategorija:Slovenja	Kategori:Slovenien
Kategorija:Repubblika tal-Irlanda	Kategori:Irland
Kategorija:Artikli fil-vetrina	Kategori:Wikipedia:Utmärkta artiklar
Kategorija:Logħob elettroniku	Kategori:Datorspel
Wikipedija:Bot/Rikjesti	Wikipedia:Robothjälp
Mudell:Flagicon	Mall:Flaggbild
Kategorija:Pajjiżi tal-Ewropa	Kategori:Europas länder
Kategorija:Ewropa	Kategori:Europa
Kategorija:Għajnuna	Kategori:Wikipedia:Hjälp
Mudell:Dokumentazzjoni	Mall:Dokumentation
Wikipedija:Bot/Rikjesti għall-approvazzjoni	Wikipedia:Robotansökan
Kategorija:Paġni protetti	Kategori:Wikipedia:Skrivskydd
Wikipedija:Politika dwar il-protezzjoni	Wikipedia:Skrivskydd
Kategorija:Paġni semi-protetti	Kategori:Halvlåsta sidor
Kategorija:Wikipedjani	Kategori:Wikipedia:Användare
Wikipedija:Kunsens	Wikipedia:Konsensus
Wikipedija:L-ebda attakk personali	Wikipedia:Inga personangrepp
Wikipedija:Kuntatt	Wikipedia:Kontakt
Kategorija:Utenti skont il-lingwa	Kategori:Användare efter språk
Kategorija:Politiki tal-Wikipedija	Kategori:Wikipedia:Policy
Wikipedija:Sondaġġi	Wikipedia:Aktuella omröstningar och enkäter
Wikipedija:Firem	Wikipedia:Signera diskussionsinlägg
Wikipedija:Abbozz	Wikipedia:Stubbar
Wikipedija:Artikli rikjesti	Wikipedia:Önskelista
Mudell:Softredirect	Mall:Mjuk omdirigering
Mudell:Ħassar minnufih	Mall:Radera
Kategorija:Teknoloġija	Kategori:Teknologi
Kategorija:Lingwa	Kategori:Språk
Għajnuna:Kif tibda artiklu	Wikipedia:Skriv en ny artikel
Kategorija:Wikipedija	Kategori:Wikipedia
Kanċillier tal-Ġermanja	Tysklands förbundskansler
Wikipedija:Ċaħda ġenerali	Wikipedia:Allmänt förbehåll
Kategorija:Paġni mhux indiċizzati	Kategori:Icke-indexerade sidor
Wikipedija:Mudelli kollha	Wikipedia:Meddelandemall
Kategorija:Avvenimenti kurrenti	Kategori:Pågående
Wikipedija:Manwal tal-istil	Wikipedia:Stilguide
Mudell:Navbox	Mall:Navbox
Mudell:Abbrevjazzjoni	Mall:Genväg
Kategorija:Żoni tal-ħin	Kategori:Tidszoner
Galeopterus variegatus	Malajisk pälsfladdrare
Eżametru dattiliku	Daktylisk hexameter
Kategorija:Nies ħajjin	Kategori:Levande personer
Festival tal-Eurovision 2014	Eurovision Song Contest 2014
Mudell:!	Mall:!
Kategorija:Mudelli ta' bnadar	Kategori:Flaggmallar
Mudell:!-	Mall:!-
Mudell:!!	Mall:!!
Mudell:=	Mall:=
Mudell:Tnavbar	Mall:Navbar
Mudell:Ċiklu	Mall:Loop
Kategorija:Mudelli ta' formattjar	Kategori:Formaterings- och funktionsmallar
Mudell:Clear	Mall:Clear
Mudell:Col-break	Mall:Col-break
Mudell:Col-begin	Mall:Col-begin
Mudell:Col-end	Mall:Col-end
Il-Portal tad-Dejta Miftuħa tal-UE	EUs portal för öppna data
Mudell:Deskrizzjoni kmand	Mall:Tooltip
Wikipedija:Lista ta' artikli li kull Wikipedija għandu jkollha	Wikipedia:Artiklar som bör finnas på Wikipedia
Kategorija:Afrika	Kategori:Afrika
Kategorija:Elettronika	Kategori:Elektronik
Kategorija:Xhur tas-sena	Kategori:Månader
Mudell:Wikisors	Mall:Wikisource
Mudell:Babel	Mall:Babel
Mudell:Commons	Mall:Commons
Mudell:Link GA	Mall:Link GA
Kategorija:Avvenimenti sportivi kurrenti	Kategori:Pågående sportevenemang
Opossum ta' denbu qasir ta' strixxa waħda	Monodelphis unistriata
Għajnuna:Esplora lill-Wikipedija	Wikipedia:Sökning
Mudell:Pajjiżi tal-Commonwealth	Mall:Samväldet
Mudell:Stub	Mall:Stub
Mudell:Utent ar-1	Mall:Användare ar-1
Mudell:Utent az	Mall:Användare az
Mudell:Utent be-2	Mall:Användare be-2
Mudell:Utent da-1	Mall:Användare da-1
Mudell:Utent bg-1	Mall:Användare bg-1
Mudell:Utent eo-3	Mall:Användare eo-3
Mudell:Utent de	Mall:Användare de
Mudell:Utent de-1	Mall:Användare de-1
Mudell:Utent el	Mall:Användare el
Mudell:Utent es	Mall:Användare es
Mudell:Utent de-3	Mall:Användare de-3
Mudell:Utent en-3	Mall:Användare en-3
Mudell:Utent en-1	Mall:Användare en-1
Mudell:Utent en-2	Mall:Användare en-2
Mudell:Utent en-4	Mall:Användare en-4
Mudell:Utent en-0	Mall:Användare en-0
Mudell:Utent en	Mall:Användare en
Mudell:Utent de-2	Mall:Användare de-2
Mudell:Utent es-1	Mall:Användare es-1
Mudell:Utent fa	Mall:Användare fa
Mudell:Utent fr-1	Mall:Användare fr-1
Mudell:Utent ia-2	Mall:Användare ia-2
Mudell:Utent it-3	Mall:Användare it-3
Mudell:Utent grc-1	Mall:Användare grc-1
Mudell:Utent ja-4	Mall:Användare ja-4
Mudell:Utent sk	Mall:Användare sk
Mudell:Utent tr-2	Mall:Användare tr-2
Mudell:Utent fr-2	Mall:Användare fr-2
Mudell:Utent ja	Mall:Användare ja
Mudell:Utent it-1	Mall:Användare it-1
Mudell:Utent fr	Mall:Användare fr
Mudell:Ebda firma	Mall:Signatur
Mudell:Pl	Mall:Pl ikon
Kategorija:Turiżmu	Kategori:Turism
Kategorija:1957	Kategori:1957
Kategorija:1949	Kategori:1949
Kategorija:1927	Kategori:1927
Kategorija:1919	Kategori:1919
Mudell:Dati pajjiż Taġikistan	Mall:Landsdata Tadzjikistan
Kategorija:Moldova	Kategori:Moldavien
Kategorija:Ażerbajġan	Kategori:Azerbajdzjan
Kategorija:Asja	Kategori:Asien
Kategorija:Ċili	Kategori:Chile
Kategorija:Seklu 21	Kategori:2000-talet
Kategorija:Mudelli ta' servizz	Kategori:Åtgärdsmallar
Kategorija:Utenti uk	Kategori:Användare uk
Kategorija:1930	Kategori:1930
Kategorija:Utenti uk-N	Kategori:Användare uk-N
Kategorija:1936	Kategori:1936
Kategorija:1947	Kategori:1947
Mudell:Mudell ikkumplikat	Mall:Komplicerad kod
Kategorija:1937	Kategori:1937
Kategorija:1940	Kategori:1940
Kategorija:1934	Kategori:1934
Kategorija:1960	Kategori:1960
Kategorija:1943	Kategori:1943
Kategorija:1951	Kategori:1951
Mudell:Tim tal-futbol	Mall:Truppmall
Kategorija:1942	Kategori:1942
Kategorija:1959	Kategori:1959
Kategorija:1938	Kategori:1938
Kategorija:1928	Kategori:1928
Kategorija:1913	Kategori:1913
Kategorija:1918	Kategori:1918
Kategorija:1954	Kategori:1954
Kategorija:1941	Kategori:1941
Kategorija:1955	Kategori:1955
Kategorija:1950	Kategori:1950
Kategorija:1921	Kategori:1921
Kategorija:1977	Kategori:1977
Kategorija:1946	Kategori:1946
Kategorija:1948	Kategori:1948
Kategorija:1932	Kategori:1932
Kategorija:Futbol	Kategori:Fotboll
Kategorija:1945	Kategori:1945
Mudell:Dati pajjiż Kuwajt	Mall:Landsdata Kuwait
Mudell:Mod	Mall:Mod
Kategorija:1923	Kategori:1923
Kategorija:1935	Kategori:1935
Kategorija:1910	Kategori:1910
Kategorija:1917	Kategori:1917
Kategorija:1904	Kategori:1904
Kategorija:1926	Kategori:1926
Kategorija:1907	Kategori:1907
Kategorija:1914	Kategori:1914
Mudell:Utent sv	Mall:Användare sv
Kategorija:1929	Kategori:1929
Kategorija:1920	Kategori:1920
Mudell:Utent it	Mall:Användare it
Kategorija:1925	Kategori:1925
Mudell:Utent uk	Mall:Användare uk
Kategorija:1905	Kategori:1905
Kategorija:1915	Kategori:1915
Mudell:Utent es-2	Mall:Användare es-2
Kategorija:1908	Kategori:1908
Kategorija:Mudelli ta' avviż	Kategori:Mallar för problematiska användare
Kategorija:1901	Kategori:1901
Kategorija:1903	Kategori:1903
Kategorija:1902	Kategori:1902
Kategorija:1900	Kategori:1900
Mudell:Ru	Mall:Ru ikon
Mudell:PaġnaPrinċipali/Proġetti	Mall:Wikipediasystrar
Kategorija:1933	Kategori:1933
Mudell:Dati pajjiż Belġju	Mall:Landsdata Belgien
Kategorija:1912	Kategori:1912
Kategorija:Klabbs tal-futbol Ingliżi	Kategori:Fotbollsklubbar i England
Mudell:Dati pajjiż Slovakkja	Mall:Landsdata Slovakien
Kategorija:Mudelli tal-koordinati	Kategori:Koordinatmallar
Kategorija:Klabbs tal-futbol Spanjoli	Kategori:Fotbollsklubbar i Spanien
Mudell:Dati pajjiż El Salvador	Mall:Landsdata El Salvador
Mudell:Dati pajjiż Panama	Mall:Landsdata Panama
Kategorija:1952	Kategori:1952
Mudell:Premier League	Mall:Premier League
Mudell:Dati pajjiż Ekwador	Mall:Landsdata Ecuador
Mudell:Dati pajjiż Etjopja	Mall:Landsdata Etiopien
Mudell:Dati pajjiż Tuneżija	Mall:Landsdata Tunisien
Mudell:Dati pajjiż Repubblika Ċeka	Mall:Landsdata Tjeckien
Mudell:Dati pajjiż Tajlandja	Mall:Landsdata Thailand
Mudell:Dati pajjiż Kuba	Mall:Landsdata Kuba
Mudell:Dati pajjiż Indoneżja	Mall:Landsdata Indonesien
Mudell:Dati pajjiż Kambodja	Mall:Landsdata Kambodja
Mudell:Dati pajjiż Senegal	Mall:Landsdata Senegal
Mudell:Dati pajjiż Madagaskar	Mall:Landsdata Madagaskar
Mudell:Dati pajjiż Albanija	Mall:Landsdata Albanien
Mudell:Dati pajjiż Perù	Mall:Landsdata Peru
Mudell:Dati pajjiż Paragwaj	Mall:Landsdata Paraguay
Mudell:Dati pajjiż Makaw	Mall:Landsdata Macao
Mudell:Dati pajjiż Kenja	Mall:Landsdata Kenya
Mudell:Dati pajjiż San Marino	Mall:Landsdata San Marino
Mudell:Dati pajjiż Nikaragwa	Mall:Landsdata Nicaragua
Mudell:Dati pajjiż Ħonduras	Mall:Landsdata Honduras
Mudell:Dati pajjiż Użbekistan	Mall:Landsdata Uzbekistan
Mudell:Dati pajjiż Bolivja	Mall:Landsdata Bolivia
Mudell:Dati pajjiż Repubblika Dominikana	Mall:Landsdata Dominikanska republiken
Mudell:Dati pajjiż Liechtenstein	Mall:Landsdata Liechtenstein
Mudell:Dati pajjiż Togo	Mall:Landsdata Togo
Mudell:Dati pajjiż Gwatemala	Mall:Landsdata Guatemala
Kategorija:Klabbs tal-futbol Ġermaniżi	Kategori:Fotbollsklubbar i Tyskland
Kategorija:Lingwistika	Kategori:Lingvistik
Mudell:Dati pajjiż Ħaiti	Mall:Landsdata Haiti
Mudell:Dati pajjiż Mali	Mall:Landsdata Mali
Mudell:Dati pajjiż Latvja	Mall:Landsdata Lettland
Mudell:Football kit	Mall:Fotbollkit
Mudell:Dati pajjiż Malta	Mall:Landsdata Malta
Mudell:Dati pajjiż Monako	Mall:Landsdata Monaco
Mudell:Dati pajjiż Danimarka	Mall:Landsdata Danmark
Mudell:Dati pajjiż Iżlanda	Mall:Landsdata Island
Mudell:Dati pajjiż Polonja	Mall:Landsdata Polen
Kategorija:1911	Kategori:1911
Kategorija:1922	Kategori:1922
Kategorija:1924	Kategori:1924
Mudell:Dati pajjiż Bulgarija	Mall:Landsdata Bulgarien
Kategorija:1906	Kategori:1906
Mudell:Dati pajjiż Bosnja-Ħerzegovina	Mall:Landsdata Bosnien och Hercegovina
Kategorija:Klabbs tal-futbol	Kategori:Fotbollsklubbar
Mudell:Dati pajjiż Gujana	Mall:Landsdata Guyana
Kategorija:Mudelli tal-futbol	Kategori:Fotbollsmallar
Kategorija:Utenti fr-1	Kategori:Användare fr-1
Mudell:Dati pajjiż Norveġja	Mall:Landsdata Norge
Mudell:Dati pajjiż Afrika t'Isfel	Mall:Landsdata Sydafrika
Mudell:Dati pajjiż Ġamajka	Mall:Landsdata Jamaica
Mudell:Dati pajjiż Ġeorġja	Mall:Landsdata Georgien
Mudell:Dati pajjiż Arġentina	Mall:Landsdata Argentina
Mudell:Dati pajjiż Urugwaj	Mall:Landsdata Uruguay
Mudell:Wikiquote	Mall:Wikiquote
Mudell:Dati pajjiż Trinidad u Tobago	Mall:Landsdata Trinidad och Tobago
Kategorija:Innijiet Nazzjonali	Kategori:Nationalsånger
Mudell:Dati pajjiż Brunej	Mall:Landsdata Brunei
Mudell:Dati pajjiż Sri Lanka	Mall:Landsdata Sri Lanka
Mudell:Dati pajjiż Messiku	Mall:Landsdata Mexiko
Mudell:Dati pajjiż Greċja	Mall:Landsdata Grekland
Mudell:Dati pajjiż Lussemburgu	Mall:Landsdata Luxemburg
Mudell:Dati pajjiż Arabja Sawdija	Mall:Landsdata Saudiarabien
Mudell:Dati pajjiż Baħamas	Mall:Landsdata Bahamas
Mudell:Dati pajjiż Kroazja	Mall:Landsdata Kroatien
Mudell:Afrika	Mall:Afrika
Mudell:Dati pajjiż Emirati Għarab Magħquda	Mall:Landsdata Förenade Arabemiraten
Mudell:Wikimedia	Mall:Wikimedia Foundation
Mudell:Infobox artist mużikali	Mall:Infobox musiker
Mudell:Dati pajjiż Gżejjer Verġni Amerikani	Mall:Landsdata Amerikanska Jungfruöarna
Mudell:Dati pajjiż Marokk	Mall:Landsdata Marocko
Mudell:Dati pajjiż Serbja	Mall:Landsdata Serbien
Mudell:Dati pajjiż Awstralja	Mall:Landsdata Australien
Mudell:WIP	Mall:Pågår
Mudell:Es	Mall:Es ikon
Mudell:Dati pajjiż Franza	Mall:Landsdata Frankrike
Mudell:Ambox	Mall:Ambox
Mudell:Għall-aġġornament	Mall:Inaktuell
Mudell:Cs	Mall:Cs ikon
Mudell:Infobox Pajjiż	Mall:Landsfakta
Mudell:Mas	Mall:Högsta
Mudell:Dati pajjiż Laos	Mall:Landsdata Laos
Mudell:Fi	Mall:Fi ikon
Mudell:Stampa kbira	Mall:Panorama
Mudell:Dati pajjiż Awstrija	Mall:Landsdata Österrike
Mudell:Dati pajjiż Nepal	Mall:Landsdata Nepal
Mudell:Sar	Mall:Utfört
Mudell:Dati pajjiż Finlandja	Mall:Landsdata Finland
Mudell:Awdjo	Mall:Audio
Mudell:Dati pajjiż Eġittu	Mall:Landsdata Egypten
Mudell:Dati pajjiż Litwanja	Mall:Landsdata Litauen
Mudell:Dati pajjiż Ġappun	Mall:Landsdata Japan
Mudell:Sezzjoni-stub	Mall:Stubavsnitt
Mudell:Navbox with columns	Mall:Navbox with columns
Mudell:Biżestili	Mall:Omskottår
Mudell:Klassifikazzjoni Tassonomika Obligatorja	Mall:Taxonomisk rang
Mudell:Politika	Mall:Policy
Mudell:Facebook	Mall:Facebook-konto
Mudell:Dati pajjiż Ażerbajġan	Mall:Landsdata Azerbajdzjan
Mudell:Dati pajjiż Ċekoslovakkja	Mall:Landsdata Tjeckoslovakien
Mudell:Dati pajjiż Vjetnam	Mall:Landsdata Vietnam
Mudell:Vetrina	Mall:Utmärkt
Mudell:Dati pajjiż Libja	Mall:Landsdata Libyen
Mudell:Dati pajjiż Russja	Mall:Landsdata Ryssland
Mudell:Portal bidu	Portal:Box-header
Kategorija:Utenti en-4	Kategori:Användare en-4
Kategorija:Utenti en	Kategori:Användare en
Kategorija:Utenti zh	Kategori:Användare zh
Kategorija:Kroazja	Kategori:Kroatien
Kategorija:Utenti zh-N	Kategori:Användare zh-N
Kategorija:Utenti en-2	Kategori:Användare en-2
Mudell:TOCright	Mall:TOChöger
Kategorija:Mietu fl-1902	Kategori:Avlidna 1902
Mudell:Skwadra Ġermaniża Tazza tad-Dinja tal-Futbol 2002	Mall:Tysklands trupp i VM i fotboll 2002
Mudell:Utent zh	Mall:Användare zh
Mudell:Infobox Tim nazzjonali tal-futbol	Mall:Fotbollslandslag
Mudell:Leġenda	Mall:Legend
Mudell:Ċita web	Mall:Webbref
Mudell:Dati pajjiż Italja	Mall:Landsdata Italien
Vojvodja	Vojvodskap
Kategorija:Unuri tal-futbol	Kategori:Fotbollspriser
Mudell:Dati pajjiż	Mall:Landsdata
Mudell:Futbol internazzjonali	Mall:Internationell fotboll
Kategorija:Kċina	Kategori:Mat och dryck
Mudell:Coor URL	Mall:Coor URL
Mudell:Min	Mall:Lägsta
Mudell:Subon	Mall:Inbytt
Mudell:Wikizzjunarju	Mall:Wiktionary
Mudell:Utent nl-2	Mall:Användare nl-2
Mudell:Dati pajjiż Żvezja	Mall:Landsdata Sverige
Mudell:Bar box	Mall:Stapeldiagram
Mudell:Languageicon	Mall:Språkikon
Kategorija:Agrikoltura	Kategori:Jordbruk
Kategorija:Utenti hi	Kategori:Användare hi
Mudell:Golden goal	Mall:Golden goal
Kategorija:Seklu 20	Kategori:1900-talet
Kategorija:Politiċi	Kategori:Politiker
Kategorija:Amerika	Kategori:Amerika
Mudell:Użioħra	Mall:Olika betydelser
Mudell:Dati pajjiż Kosta Rika	Mall:Landsdata Costa Rica
Mudell:Dati pajjiż Unjoni Sovjetika	Mall:Landsdata Sovjetunionen
Mudell:Dati pajjiż Indja	Mall:Landsdata Indien
Kategorija:Pangolin	Kategori:Myrkottar
Kategorija:Mudelli tal-lingwi tal-utenti	Kategori:Babelmallar
Kategorija:Bliet tal-Marokk	Kategori:Orter i Marocko
Mudell:Data tat-twelid u età	Mall:Ålder
Mudell:Dati pajjiż Alġerija	Mall:Landsdata Algeriet
Mudell:Clade	Mall:Klad
Mudell:ISEMXAHAR	Mall:MÅNADSNAMN
Mudell:Rindirizzament kategorija	Mall:Kategoriomdirigering
Mudell:Dati pajjiż Veneżwela	Mall:Landsdata Venezuela
Mudell:Infobox Kariga pubblika	Mall:Infobox politiker
Mudell:Proġetti oħra	Mall:Systerlänkar
Mudell:Sortname	Mall:Sortname
Mudell:Dati pajjiż Andorra	Mall:Landsdata Andorra
Mudell:Dati pajjiż Angola	Mall:Landsdata Angola
Mudell:Dati pajjiż Botswana	Mall:Landsdata Botswana
Mudell:Dati pajjiż Unjoni Ewropea	Mall:Landsdata Europeiska unionen
Mudell:Dati pajjiż Portugall	Mall:Landsdata Portugal
Mudell:Data tal-mewt u età	Mall:Död datum och ålder
Kategorija:Twieldu fl-1879	Kategori:Födda 1879
Kategorija:Abbozzi ta' bijografiji	Kategori:Personstubbar
Mudell:Sport fil-futur	Mall:Framtida sport
Mudell:Dati pajjiż Belt tal-Vatikan	Mall:Landsdata Vatikanstaten
Kategorija:Twieldu fl-1955	Kategori:Födda 1955
Kategorija:Twieldu fl-1963	Kategori:Födda 1963
Kategorija:Mudelli ta' dati tal-pajjiżi	Kategori:Landsdatamallar
Kategorija:Twieldu fl-1817	Kategori:Födda 1817
Kategorija:Twieldu fl-1998	Kategori:Födda 1998
Mudell:Dati pajjiż Ċina	Mall:Landsdata Kina
Mudell:Dati pajjiż Benin	Mall:Landsdata Benin
Mudell:Wikifikazzjoni	Mall:Ickewiki
Mudell:Dati pajjiż Ingilterra	Mall:Landsdata Kungariket England
Kategorija:Seklu 19	Kategori:1800-talet
Mudell:Dati pajjiż Repubblika tal-Irlanda	Mall:Landsdata Republiken Irland
Mudell:Dati pajjiż Turkija	Mall:Landsdata Turkiet
Kategorija:Kittieba	Kategori:Författare
Mudell:Yel	Mall:Gultkort
Mudell:Dati pajjiż Ċipru	Mall:Landsdata Cypern
Mudell:Dati pajjiż Żvizzera	Mall:Landsdata Schweiz
Mudell:Dati pajjiż Filippini	Mall:Landsdata Filippinerna
Mudell:Dati pajjiż Niġerja	Mall:Landsdata Nigeria
Mudell:Dati pajjiż Belarus	Mall:Landsdata Vitryssland
Mudell:Dati pajjiż Malażja	Mall:Landsdata Malaysia
Mudell:Dati pajjiż Armenja	Mall:Landsdata Armenien
Mudell:Dati pajjiż Żimbabwe	Mall:Landsdata Zimbabwe
Mudell:Dati pajjiż Timor tal-Lvant	Mall:Landsdata Östtimor
Mudell:Tim ta' AC Milan	Mall:AC Milan trupp
Mudell:Dati pajjiż Tajwan	Mall:Landsdata Taiwan
Mudell:Dati pajjiż Vjetnam t'Isfel	Mall:Landsdata Sydvietnam
Mudell:Dati pajjiż Każakistan	Mall:Landsdata Kazakstan
Mudell:Dati pajjiż Ċili	Mall:Landsdata Chile
Mudell:Dati pajjiż Slovenja	Mall:Landsdata Slovenien
Mudell:Dati pajjiż Libanu	Mall:Landsdata Libanon
Mudell:Dati pajjiż Tajpej Ċiniżi	Mall:Landsdata Kina-Taipei
Mudell:Dati pajjiż Butan	Mall:Landsdata Bhutan
Kategorija:1931	Kategori:1931
Kategorija:1958	Kategori:1958
Kategorija:1956	Kategori:1956
Kategorija:1944	Kategori:1944
Kategorija:Jiem ta' Jannar	Kategori:Januari
Kategorija:1916	Kategori:1916
Kategorija:1939	Kategori:1939
Mudell:Tavla Perjodika kumpatta	Mall:Periodiska systemet navbox
Kategorija:1909	Kategori:1909
Kategorija:Klabbs tal-futbol Taljani	Kategori:Fotbollsklubbar i Italien
Mudell:Tazza tad-Dinja tal-Futbol tal-Klabbs	Mall:Världsmästerskapet i fotboll för klubblag
Kategorija:Mietu fl-1221	Kategori:Avlidna 1221
Mudell:Utent no-2	Mall:Användare no-2
Mudell:Kategorijamoħbija	Mall:Dold kategori
Mudell:Klassifika tal-futbol	Mall:Fb cl team
Mudell:Dokumentazzjoni mudell	Mall:Dokumentationssida
Mudell:Bundesliga	Mall:1.Bundesliga
Mudell:CcTLD	Mall:Toppdomäner
Mudell:Div col	Mall:Kolumner
Mudell:Klassifikazzjoni	Mall:Betygssättning
Kategorija:Notoryctemorphia	Kategori:Notoryctemorphia
Kategorija:Pittura	Kategori:Måleri
Mudell:Div col end	Mall:Kolumner-slut
Mudell:Goal	Mall:Mål
Mudell:Paġna utent	Mall:Wikipediaanvändare
Kategorija:UEFA Europa League	Kategori:UEFA-cupen
Mudell:Infobox Album	Mall:Album infobox
Mudell:Utent	Mall:Anv-data
Kategorija:Ajruporti fil-Vjetnam	Kategori:Flygplatser i Vietnam
Mudell:Logħba futbol	Mall:Resultat
Mudell:Emerġenza-buttuna-tifi	Mall:Nödstopp för robot
Mudell:Imdb	Mall:IMDb-namn
Kategorija:Tuneżija	Kategori:Tunisien
Mudell:It	Mall:It ikon
Mudell:Infobox Stadju	Mall:Arena
Mudell:Wikibarijiet	Mall:Wikinews
Mudell:Cmbox	Mall:Cmbox
Mudell:Rindirizz	Mall:Omdirigering
Mudell:TwoLegStart	Mall:TwoLeg start
Mudell:Pajjiżi fil-Logħob Olimpiku tas-Sajf 2008	Mall:Deltagande nationer i olympiska sommarspelen 2008
Mudell:Coord/link	Mall:Coord/link
Mudell:LTU	Mall:LTU
Mudell:Utent SUL	Mall:SUL Box
Kategorija:Utenti ja-N	Kategori:Användare ja-N
Kategorija:Futbolers Belġjani	Kategori:Belgiska fotbollsspelare
Kategorija:Futbolers Sloveni	Kategori:Slovenska fotbollsspelare
Kategorija:Artikli kandidati għall-vetrina tal-Wikipedija	Kategori:Wikipedia:Artikelnomineringar
Mudell:Pdf	Mall:PDF
Mudell:Dati pajjiż Ġermanja tal-Punent	Mall:Landsdata Västtyskland
Mudell:Dati pajjiż Ġermanja tal-Lvant	Mall:Landsdata Östtyskland
Kategorija:Twieldu fl-1903	Kategori:Födda 1903
Kategorija:Imperi	Kategori:Imperier
Kategorija:Twieldu fl-1925	Kategori:Födda 1925
Kategorija:Twieldu fl-1936	Kategori:Födda 1936
Kategorija:Twieldu fl-1916	Kategori:Födda 1916
Kategorija:Twieldu fl-1910	Kategori:Födda 1910
Kategorija:Twieldu fl-1939	Kategori:Födda 1939
Mudell:Utent it-0	Mall:Användare it-0
Mudell:Diżambigwazzjoni	Mall:Förgrening
Kategorija:1962	Kategori:1962
Mudell:Dati pajjiż Ħong Kong	Mall:Landsdata Hongkong
Mudell:Ma sarx	Mall:Ej utfört
Mudell:QasamKat	Mall:Storkategori
Mudell:Uk	Mall:Uk ikon
Kategorija:Mudelli infobox	Kategori:Faktamallar
Mudell:Penmiss	Mall:Straffmiss
Kategorija:Real Madrid CF	Kategori:Real Madrid
Kategorija:Storja ta' l-isport	Kategori:Sporthistoria
Mudell:Dati pajjiż Żajr	Mall:Landsdata Zaire
Mudell:Dati pajjiż Imperu Ġermaniż	Mall:Landsdata Kejsardömet Tyskland
Kategorija:Futbol fi Spanja	Kategori:Fotboll i Spanien
Mudell:Pengoal	Mall:Straffmål
Kategorija:Mietu fl-2013	Kategori:Avlidna 2013
Mudell:Fb	Mall:Hff
Kategorija:Twieldu fl-1938	Kategori:Födda 1938
Kategorija:Meta-mudelli tal-Wikipedija	Kategori:Metamallar
Mudell:Is	Mall:Is ikon
Mudell:Dati pajjiż Gżira tal-Milied	Mall:Landsdata Julön
Mudell:Dati pajjiż Imperu Ottoman	Mall:Landsdata Osmanska riket
Kategorija:Mudelli ta' ikoni tal-lingwi	Kategori:Språkmallar
Mudell:Infobox Filosfu	Mall:Infobox filosof
Mudell:Hy	Mall:Hy ikon
Kategorija:Teoloġija	Kategori:Teologi
Mudell:Infobox Organizzazzjoni	Mall:Organisationsfakta
Robin Stjernberg	Robin Stjernberg
Kategorija:1663	Kategori:1663
Kategorija:Mietu fl-1663	Kategori:Avlidna 1663
Mudell:Hr	Mall:Hr ikon
Mudell:Tr	Mall:Tr ikon
Mudell:Az	Mall:Az ikon
Kategorija:Arkitettura	Kategori:Arkitektur
Mudell:Nl	Mall:Nl ikon
Mudell:NATO	Mall:NATO
Mudell:Dati pajjiż Qatar	Mall:Landsdata Qatar
Mudell:Utent it-2	Mall:Användare it-2
Mudell:De	Mall:De ikon
Kategorija:Bliet tal-Italja	Kategori:Italiens kommuner
Mudell:Età	Mall:Age
Kategorija:Pajjiżi li spiċċaw fl-1813	Kategori:Stater och territorier upplösta 1813
Kategorija:Pajjiżi li spiċċaw fl-1923	Kategori:Stater och territorier upplösta 1923
Kategorija:Pajjiżi li spiċċaw fl-1974	Kategori:Stater och territorier upplösta 1974
Kategorija:Pajjiżi li spiċċaw fl-2006	Kategori:Stater och territorier upplösta 2006
Kategorija:Pajjiżi stabbiliti fl-1299	Kategori:Stater och territorier bildade 1299
Kategorija:Pajjiżi stabbiliti fl-1948	Kategori:Stater och territorier bildade 1948
Mudell:Għoti tal-penalties	Mall:Straffavgörandelåda
Kategorija:Plejers ta' Oud-Heverlee Leuven	Kategori:Spelare i Oud-Heverlee Leuven
Mudell:Infobox Ċelebrità	Mall:Infobox biografi
Mudell:Dati pajjiż Iżrael	Mall:Landsdata Israel
Kategorija:1953	Kategori:1953
Mudell:Tim ta' AS Roma	Mall:AS Roma trupp
Mudell:Lista ta' kapitali Ewropej skont ir-reġjun	Mall:Huvudstäder i Europa
Mudell:Dati pajjiż Ukraina	Mall:Landsdata Ukraina
Mudell:Dati pajjiż Kolombja	Mall:Landsdata Colombia
Mudell:Dati pajjiż Gana	Mall:Landsdata Ghana
Mudell:Dati pajjiż Rumanija	Mall:Landsdata Rumänien
Mudell:Dati pajjiż Korea t'Isfel	Mall:Landsdata Sydkorea
Kategorija:Maltin skont ix-xogħol tagħhom	Kategori:Malteser efter yrke
Mudell:L-Ewwel Diviżjoni Belġjana	Mall:Jupiler League
Mudell:Football League Championship	Mall:Football League Championship
Mudell:Sr	Mall:Sr ikon
Kategorija:Isqfijiet Kattoliċi Rumani	Kategori:Romersk-katolska biskopar
Mudell:Coord	Mall:Coord
Kategorija:Twieldu fis-seklu 20	Kategori:Födda 1900-talet
Kategorija:Twieldu fis-seklu 19	Kategori:Födda 1800-talet
Kategorija:Twieldu fis-seklu 21	Kategori:Födda 2000-talet
Kategorija:Twieldu fis-seklu 18	Kategori:Födda 1700-talet
Kategorija:Twieldu fis-seklu 17	Kategori:Födda 1600-talet
Kategorija:Twieldu fis-seklu 16	Kategori:Födda 1500-talet
Kategorija:Twieldu fis-seklu 15	Kategori:Födda 1400-talet
Kategorija:Mudelli tal-klabbs tal-futbol Franċiżi	Kategori:Spelartruppsmallar för klubblag - Frankrike
Kategorija:FIFA	Kategori:FIFA
Mudell:Dati pajjiż Boemja	Mall:Landsdata Böhmen
Kategorija:Futbolers Ivorjani	Kategori:Ivorianska fotbollsspelare
Mudell:Dati pajjiż Baħrejn	Mall:Landsdata Bahrain
Kategorija:Mietu fl-1622	Kategori:Avlidna 1622
Mudell:Ewropa	Mall:Europa
Kategorija:Futbolers skont in-nazzjonalità	Kategori:Fotbollsspelare efter nationalitet
Kategorija:Utenti yue	Kategori:Användare zh-yue
Kategorija:Utenti az	Kategori:Användare az
Kategorija:Utenti be	Kategori:Användare be
Kategorija:Utenti hr	Kategori:Användare hr
Kategorija:Utenti eo	Kategori:Användare eo
Kategorija:Utenti fr	Kategori:Användare fr
Kategorija:Utenti cy	Kategori:Användare cy
Kategorija:Utenti id	Kategori:Användare id
Kategorija:Utenti ga	Kategori:Användare ga
Kategorija:Utenti ja	Kategori:Användare ja
Kategorija:Utenti nn	Kategori:Användare nn
Kategorija:Utenti pt	Kategori:Användare pt
Kategorija:Utenti scn	Kategori:Användare scn
Kategorija:Utenti sv	Kategori:Användare sv
Kategorija:Utenti fr-3	Kategori:Användare fr-3
Kategorija:Utenti it-3	Kategori:Användare it-3
Kategorija:Utenti no-3	Kategori:Användare no-3
Kategorija:Utenti pl-3	Kategori:Användare pl-3
Kategorija:Utenti da-1	Kategori:Användare da-1
Kategorija:Utenti ga-1	Kategori:Användare ga-1
Kategorija:Utenti nl-1	Kategori:Användare nl-1
Kategorija:Utenti tr-1	Kategori:Användare tr-1
Kategorija:Utenti ar-1	Kategori:Användare ar-1
Kategorija:Utenti it-4	Kategori:Användare it-4
Kategorija:Utenti pl-4	Kategori:Användare pl-4
Kategorija:Utenti be-2	Kategori:Användare be-2
Kategorija:Utenti da-2	Kategori:Användare da-2
Kategorija:Utenti fr-2	Kategori:Användare fr-2
Kategorija:Utenti cy-2	Kategori:Användare cy-2
Kategorija:Utenti hi-2	Kategori:Användare hi-2
Kategorija:Utenti it-2	Kategori:Användare it-2
Kategorija:Utenti ja-2	Kategori:Användare ja-2
Kategorija:Utenti nl-2	Kategori:Användare nl-2
Kategorija:Utenti pl-2	Kategori:Användare pl-2
Kategorija:Utenti tr-2	Kategori:Användare tr-2
Kategorija:Utenti be-N	Kategori:Användare be-N
Kategorija:Utenti cs-N	Kategori:Användare cs-N
Kategorija:Utenti hr-N	Kategori:Användare hr-N
Kategorija:Utenti fr-N	Kategori:Användare fr-N
Kategorija:Utenti it-N	Kategori:Användare it-N
Kategorija:Utenti nl-N	Kategori:Användare nl-N
Kategorija:Utenti no-N	Kategori:Användare no-N
Kategorija:Utenti ru-N	Kategori:Användare ru-N
Kategorija:Divertiment	Kategori:Nöjen
Kategorija:Utenti se-3	Kategori:Användare se-3
Mudell:Nfteams	Mall:Nfteams
Kategorija:Klabbs tal-futbol xolti	Kategori:Upplösta fotbollsklubbar
Kategorija:UEFA Champions League 2012–13	Kategori:UEFA Champions League 2012/2013
Kategorija:UEFA Champions League	Kategori:UEFA Champions League
Mudell:Utent yue	Mall:Användare zh-yue
Kategorija:Abbozzi tal-enerġija	Kategori:Energistubbar
Kategorija:Plejers ta' Enosis Neon Paralimni	Kategori:Spelare i Enosis Neon Paralimni FC
Kategorija:Mużiċisti għamjin	Kategori:Blinda musiker
Kategorija:Għall-wikifikazzjoni	Kategori:Artiklar som behöver wikifieras
Kategorija:1220	Kategori:1220
Kategorija:Organizzazzjonijiet tal-futbol	Kategori:Fotbollsfederationer
Kategorija:UEFA	Kategori:UEFA
Kategorija:Utenti af	Kategori:Användare af
Kategorija:Utenti af-3	Kategori:Användare af-3
Kategorija:Utenti ar	Kategori:Användare ar
Kategorija:Utenti az-N	Kategori:Användare az-N
Kategorija:Utenti bg	Kategori:Användare bg
Kategorija:Utenti bg-1	Kategori:Användare bg-1
Kategorija:Utenti bg-N	Kategori:Användare bg-N
Kategorija:Mużiċisti Awstrijaċi	Kategori:Österrikiska musiker
Kategorija:Utenti cs	Kategori:Användare cs
Kategorija:Utenti da	Kategori:Användare da
Kategorija:Provinċja ta' Quang Binh	Kategori:Quang Binh
Kategorija:Abbozzi ta' annimali	Kategori:Djurstubbar
Kategorija:Utenti de	Kategori:Användare de
Kategorija:Utenti de-2	Kategori:Användare de-2
Kategorija:Utenti de-3	Kategori:Användare de-3
Kategorija:Utenti de-4	Kategori:Användare de-4
Kategorija:Utenti de-N	Kategori:Användare de-N
Kategorija:Utenti el	Kategori:Användare el
Kategorija:Utenti el-N	Kategori:Användare el-N
Kategorija:Utenti en-3	Kategori:Användare en-3
Kategorija:Utenti en-N	Kategori:Användare en-N
Kategorija:Utenti eo-3	Kategori:Användare eo-3
Kategorija:Utenti es	Kategori:Användare es
Kategorija:Utenti es-1	Kategori:Användare es-1
Mudell:Pajjiżi tal-Unjoni Ewropea	Mall:EU
Kategorija:Utenti es-2	Kategori:Användare es-2
Kategorija:Utenti es-3	Kategori:Användare es-3
Kategorija:Utenti es-N	Kategori:Användare es-N
Kategorija:Utenti fa	Kategori:Användare fa
Kategorija:Utenti fa-N	Kategori:Användare fa-N
Kategorija:Utenti fi	Kategori:Användare fi
Kategorija:Utenti fi-N	Kategori:Användare fi-N
Kategorija:Utenti ga-2	Kategori:Användare ga-2
Kategorija:Utenti ga-3	Kategori:Användare ga-3
Kategorija:Utenti ga-N	Kategori:Användare ga-N
Kategorija:Utenti grc	Kategori:Användare grc
Kategorija:Utenti grc-1	Kategori:Användare grc-1
Kategorija:Utenti hu	Kategori:Användare hu
Kategorija:Utenti hu-1	Kategori:Användare hu-1
Kategorija:1452	Kategori:1452
Mudell:Tim ta' Bayer 04 Leverkusen	Mall:Bayer 04 Leverkusen trupp
Kategorija:Plejers ta' Los Angeles Galaxy	Kategori:Spelare i Los Angeles Galaxy
Kategorija:Mietu fl-1904	Kategori:Avlidna 1904
Kategorija:Plejers ta' Grasshopper Club Zürich	Kategori:Grasshopper Club Zürich
Kategorija:Politiċi Veneżwelani	Kategori:Venezuelanska politiker
Kategorija:Utenti pl-N	Kategori:Användare pl-N
Kategorija:Utenti pt-1	Kategori:Användare pt-1
Mudell:Dati pajjiż Ġermanja	Mall:Landsdata Tyskland
Mudell:Dati pajjiż Renju Unit	Mall:Landsdata Storbritannien
Kategorija:Mietu fl-1852	Kategori:Avlidna 1852
Kategorija:Mietu fl-1880	Kategori:Avlidna 1880
Kategorija:Ġeometrija	Kategori:Geometri
Kategorija:Mietu fl-1942	Kategori:Avlidna 1942
Kategorija:Kampjonati Ewropej tal-Futbol 2012	Kategori:Europamästerskapet i fotboll för herrar 2012
Mudell:Dati pajjiż Skozja	Mall:Landsdata Skottland
Għajnuna:Gwida essenzjali/Ifformattjar	Wikipedia:Introduktion till formatering
Mudell:Dati pajjiż Estonja	Mall:Landsdata Estland
Kategorija:Utenti it	Kategori:Användare it
Kategorija:Utenti it-1	Kategori:Användare it-1
Kategorija:Futbolers Ażerbajġani	Kategori:Azeriska fotbollsspelare
Kategorija:European Broadcasting Union	Kategori:Eurovisionen
Kategorija:Vulkani	Kategori:Vulkaner
Kategorija:Mietu fl-1564	Kategori:Avlidna 1564
Kategorija:1564	Kategori:1564
Kategorija:Edizzjonijiet tat-Tazza tad-Dinja tal-Futbol	Kategori:Världsmästerskapet i fotboll efter år
Kategorija:Provinċji tal-Vjetnam	Kategori:Vietnams provinser
Kategorija:1592	Kategori:1592
Kategorija:Kompetizzjonijiet tal-futbol skont il-pajjiż	Kategori:Fotbollstävlingar efter land
Kategorija:Arti marzjali	Kategori:Kampsport
Kategorija:Plejers ta' De Graafschap	Kategori:Spelare i De Graafschap
Kategorija:Pitturi tar-Rinaxximent	Kategori:Renässansmålare
Kategorija:Bijoloġi evoluzzjonarji	Kategori:Evolutionsbiologer
Kategorija:Knisja Kattolika Rumana	Kategori:Romersk-katolska kyrkan
Kategorija:Kowċis Olandiżi	Kategori:Nederländska fotbollstränare
Kategorija:Mużiċisti Olandiżi	Kategori:Nederländska musiker
Kategorija:Kantanti Olandiżi	Kategori:Nederländska sångare
Kategorija:Mietu fl-1794	Kategori:Avlidna 1794
Kategorija:Mietu fl-1931	Kategori:Avlidna 1931
Kategorija:Mietu fl-1827	Kategori:Avlidna 1827
Kategorija:Utenti ru-1	Kategori:Användare ru-1
Mudell:TOClimit	Mall:TOC limit
Wikipedija:Babel	Wikipedia:Babel
Kategorija:Mietu fl-1829	Kategori:Avlidna 1829
Kategorija:Mietu fl-1778	Kategori:Avlidna 1778
Kategorija:Mietu fl-1547	Kategori:Avlidna 1547
Kategorija:Abbozzi tal-kimika	Kategori:Kemistubbar
Kategorija:1687	Kategori:1687
Kategorija:1614	Kategori:1614
Kategorija:1612	Kategori:1612
Kategorija:Mietu fl-1612	Kategori:Avlidna 1612
Kategorija:Mietu fl-1655	Kategori:Avlidna 1655
Kategorija:Mietu fl-1616	Kategori:Avlidna 1616
Kategorija:Mietu fl-1614	Kategori:Avlidna 1614
Kategorija:Futbolers Olandiżi	Kategori:Nederländska fotbollsspelare
Kategorija:1655	Kategori:1655
Kategorija:Mietu fl-1994	Kategori:Avlidna 1994
Kategorija:Twieldu fl-1906	Kategori:Födda 1906
Kategorija:Kompożituri tal-opra	Kategori:Operatonsättare
Kategorija:Ibħra	Kategori:Hav
Kategorija:Bliet tal-Polonja	Kategori:Städer i Polen
Kategorija:Kompożituri skont in-nazzjonalità	Kategori:Kompositörer efter nationalitet
Mudell:Bundesliga (Awstrija)	Mall:Österrikiska Bundesliga i fotboll
Kategorija:Futbolers f'Wales skont il-klabb	Kategori:Fotbollsspelare i klubblag i Wales
Kategorija:Atturi skont in-nazzjonalità	Kategori:Skådespelare efter nationalitet
Kategorija:Mietu fl-2009	Kategori:Avlidna 2009
Kategorija:Sistema solari	Kategori:Solsystemet
Trasformata ta' Fourier	Fouriertransform
Mudell:Dati pajjiż Brażil	Mall:Landsdata Brasilien
Mudell:FIFA	Mall:FIFA-spelare
Mudell:Dati pajjiż Irlanda ta' Fuq	Mall:Landsdata Nordirland
Mudell:UEFA	Mall:UEFA-spelare
Kategorija:Entomoloġija	Kategori:Entomologi
Kategorija:Carnivora	Kategori:Rovdjur
Kategorija:Klabbs tal-futbol Torok	Kategori:Fotbollsklubbar i Turkiet
Kategorija:Mietu fl-1321	Kategori:Avlidna 1321
Kategorija:Mietu fl-2005	Kategori:Avlidna 2005
Kategorija:Twieldu fl-1983	Kategori:Födda 1983
Kategorija:Mietu fl-1592	Kategori:Avlidna 1592
Kategorija:Futbolers Pollakki	Kategori:Polska fotbollsspelare
Kategorija:Mużiċisti Bulgari	Kategori:Bulgariska musiker
Kategorija:Mietu fl-1991	Kategori:Avlidna 1991
Kategorija:Mietu fl-1992	Kategori:Avlidna 1992
Kategorija:Plejers ta' Sport Club Corinthians Paulista	Kategori:Spelare i Sport Club Corinthians Paulista
Kategorija:Twieldu fl-1992	Kategori:Födda 1992
Kategorija:Utenti nb	Kategori:Användare nb
Kategorija:Twieldu fl-1970	Kategori:Födda 1970
Kategorija:Mietu fl-1980	Kategori:Avlidna 1980
Kategorija:Mietu fl-2008	Kategori:Avlidna 2008
Kategorija:Mietu fl-1966	Kategori:Avlidna 1966
Kategorija:Mietu fl-1946	Kategori:Avlidna 1946
Kategorija:Mietu fl-1938	Kategori:Avlidna 1938
Kategorija:Twieldu fl-1984	Kategori:Födda 1984
Kategorija:Mietu fl-1962	Kategori:Avlidna 1962
Kategorija:Twieldu fl-1990	Kategori:Födda 1990
Kategorija:Mietu fl-1934	Kategori:Avlidna 1934
Kategorija:Twieldu fl-1974	Kategori:Födda 1974
Kategorija:Mietu fl-1947	Kategori:Avlidna 1947
Kategorija:Mietu fl-2007	Kategori:Avlidna 2007
Kategorija:Twieldu fl-1965	Kategori:Födda 1965
Kategorija:Twieldu fl-1940	Kategori:Födda 1940
Kategorija:Twieldu fl-1898	Kategori:Födda 1898
Kategorija:Twieldu fl-1867	Kategori:Födda 1867
Kategorija:Twieldu fl-1871	Kategori:Födda 1871
Kategorija:Twieldu fl-1862	Kategori:Födda 1862
Kategorija:Twieldu fl-1977	Kategori:Födda 1977
Kategorija:Twieldu fl-1899	Kategori:Födda 1899
Kategorija:1844	Kategori:1844
Kategorija:Twieldu fl-1931	Kategori:Födda 1931
Kategorija:Twieldu fl-1915	Kategori:Födda 1915
Kategorija:Twieldu fl-1929	Kategori:Födda 1929
Kategorija:Poeti Spanjoli	Kategori:Spanska poeter
Portal:Sport	Portal:Sport
Mudell:Id	Mall:Id ikon
Kategorija:Abbozzi tal-arkeoloġija	Kategori:Arkeologistubbar
Kategorija:Twieldu fl-1954	Kategori:Födda 1954
Kategorija:Xjenza soċjali	Kategori:Samhällsvetenskap
Kategorija:Bjelorussja	Kategori:Vitryssland
Kategorija:Twieldu fl-1960	Kategori:Födda 1960
Kategorija:Kantanti Kanadiżi	Kategori:Kanadensiska sångare
Mudell:Dati pajjiż Ungerija	Mall:Landsdata Ungern
Kategorija:Mietu fl-1830	Kategori:Avlidna 1830
Kategorija:Mietu fl-1993	Kategori:Avlidna 1993
Kategorija:Pajjiżi tal-Afrika	Kategori:Afrikas länder
Kategorija:Mietu fl-1998	Kategori:Avlidna 1998
Kategorija:Klabbs tal-futbol Ażerbajġani	Kategori:Fotbollsklubbar i Azerbajdzjan
Kategorija:1170	Kategori:1170
Kategorija:Twieldu fl-1170	Kategori:Födda 1170
Kategorija:Twieldu fl-1182	Kategori:Födda 1182
Kategorija:Twieldu fl-1185	Kategori:Födda 1185
Kategorija:Mietu fl-1220	Kategori:Avlidna 1220
Kategorija:1226	Kategori:1226
Kategorija:Mietu fl-1226	Kategori:Avlidna 1226
Kategorija:1227	Kategori:1227
Kategorija:Mietu fl-1227	Kategori:Avlidna 1227
Kategorija:Twieldu fl-1951	Kategori:Födda 1951
Kategorija:Mietu fl-1882	Kategori:Avlidna 1882
Kategorija:Mietu fl-1883	Kategori:Avlidna 1883
Kategorija:1265	Kategori:1265
Kategorija:Twieldu fl-1265	Kategori:Födda 1265
Kategorija:1296	Kategori:1296
Kategorija:Mietu fl-1296	Kategori:Avlidna 1296
Mudell:Ballun tad-Deheb	Mall:Vinnare av Ballon d'Or
Mudell:Utent da-3	Mall:Användare da-3
Mudell:Tim ta' FC Barcelona	Mall:FC Barcelona trupp
Mudell:Utent ja-2	Mall:Användare ja-2
Kategorija:1528	Kategori:1528
Mudell:Dati pajjiż New Zealand	Mall:Landsdata Nya Zeeland
Kategorija:1405	Kategori:1405
Mudell:Utent ru-2	Mall:Användare ru-2
Kategorija:Twieldu fl-1405	Kategori:Födda 1405
Kategorija:1522	Kategori:1522
Kategorija:1419	Kategori:1419
Mudell:Lv	Mall:Lv ikon
Kategorija:1508	Kategori:1508
Kategorija:1519	Kategori:1519
Kategorija:Futbol fil-Polonja	Kategori:Fotboll i Polen
Kategorija:Futbolers fil-Polonja skont il-klabb	Kategori:Fotbollsspelare i klubblag i Polen
Kategorija:Twieldu fl-1452	Kategori:Födda 1452
Kategorija:1466	Kategori:1466
Kategorija:1468	Kategori:1468
Kategorija:Mietu fl-1468	Kategori:Avlidna 1468
Kategorija:1471	Kategori:1471
Kategorija:Twieldu fl-1471	Kategori:Födda 1471
Mudell:Skwadra Taljana Tazza tad-Dinja tal-Futbol 2010	Mall:Italiens trupp i VM i fotboll 2010
Kategorija:1478	Kategori:1478
Kategorija:Twieldu fl-1478	Kategori:Födda 1478
Kategorija:Twieldu fl-1480	Kategori:Födda 1480
Kategorija:1483	Kategori:1483
Kategorija:1494	Kategori:1494
Kategorija:Twieldu fl-1494	Kategori:Födda 1494
Kategorija:Utenti ru	Kategori:Användare ru
Kategorija:Utenti ru-2	Kategori:Användare ru-2
Kategorija:Utenti ru-3	Kategori:Användare ru-3
Kategorija:Twieldu fl-1508	Kategori:Födda 1508
Kategorija:Utenti se	Kategori:Användare se
Kategorija:Twieldu fl-1515	Kategori:Födda 1515
Kategorija:Mietu fl-1519	Kategori:Avlidna 1519
Kategorija:1532	Kategori:1532
Kategorija:Twieldu fl-1532	Kategori:Födda 1532
Kategorija:Twieldu fl-1533	Kategori:Födda 1533
Kategorija:Mietu fl-1535	Kategori:Avlidna 1535
Kategorija:Mietu fl-1539	Kategori:Avlidna 1539
Kategorija:1542	Kategori:1542
Kategorija:Utenti sv-3	Kategori:Användare sv-3
Kategorija:1547	Kategori:1547
Kategorija:Utenti sv-N	Kategori:Användare sv-N
Kategorija:Twieldu fl-1552	Kategori:Födda 1552
Kategorija:1562	Kategori:1562
Kategorija:Twieldu fl-1564	Kategori:Födda 1564
Kategorija:1567	Kategori:1567
Kategorija:1568	Kategori:1568
Kategorija:Mietu fl-1568	Kategori:Avlidna 1568
Kategorija:1573	Kategori:1573
Kategorija:Twieldu fl-1573	Kategori:Födda 1573
Kategorija:1581	Kategori:1581
Kategorija:Twieldu fl-1582	Kategori:Födda 1582
Kategorija:1591	Kategori:1591
Kategorija:1593	Kategori:1593
Kategorija:1597	Kategori:1597
Kategorija:1600	Kategori:1600
Mudell:Esc	Mall:ESC
Kategorija:1616	Kategori:1616
Kategorija:1621	Kategori:1621
Kategorija:Utenti tr	Kategori:Användare tr
Kategorija:Mietu fl-1621	Kategori:Avlidna 1621
Kategorija:1625	Kategori:1625
Kategorija:Mietu fl-1625	Kategori:Avlidna 1625
Kategorija:Utenti uk-4	Kategori:Användare uk-4
Kategorija:1636	Kategori:1636
Kategorija:1643	Kategori:1643
Kategorija:Mietu fl-1643	Kategori:Avlidna 1643
Kategorija:1654	Kategori:1654
Kategorija:Twieldu fl-1654	Kategori:Födda 1654
Kategorija:1656	Kategori:1656
Kategorija:Mietu fl-1656	Kategori:Avlidna 1656
Kategorija:1660	Kategori:1660
Kategorija:1667	Kategori:1667
Kategorija:Mietu fl-1667	Kategori:Avlidna 1667
Kategorija:1670	Kategori:1670
Kategorija:Mietu fl-1670	Kategori:Avlidna 1670
Kategorija:1675	Kategori:1675
Kategorija:1685	Kategori:1685
Kategorija:Twieldu fl-1687	Kategori:Födda 1687
Mudell:En	Mall:En ikon
Kategorija:1694	Kategori:1694
Kategorija:1695	Kategori:1695
Kategorija:Twieldu fl-1696	Kategori:Födda 1696
Kategorija:Twieldu fl-1699	Kategori:Födda 1699
Kategorija:1700	Kategori:1700
Kategorija:Mietu fl-1705	Kategori:Avlidna 1705
Kategorija:1709	Kategori:1709
Kategorija:1710	Kategori:1710
Kategorija:Twieldu fl-1715	Kategori:Födda 1715
Kategorija:Twieldu fl-1724	Kategori:Födda 1724
Kategorija:Mużiċisti	Kategori:Musiker
Kategorija:Logħob ta' abilità mentali	Kategori:Logikspel
Kategorija:Twieldu fl-1881	Kategori:Födda 1881
Mudell:Timijiet nazzjonali tal-UEFA	Mall:UEFA-herrlandslag
Mudell:Tim ta' Manchester United FC	Mall:Manchester United FC trupp
Mudell:Da	Mall:Da ikon
Kategorija:Kantanti Irlandiżi	Kategori:Irländska sångare
Mudell:Skwadra Ġermaniża Tazza tad-Dinja tal-Futbol 2010	Mall:Tysklands trupp i VM i fotboll 2010
Mudell:Skwadra Ġermaniża Kampjonati Ewropej tal-Futbol 2008	Mall:Tysklands trupp i EM i fotboll 2008
Mudell:Dati pajjiż Serbja u Montenegro	Mall:Landsdata Serbien och Montenegro
Kategorija:Twieldu fl-1944	Kategori:Födda 1944
Kategorija:Twieldu fl-1932	Kategori:Födda 1932
Kategorija:Twieldu fl-1934	Kategori:Födda 1934
Kategorija:Twieldu fl-1935	Kategori:Födda 1935
Kategorija:Terminoloġija sportiva	Kategori:Sporttermer
Kategorija:Twieldu fl-1941	Kategori:Födda 1941
Kategorija:Matematiċi Russi	Kategori:Ryska matematiker
Kategorija:Soċjoloġija	Kategori:Sociologi
Kategorija:Twieldu fis-seklu 12	Kategori:Födda 1100-talet
Kategorija:Twieldu fis-seklu 13	Kategori:Födda 1200-talet
Kategorija:Twieldu fis-seklu 14	Kategori:Födda 1300-talet
Kategorija:Twieldu fl-1466	Kategori:Födda 1466
Kategorija:Twieldu fl-1483	Kategori:Födda 1483
Kategorija:Twieldu fl-1542	Kategori:Födda 1542
Kategorija:Twieldu fl-1547	Kategori:Födda 1547
Kategorija:Twieldu fl-1562	Kategori:Födda 1562
Kategorija:Twieldu fl-1567	Kategori:Födda 1567
Kategorija:Twieldu fl-1581	Kategori:Födda 1581
Kategorija:Twieldu fl-1591	Kategori:Födda 1591
Kategorija:Twieldu fl-1593	Kategori:Födda 1593
Kategorija:Twieldu fl-1600	Kategori:Födda 1600
Kategorija:Twieldu fl-1636	Kategori:Födda 1636
Kategorija:Twieldu fl-1643	Kategori:Födda 1643
Kategorija:Twieldu fl-1667	Kategori:Födda 1667
Kategorija:Twieldu fl-1675	Kategori:Födda 1675
Kategorija:Twieldu fl-1685	Kategori:Födda 1685
Kategorija:Twieldu fl-1694	Kategori:Födda 1694
Kategorija:Twieldu fl-1695	Kategori:Födda 1695
Kategorija:Twieldu fl-1700	Kategori:Födda 1700
Kategorija:Twieldu fl-1710	Kategori:Födda 1710
Kategorija:Twieldu fl-1744	Kategori:Födda 1744
Kategorija:Ġurnalisti Maltin	Kategori:Maltesiska journalister
Kategorija:Twieldu fl-1748	Kategori:Födda 1748
Kategorija:Twieldu fl-1749	Kategori:Födda 1749
Kategorija:Twieldu fl-1756	Kategori:Födda 1756
Kategorija:Twieldu fl-1758	Kategori:Födda 1758
Kategorija:Twieldu fl-1759	Kategori:Födda 1759
Kategorija:Twieldu fl-1764	Kategori:Födda 1764
Kategorija:Twieldu fl-1767	Kategori:Födda 1767
Kategorija:Twieldu fl-1769	Kategori:Födda 1769
Kategorija:Twieldu fl-1770	Kategori:Födda 1770
Kategorija:Twieldu fl-1772	Kategori:Födda 1772
Kategorija:Twieldu fl-1773	Kategori:Födda 1773
Kategorija:Twieldu fl-1779	Kategori:Födda 1779
Kategorija:Twieldu fl-1786	Kategori:Födda 1786
Kategorija:Twieldu fl-1797	Kategori:Födda 1797
Kategorija:Twieldu fl-1801	Kategori:Födda 1801
Kategorija:Twieldu fl-1803	Kategori:Födda 1803
Kategorija:Twieldu fl-1808	Kategori:Födda 1808
Kategorija:Twieldu fl-1809	Kategori:Födda 1809
Kategorija:Twieldu fl-1813	Kategori:Födda 1813
Kategorija:Twieldu fl-1815	Kategori:Födda 1815
Kategorija:Twieldu fl-1818	Kategori:Födda 1818
Kategorija:Twieldu fl-1821	Kategori:Födda 1821
Kategorija:Twieldu fl-1822	Kategori:Födda 1822
Kategorija:Twieldu fl-1824	Kategori:Födda 1824
Kategorija:Twieldu fl-1840	Kategori:Födda 1840
Kategorija:Twieldu fl-1841	Kategori:Födda 1841
Kategorija:Twieldu fl-1844	Kategori:Födda 1844
Kategorija:Twieldu fl-1846	Kategori:Födda 1846
Kategorija:Twieldu fl-1847	Kategori:Födda 1847
Kategorija:Twieldu fl-1848	Kategori:Födda 1848
Kategorija:Twieldu fl-1849	Kategori:Födda 1849
Kategorija:Twieldu fl-1853	Kategori:Födda 1853
Kategorija:Twieldu fl-1854	Kategori:Födda 1854
Kategorija:Twieldu fl-1859	Kategori:Födda 1859
Kategorija:Twieldu fl-1860	Kategori:Födda 1860
Kategorija:Twieldu fl-1861	Kategori:Födda 1861
Kategorija:Twieldu fl-1864	Kategori:Födda 1864
Kategorija:Twieldu fl-1866	Kategori:Födda 1866
Kategorija:Twieldu fl-1869	Kategori:Födda 1869
Kategorija:Twieldu fl-1873	Kategori:Födda 1873
Kategorija:Twieldu fl-1874	Kategori:Födda 1874
Kategorija:Twieldu fl-1876	Kategori:Födda 1876
Kategorija:Twieldu fl-1877	Kategori:Födda 1877
Kategorija:Twieldu fl-1880	Kategori:Födda 1880
Kategorija:Twieldu fl-1883	Kategori:Födda 1883
Kategorija:Twieldu fl-1884	Kategori:Födda 1884
Kategorija:Twieldu fl-1885	Kategori:Födda 1885
Kategorija:Twieldu fl-1886	Kategori:Födda 1886
Kategorija:Twieldu fl-1887	Kategori:Födda 1887
Kategorija:Twieldu fl-1889	Kategori:Födda 1889
Kategorija:Twieldu fl-1890	Kategori:Födda 1890
Kategorija:Twieldu fl-1891	Kategori:Födda 1891
Kategorija:Twieldu fl-1892	Kategori:Födda 1892
Kategorija:Twieldu fl-1893	Kategori:Födda 1893
Kategorija:Twieldu fl-1894	Kategori:Födda 1894
Kategorija:Twieldu fl-1895	Kategori:Födda 1895
Kategorija:Twieldu fl-1896	Kategori:Födda 1896
Kategorija:Twieldu fl-1897	Kategori:Födda 1897
Kategorija:Twieldu fl-1900	Kategori:Födda 1900
Kategorija:Twieldu fl-1901	Kategori:Födda 1901
Kategorija:Twieldu fl-1902	Kategori:Födda 1902
Kategorija:Twieldu fl-1904	Kategori:Födda 1904
Kategorija:Twieldu fl-1905	Kategori:Födda 1905
Kategorija:Twieldu fl-1907	Kategori:Födda 1907
Kategorija:Twieldu fl-1908	Kategori:Födda 1908
Kategorija:Twieldu fl-1909	Kategori:Födda 1909
Kategorija:Twieldu fl-1912	Kategori:Födda 1912
Kategorija:Twieldu fl-1913	Kategori:Födda 1913
Kategorija:Twieldu fl-1914	Kategori:Födda 1914
Kategorija:Twieldu fl-1917	Kategori:Födda 1917
Kategorija:Twieldu fl-1918	Kategori:Födda 1918
Kategorija:Twieldu fl-1919	Kategori:Födda 1919
Kategorija:Twieldu fl-1922	Kategori:Födda 1922
Kategorija:Twieldu fl-1923	Kategori:Födda 1923
Kategorija:Twieldu fl-1927	Kategori:Födda 1927
Kategorija:Twieldu fl-1928	Kategori:Födda 1928
Kategorija:Twieldu fl-1942	Kategori:Födda 1942
Kategorija:Twieldu fl-1943	Kategori:Födda 1943
Kategorija:Twieldu fl-1945	Kategori:Födda 1945
Kategorija:Twieldu fl-1947	Kategori:Födda 1947
Kategorija:Twieldu fl-1949	Kategori:Födda 1949
Kategorija:Twieldu fl-1952	Kategori:Födda 1952
Kategorija:Twieldu fl-1953	Kategori:Födda 1953
Kategorija:Twieldu fl-1957	Kategori:Födda 1957
Kategorija:Twieldu fl-1958	Kategori:Födda 1958
Kategorija:Twieldu fl-1959	Kategori:Födda 1959
Kategorija:Twieldu fl-1961	Kategori:Födda 1961
Kategorija:Twieldu fl-1962	Kategori:Födda 1962
Kategorija:Twieldu fl-1966	Kategori:Födda 1966
Kategorija:Twieldu fl-1967	Kategori:Födda 1967
Kategorija:Twieldu fl-1968	Kategori:Födda 1968
Kategorija:Twieldu fl-1969	Kategori:Födda 1969
Kategorija:Twieldu fl-1971	Kategori:Födda 1971
Kategorija:Twieldu fl-1972	Kategori:Födda 1972
Kategorija:Twieldu fl-1973	Kategori:Födda 1973
Kategorija:Twieldu fl-1975	Kategori:Födda 1975
Kategorija:Twieldu fl-1976	Kategori:Födda 1976
Kategorija:Twieldu fl-1978	Kategori:Födda 1978
Kategorija:Twieldu fl-1979	Kategori:Födda 1979
Kategorija:Twieldu fl-1980	Kategori:Födda 1980
Kategorija:Twieldu fl-1981	Kategori:Födda 1981
Kategorija:Twieldu fl-1982	Kategori:Födda 1982
Kategorija:Twieldu fl-1985	Kategori:Födda 1985
Kategorija:Twieldu fl-1986	Kategori:Födda 1986
Kategorija:Twieldu fl-1987	Kategori:Födda 1987
Kategorija:Twieldu fl-1988	Kategori:Födda 1988
Kategorija:Twieldu fl-1989	Kategori:Födda 1989
Kategorija:Twieldu fl-1991	Kategori:Födda 1991
Kategorija:Twieldu fl-1993	Kategori:Födda 1993
Kategorija:Twieldu fl-1994	Kategori:Födda 1994
Kategorija:Twieldu fl-1995	Kategori:Födda 1995
Kategorija:Twieldu fl-1996	Kategori:Födda 1996
Kategorija:Twieldu fl-1997	Kategori:Födda 1997
Kategorija:Twieldu fl-1999	Kategori:Födda 1999
Kategorija:Twieldu fl-2000	Kategori:Födda 2000
Mudell:Tazza tad-Dinja tal-Futbol 2006	Mall:Världsmästerskapet i fotboll 2006
Mudell:Dati pajjiż Afganistan	Mall:Landsdata Afghanistan
Mudell:Dati pajjiż Bangladexx	Mall:Landsdata Bangladesh
Kategorija:1715	Kategori:1715
Kategorija:1797	Kategori:1797
Kategorija:1787	Kategori:1787
Kategorija:1539	Kategori:1539
Kategorija:1321	Kategori:1321
Mudell:Nowrap end	Mall:Nowrap end
Mudell:Tazza tad-Dinja tal-Klabbs Rawnd 7	Mall:VMklubblag
Mudell:90minut	Mall:90minut
Kategorija:Seklu 17	Kategori:1600-talet
Kategorija:Deċennju tal-1260	Kategori:1260-talet
Mudell:Tim ta' Arsenal FC	Mall:Arsenal FC trupp
Kategorija:1182	Kategori:1182
Kategorija:1185	Kategori:1185
Kategorija:1221	Kategori:1221
Mudell:Premier League Ażerbajġan	Mall:Klubbar i Premjer Liqasy
Kategorija:Plejers ta' Celta de Vigo	Kategori:Spelare i RC Celta de Vigo
Mudell:Bar percent	Mall:Procentstapel
Mudell:Bk	Mall:Hbkf
Mudell:Tim ta' Bologna FC 1909	Mall:Bologna FC 1909 trupp
Kategorija:2014	Kategori:2014
Mudell:Skwadra Brażiljana Tazza tal-Konfederazzjonijiet 2009	Mall:Brasiliens trupp i Fifa Confederations Cup 2009
Mudell:Skwadra Brażiljana Tazza tad-Dinja tal-Futbol 2010	Mall:Brasiliens trupp i VM i fotboll 2010
Mudell:Utent sv-3	Mall:Användare sv-3
Mudell:Fr	Mall:Fr ikon
Kategorija:1515	Kategori:1515
Mudell:Twitter	Mall:Twitter
Kategorija:Mietu fl-1522	Kategori:Avlidna 1522
Kategorija:Portali	Kategori:Portaler
Kategorija:Mietu fl-1528	Kategori:Avlidna 1528
Kategorija:1533	Kategori:1533
Kategorija:1535	Kategori:1535
Kategorija:1546	Kategori:1546
Kategorija:1552	Kategori:1552
Kategorija:Futbolers Sud-Koreani	Kategori:Sydkoreanska fotbollsspelare
Kategorija:1580	Kategori:1580
Kategorija:Mietu fl-1580	Kategori:Avlidna 1580
Kategorija:1582	Kategori:1582
Kategorija:1595	Kategori:1595
Mudell:Utent af-3	Mall:Användare af-3
Kategorija:1622	Kategori:1622
Kategorija:1642	Kategori:1642
Kategorija:Mietu fl-1642	Kategori:Avlidna 1642
Kategorija:Mietu fl-1660	Kategori:Avlidna 1660
Kategorija:1696	Kategori:1696
Kategorija:1699	Kategori:1699
Kategorija:1705	Kategori:1705
Kategorija:1726	Kategori:1726
Kategorija:Mietu fl-1726	Kategori:Avlidna 1726
Kategorija:Mietu fl-1727	Kategori:Avlidna 1727
Marie Louise Coleiro Preca	Marie Louise Coleiro Preca
Kategorija:Mietu fl-1748	Kategori:Avlidna 1748
Kategorija:Mietu fl-1757	Kategori:Avlidna 1757
Kategorija:Mietu fl-1759	Kategori:Avlidna 1759
Kategorija:Mietu fl-1760	Kategori:Avlidna 1760
Kategorija:1764	Kategori:1764
Kategorija:1767	Kategori:1767
Kategorija:1769	Kategori:1769
Kategorija:Mietu fl-1772	Kategori:Avlidna 1772
Kategorija:1779	Kategori:1779
Kategorija:Mietu fl-1782	Kategori:Avlidna 1782
Kategorija:Mietu fl-1787	Kategori:Avlidna 1787
Kategorija:Mietu fl-1789	Kategori:Avlidna 1789
Kategorija:Mietu fl-1790	Kategori:Avlidna 1790
Kategorija:1778	Kategori:1778
Kategorija:Mużika popolari	Kategori:Världsmusik
Mudell:Artiklu prinċipali	Mall:Huvudartikel
Kategorija:Mudelli ta' kampjonati bl-eliminatorji	Kategori:Turneringsmallar
Kategorija:Avvenimenti sportivi	Kategori:Sportevenemang
Kategorija:Avvenimenti sportivi futuri	Kategori:Framtida sportevenemang
Kategorija:Avvenimenti futuri	Kategori:Framtida händelser
Kategorija:It-Tieni Gwerra Dinjija	Kategori:Andra världskriget
Kategorija:L-Ewwel Gwerra Dinjija	Kategori:Första världskriget
Kategorija:Plejers ta' AC Milan	Kategori:Spelare i AC Milan
Mudell:L-Ewwel fir-Rankings Mondjali tal-FIFA	Mall:Fifa ranking herr
Kategorija:Logħob tal-mejda	Kategori:Brädspel
Kategorija:Mudelli ta' ċitazzjoni tas-sorsi	Kategori:Källmallar
Mudell:Ħs	Mall:Efter förlängning
Kategorija:UC Sampdoria	Kategori:UC Sampdoria
Mudell:Tim ta' FC Bayern Munich	Mall:FC Bayern München trupp
Kategorija:Tubulidentata	Kategori:Tubulidentata
Kategorija:Klabbs tal-futbol Albaniżi	Kategori:Fotbollsklubbar i Albanien
Kategorija:Kittieba Spanjoli	Kategori:Spanska författare
Kategorija:Klabbs tal-futbol Bjelorussi	Kategori:Fotbollsklubbar i Vitryssland
Kategorija:Klabbs tal-futbol Latvjani	Kategori:Fotbollsklubbar i Lettland
Kategorija:Klabbs tal-futbol Maltin	Kategori:Fotbollsklubbar på Malta
Mudell:Tim ta' Chelsea FC	Mall:Chelsea FC trupp
Kategorija:Mietu fl-1937	Kategori:Avlidna 1937
Kategorija:Mietu fl-1950	Kategori:Avlidna 1950
Kategorija:Angola	Kategori:Angola
Kategorija:Libja	Kategori:Libyen
Kategorija:Marokk	Kategori:Marocko
Kategorija:1480	Kategori:1480
Kategorija:Mietu fl-1595	Kategori:Avlidna 1595
Kategorija:Mietu fl-1597	Kategori:Avlidna 1597
Kategorija:1610	Kategori:1610
Kategorija:Mietu fl-1610	Kategori:Avlidna 1610
Kategorija:Unuri u trofej sportivi	Kategori:Sportpriser
Kategorija:Mietu fl-2011	Kategori:Avlidna 2011
Kategorija:Kantanti Taljani	Kategori:Italienska sångare
Kategorija:Mietu fl-1546	Kategori:Avlidna 1546
Kategorija:1724	Kategori:1724
Kategorija:1748	Kategori:1748
Kategorija:1749	Kategori:1749
Kategorija:1750	Kategori:1750
Kategorija:Mietu fl-1750	Kategori:Avlidna 1750
Kategorija:1756	Kategori:1756
Kategorija:1757	Kategori:1757
Kategorija:1758	Kategori:1758
Kategorija:1759	Kategori:1759
Kategorija:1760	Kategori:1760
Kategorija:1770	Kategori:1770
Kategorija:1772	Kategori:1772
Kategorija:1773	Kategori:1773
Kategorija:Pajjiżi stabbiliti fl-1813	Kategori:Stater och territorier bildade 1813
Kategorija:1782	Kategori:1782
Kategorija:Pajjiżi stabbiliti fl-1814	Kategori:Stater och territorier bildade 1814
Kategorija:1786	Kategori:1786
Kategorija:1791	Kategori:1791
Kategorija:Mietu fl-1791	Kategori:Avlidna 1791
Kategorija:1792	Kategori:1792
Kategorija:Mietu fl-1792	Kategori:Avlidna 1792
Kategorija:1794	Kategori:1794
Kategorija:1801	Kategori:1801
Kategorija:1803	Kategori:1803
Kategorija:1804	Kategori:1804
Kategorija:Mietu fl-1804	Kategori:Avlidna 1804
Kategorija:1807	Kategori:1807
Kategorija:Mietu fl-1807	Kategori:Avlidna 1807
Kategorija:1809	Kategori:1809
Kategorija:1813	Kategori:1813
Kategorija:1815	Kategori:1815
Kategorija:1818	Kategori:1818
Kategorija:Mietu fl-1818	Kategori:Avlidna 1818
Kategorija:Mietu fl-1821	Kategori:Avlidna 1821
Kategorija:1827	Kategori:1827
Kategorija:Mietu fl-1828	Kategori:Avlidna 1828
Kategorija:1830	Kategori:1830
Kategorija:Mietu fl-1832	Kategori:Avlidna 1832
Kategorija:1835	Kategori:1835
Kategorija:1840	Kategori:1840
Kategorija:1842	Kategori:1842
Kategorija:Mietu fl-1842	Kategori:Avlidna 1842
Kategorija:1846	Kategori:1846
Kategorija:1847	Kategori:1847
Kategorija:Mietu fl-1847	Kategori:Avlidna 1847
Kategorija:1848	Kategori:1848
Kategorija:1849	Kategori:1849
Kategorija:1852	Kategori:1852
Kategorija:1853	Kategori:1853
Kategorija:1854	Kategori:1854
Kategorija:1859	Kategori:1859
Kategorija:Mietu fl-1859	Kategori:Avlidna 1859
Kategorija:1860	Kategori:1860
Kategorija:1861	Kategori:1861
Kategorija:Mietu fl-1861	Kategori:Avlidna 1861
Kategorija:1862	Kategori:1862
Kategorija:1864	Kategori:1864
Kategorija:1866	Kategori:1866
Kategorija:1869	Kategori:1869
Kategorija:Mietu fl-1869	Kategori:Avlidna 1869
Kategorija:1870	Kategori:1870
Kategorija:1871	Kategori:1871
Kategorija:1872	Kategori:1872
Kategorija:Mietu fl-1873	Kategori:Avlidna 1873
Kategorija:1874	Kategori:1874
Kategorija:1875	Kategori:1875
Kategorija:1876	Kategori:1876
Kategorija:1877	Kategori:1877
Kategorija:1879	Kategori:1879
Kategorija:1880	Kategori:1880
Kategorija:1881	Kategori:1881
Kategorija:1882	Kategori:1882
Kategorija:1883	Kategori:1883
Kategorija:1884	Kategori:1884
Kategorija:1885	Kategori:1885
Kategorija:1886	Kategori:1886
Kategorija:1887	Kategori:1887
Kategorija:1889	Kategori:1889
Kategorija:1890	Kategori:1890
Kategorija:Mietu fl-1890	Kategori:Avlidna 1890
Kategorija:1891	Kategori:1891
Kategorija:1892	Kategori:1892
Kategorija:1893	Kategori:1893
Kategorija:Mietu fl-1893	Kategori:Avlidna 1893
Kategorija:1894	Kategori:1894
Kategorija:Mietu fl-1894	Kategori:Avlidna 1894
Kategorija:1895	Kategori:1895
Kategorija:Mietu fl-1895	Kategori:Avlidna 1895
Kategorija:1897	Kategori:1897
Kategorija:Mietu fl-1897	Kategori:Avlidna 1897
Kategorija:Mietu fl-1898	Kategori:Avlidna 1898
Kategorija:1899	Kategori:1899
Kategorija:Mietu fl-1900	Kategori:Avlidna 1900
Kategorija:Mietu fl-1901	Kategori:Avlidna 1901
Kategorija:Mietu fl-1905	Kategori:Avlidna 1905
Kategorija:Mietu fl-1915	Kategori:Avlidna 1915
Kategorija:Mietu fl-1916	Kategori:Avlidna 1916
Kategorija:Mietu fl-1917	Kategori:Avlidna 1917
Kategorija:Mietu fl-1918	Kategori:Avlidna 1918
Kategorija:Mietu fl-1920	Kategori:Avlidna 1920
Kategorija:Mietu fl-1921	Kategori:Avlidna 1921
Kategorija:Mietu fl-1925	Kategori:Avlidna 1925
Kategorija:Mietu fl-1926	Kategori:Avlidna 1926
Kategorija:Mietu fl-1927	Kategori:Avlidna 1927
Kategorija:Mietu fl-1935	Kategori:Avlidna 1935
Kategorija:Mietu fl-1936	Kategori:Avlidna 1936
Kategorija:Mietu fl-1939	Kategori:Avlidna 1939
Kategorija:Mietu fl-1940	Kategori:Avlidna 1940
Kategorija:Mietu fl-1954	Kategori:Avlidna 1954
Kategorija:1961	Kategori:1961
Kategorija:1964	Kategori:1964
Kategorija:Mietu fl-1964	Kategori:Avlidna 1964
Kategorija:1965	Kategori:1965
Kategorija:1966	Kategori:1966
Kategorija:1967	Kategori:1967
Kategorija:Mietu fl-1967	Kategori:Avlidna 1967
Kategorija:Mietu fl-1968	Kategori:Avlidna 1968
Kategorija:1969	Kategori:1969
Kategorija:1970	Kategori:1970
Kategorija:Mietu fl-1970	Kategori:Avlidna 1970
Kategorija:Mietu fl-1971	Kategori:Avlidna 1971
Kategorija:1972	Kategori:1972
Kategorija:Mietu fl-1972	Kategori:Avlidna 1972
Kategorija:1973	Kategori:1973
Kategorija:Mietu fl-1973	Kategori:Avlidna 1973
Kategorija:1974	Kategori:1974
Kategorija:1975	Kategori:1975
Kategorija:1976	Kategori:1976
Kategorija:Mietu fl-1977	Kategori:Avlidna 1977
Kategorija:1978	Kategori:1978
Kategorija:1979	Kategori:1979
Kategorija:1980	Kategori:1980
Kategorija:1981	Kategori:1981
Kategorija:1982	Kategori:1982
Kategorija:Mietu fl-1982	Kategori:Avlidna 1982
Kategorija:1983	Kategori:1983
Kategorija:Mietu fl-1983	Kategori:Avlidna 1983
Kategorija:1984	Kategori:1984
Kategorija:Mietu fl-1984	Kategori:Avlidna 1984
Kategorija:1985	Kategori:1985
Kategorija:1986	Kategori:1986
Kategorija:1987	Kategori:1987
Kategorija:Mietu fl-1987	Kategori:Avlidna 1987
Kategorija:1988	Kategori:1988
Kategorija:1989	Kategori:1989
Kategorija:Mietu fl-1989	Kategori:Avlidna 1989
Kategorija:1990	Kategori:1990
Kategorija:Mietu fl-1990	Kategori:Avlidna 1990
Kategorija:1991	Kategori:1991
Kategorija:1992	Kategori:1992
Kategorija:1993	Kategori:1993
Kategorija:1994	Kategori:1994
Kategorija:1995	Kategori:1995
Kategorija:Mietu fl-1995	Kategori:Avlidna 1995
Kategorija:Fußball-Bundesliga	Kategori:Fußball-Bundesliga
Kategorija:1996	Kategori:1996
Kategorija:Mietu fl-1996	Kategori:Avlidna 1996
Kategorija:1997	Kategori:1997
Kategorija:Mietu fl-1997	Kategori:Avlidna 1997
Kategorija:1999	Kategori:1999
Kategorija:2000	Kategori:2000
Kategorija:Mietu fl-2000	Kategori:Avlidna 2000
Kategorija:2001	Kategori:2001
Kategorija:Mietu fl-2001	Kategori:Avlidna 2001
Kategorija:2002	Kategori:2002
Kategorija:Mietu fl-2002	Kategori:Avlidna 2002
Kategorija:Mietu fl-2003	Kategori:Avlidna 2003
Kategorija:2004	Kategori:2004
Kategorija:Mietu fl-2004	Kategori:Avlidna 2004
Kategorija:2005	Kategori:2005
Kategorija:2006	Kategori:2006
Kategorija:Mietu fl-2006	Kategori:Avlidna 2006
Kategorija:2007	Kategori:2007
Kategorija:2008	Kategori:2008
Kategorija:2009	Kategori:2009
Kategorija:2010	Kategori:2010
Kategorija:2011	Kategori:2011
Kategorija:Ajruporti skont il-pajjiż	Kategori:Flygplatser efter land
Kategorija:Pajjiżi gżejjer	Kategori:Östater
Kategorija:Pajjiżi interkjużi	Kategori:Kustlösa stater
Kategorija:Politika ta' Malta	Kategori:Politik på Malta
Kategorija:Ġurnalisti Franċiżi	Kategori:Franska journalister
Kategorija:Grawnds tal-futbol fl-Italja	Kategori:Fotbollsanläggningar i Italien
Mudell:Amerika t'Isfel	Mall:Sydamerika metamall
Kategorija:Futbol fil-Gambja	Kategori:Fotboll i Gambia
Kategorija:Futbol fil-Greċja	Kategori:Fotboll i Grekland
Kategorija:Futbol fin-Niġerja	Kategori:Fotboll i Nigeria
Kategorija:Futbol fl-Afrika t'Isfel	Kategori:Fotboll i Sydafrika
Kategorija:Futbol fil-Latvja	Kategori:Fotboll i Lettland
Kategorija:Futbol fir-Rumanija	Kategori:Fotboll i Rumänien
Kategorija:Futbol fil-Litwanja	Kategori:Fotboll i Litauen
Kategorija:Futbol fil-Montenegro	Kategori:Fotboll i Montenegro
Kategorija:Futbol f'Malta	Kategori:Fotboll i Malta
Kategorija:Futbol fl-Istati Uniti	Kategori:Fotboll i USA
Kategorija:Futbol fil-Belġju	Kategori:Fotboll i Belgien
Kategorija:Futbol fil-Bożnija u Ħerżegovina	Kategori:Fotboll i Bosnien och Hercegovina
Kategorija:Futbol fil-Bulgarija	Kategori:Fotboll i Bulgarien
Kategorija:Futbol fis-Serbja	Kategori:Fotboll i Serbien
Kategorija:Futbol fl-Unjoni Sovjetika	Kategori:Fotboll i Sovjetunionen
Kategorija:Timijiet parteċipanti fit-Tazza tad-Dinja tal-Futbol	Kategori:Spelartruppsmallar i VM i fotboll
Kategorija:Futbol fl-Iżvizzera	Kategori:Fotboll i Schweiz
Kategorija:Futbol fl-Iskozja	Kategori:Fotboll i Skottland
Kategorija:Futbol fis-Slovakkja	Kategori:Fotboll i Slovakien
Kategorija:Futbol fl-Arġentina	Kategori:Fotboll i Argentina
Kategorija:Futbol fl-Iżlanda	Kategori:Fotboll i Island
Kategorija:Futbol fl-Irlanda	Kategori:Fotboll i Irland
Kategorija:Futbol fl-Albanija	Kategori:Fotboll i Albanien
Kategorija:Futbol fl-Angola	Kategori:Fotboll i Angola
Kategorija:Futbol fl-Estonja	Kategori:Fotboll i Estland
Kategorija:Futbol fl-Awstralja	Kategori:Fotboll i Australien
Kategorija:Futbol f'Wales	Kategori:Fotboll i Wales
Kategorija:Futbol fl-Iżrael	Kategori:Fotboll i Israel
Kategorija:Futbol fiċ-Ċina	Kategori:Fotboll i Kina
Kategorija:Futbol fil-Kamerun	Kategori:Fotboll i Kamerun
Kategorija:Futbol fil-Kosta tal-Avorju	Kategori:Fotboll i Elfenbenskusten
Kategorija:Futbol f'Ċipru	Kategori:Fotboll i Cypern
Mudell:Utent ru-1	Mall:Användare ru-1
Mudell:Utent uk-4	Mall:Användare uk-4
Kategorija:Poeti skont in-nazzjonalità	Kategori:Poeter efter nationalitet
Kategorija:Mużiċisti skont in-nazzjonalità	Kategori:Musiker efter nationalitet
Kategorija:Skulturi skont in-nazzjonalità tagħhom	Kategori:Skulptörer efter land
Kategorija:Filosfi skont in-nazzjonalità	Kategori:Filosofer efter nationalitet
Kategorija:Vulkani skont il-pajjiż	Kategori:Vulkaner efter land
Kategorija:Storja ta' Malta	Kategori:Maltas historia
Mudell:Dati pajjiż Beliże	Mall:Landsdata Belize
Kategorija:Futbol fil-Gana	Kategori:Fotboll i Ghana
Kategorija:Futbol fl-Olanda	Kategori:Fotboll i Nederländerna
Kategorija:Futbol fin-Norveġja	Kategori:Fotboll i Norge
Kategorija:Futbol fil-Ġermanja	Kategori:Fotboll i Tyskland
Kategorija:Futbol fil-Bjelorussja	Kategori:Fotboll i Vitryssland
Kategorija:Futbol fl-Irlanda ta' Fuq	Kategori:Fotboll i Nordirland
Kategorija:Futbol fil-Brażil	Kategori:Fotboll i Brasilien
Kategorija:Futbol fl-Armenja	Kategori:Fotboll i Armenien
Kategorija:Futbol fl-Ażerbajġan	Kategori:Fotboll i Azerbajdzjan
Kategorija:Futbol fl-Awstrija	Kategori:Fotboll i Österrike
Kategorija:Futbol fl-Urugwaj	Kategori:Fotboll i Uruguay
Kategorija:Futbol fl-Italja	Kategori:Fotboll i Italien
Mudell:Dati pajjiż Jugożlavja	Mall:Landsdata Jugoslavien
Kategorija:Futbol fl-Ingilterra	Kategori:Fotboll i England
Kategorija:Futbol fir-Repubblika Ċeka	Kategori:Fotboll i Tjeckien
Kategorija:Futbol fil-Każakistan	Kategori:Fotboll i Kazakstan
Kategorija:Futbol fil-Kolombja	Kategori:Fotboll i Colombia
Kategorija:Futbol fit-Turkija	Kategori:Fotboll i Turkiet
Kategorija:Futbol fil-Portugall	Kategori:Fotboll i Portugal
Kategorija:Futbol fl-Ungerija	Kategori:Fotboll i Ungern
Mudell:TwoLegResult	Mall:TwoLeg result
Kategorija:Festival tal-Eurovision	Kategori:Eurovision Song Contest
Kategorija:Kowċis Arġentini	Kategori:Argentinska fotbollstränare
Kategorija:Kowċis Awstrijaċi	Kategori:Österrikiska fotbollstränare
Kategorija:Kowċis Belġjani	Kategori:Belgiska fotbollstränare
Kategorija:Kowċis Brażiljani	Kategori:Brasilianska fotbollstränare
Kategorija:Kowċis Ingliżi	Kategori:Engelska fotbollstränare
Kategorija:Kowċis Skoċċiżi	Kategori:Skotska fotbollstränare
Kategorija:Teatru	Kategori:Teater
Kategorija:Kowċis Kroati	Kategori:Kroatiska fotbollstränare
Kategorija:Kowċis Ġermaniżi	Kategori:Tyska fotbollstränare
Mudell:Dati pajjiż Kosovo	Mall:Landsdata Kosovo
Kategorija:Kantanti skont in-nazzjonalità	Kategori:Sångare efter nationalitet
Kategorija:Kowċis Rumeni	Kategori:Rumänska fotbollstränare
Kategorija:Kowċis Spanjoli	Kategori:Spanska fotbollstränare
Kategorija:Futbolers Albaniżi	Kategori:Albanska fotbollsspelare
Kategorija:Futbolers Angoliżi	Kategori:Angolanska fotbollsspelare
Kategorija:Futbolers Arġentini	Kategori:Argentinska fotbollsspelare
Kategorija:Futbolers Armeni	Kategori:Armeniska fotbollsspelare
Kategorija:Futbolers Awstraljani	Kategori:Australiska fotbollsspelare
Kategorija:Futbolers Awstrijaċi	Kategori:Österrikiska fotbollsspelare
Kategorija:Futbolers Bożnijaċi	Kategori:Bosniska fotbollsspelare
Kategorija:Futbolers Brażiljani	Kategori:Brasilianska fotbollsspelare
Kategorija:Futbolers Ingliżi	Kategori:Engelska fotbollsspelare
Mudell:Dati pajjiż Abkażja	Mall:Landsdata Abchazien
Kategorija:Kantanti Żvediżi	Kategori:Svenska sångare
Kategorija:Kantanti Iżlandiżi	Kategori:Isländska sångare
Kategorija:Kantanti Iżraeljani	Kategori:Israeliska sångare
Kategorija:Kantanti Pollakki	Kategori:Polska sångare
Kategorija:Kantanti Franċiżi	Kategori:Franska sångare
Mudell:Dati pajjiż Aruba	Mall:Landsdata Aruba
Kategorija:Utenti nl	Kategori:Användare nl
Kategorija:Ekonomisti Russi	Kategori:Ryska nationalekonomer
Kategorija:Utenti nn-3	Kategori:Användare nn-3
Kategorija:Utenti no-2	Kategori:Användare no-2
Kategorija:Utenti no	Kategori:Användare no
Kategorija:Utenti zh-1	Kategori:Användare zh-1
Kategorija:Armenja	Kategori:Armenien
Kategorija:Fiżiċi Brittaniċi	Kategori:Brittiska fysiker
Mudell:Dati pajjiż Antigwa u Barbuda	Mall:Landsdata Antigua och Barbuda
Mudell:Dati pajjiż Stati Federati tal-Mikroneżja	Mall:Landsdata Mikronesiens federerade stater
Kategorija:Pajjiżi stabbiliti fl-1992	Kategori:Stater och territorier bildade 1992
Kategorija:Atturi Taljani	Kategori:Italienska skådespelare
Kategorija:Pajjiżi skond is-sena li ġew stabbiliti	Kategori:Stater och territorier efter bildande
Kategorija:Finanza	Kategori:Finansväsen
Kategorija:Diskografiji	Kategori:Diskografier
Kategorija:Kompetizzjonijiet tal-futbol	Kategori:Fotbollstävlingar
Kategorija:Uffiċjali tal-pulizija Belġjani	Kategori:Belgiska poliser
Kategorija:Sports għal persuni b'diżabbilità	Kategori:Handikappidrott
Kategorija:Sports ta' studenti	Kategori:Studentidrott
Kategorija:Rumanziera Spanjoli	Kategori:Spanska romanförfattare
Kategorija:Televiżjoni	Kategori:Television
Kategorija:Prim Ministri ta' Malta	Kategori:Maltas premiärministrar
Kategorija:Mietu fl-1945	Kategori:Avlidna 1945
Kategorija:Mietu fl-1963	Kategori:Avlidna 1963
Kategorija:1832	Kategori:1832
Kategorija:Mietu fl-1930	Kategori:Avlidna 1930
Kategorija:1822	Kategori:1822
Kategorija:Skulturi	Kategori:Skulptörer
Kategorija:Seklu 14	Kategori:1300-talet
Kategorija:Seklu 13	Kategori:1200-talet
Kategorija:Seklu 16	Kategori:1500-talet
Kategorija:Seklu 12	Kategori:1100-talet
Kategorija:Seklu 18	Kategori:1700-talet
Kategorija:Kompożituri Russi	Kategori:Ryska kompositörer
Kategorija:Kompożituri Franċiżi	Kategori:Franska kompositörer
Kategorija:Kompożituri Barokki	Kategori:Barockkompositörer
Kategorija:Kompożituri Pollakki	Kategori:Polska kompositörer
Kategorija:Kompożituri Ġermaniżi	Kategori:Tyska kompositörer
Kategorija:Kompożituri Awstrijaċi	Kategori:Österrikiska kompositörer
Kategorija:Mużiċisti Pollakki	Kategori:Polska musiker
Kategorija:Skulturi Taljani	Kategori:Italienska skulptörer
Kategorija:Storiċi Russi	Kategori:Ryska historiker
Kategorija:Mużiċisti Norveġiżi	Kategori:Norska musiker
Kategorija:Mużiċisti Daniżi	Kategori:Danska musiker
Kategorija:Mużiċisti Russi	Kategori:Ryska musiker
Kategorija:Mużiċisti Brażiljani	Kategori:Brasilianska musiker
Kategorija:Mużiċisti Żvediżi	Kategori:Svenska musiker
Kategorija:Mużiċisti Irlandiżi	Kategori:Irländska musiker
Kategorija:Mużiċisti Brittaniċi	Kategori:Brittiska musiker
Kategorija:Mużiċisti Taljani	Kategori:Italienska musiker
Kategorija:Mużiċisti Ġeorġjani	Kategori:Georgiska musiker
Kategorija:Mużiċisti Kanadiżi	Kategori:Kanadensiska musiker
Kategorija:Mużiċisti Franċiżi	Kategori:Franska musiker
Kategorija:1829	Kategori:1829
Kategorija:Kompożituri Rumeni	Kategori:Rumänska kompositörer
Kategorija:Kompożituri Taljani	Kategori:Italienska kompositörer
Kategorija:Mużiċisti Ġermaniżi	Kategori:Tyska musiker
Kategorija:Politiċi Maltin	Kategori:Maltesiska politiker
Kategorija:Politiċi Taljani	Kategori:Italienska politiker
Kategorija:Politiċi Franċiżi	Kategori:Franska politiker
Kategorija:Filosfi Griegi	Kategori:Grekiska filosofer
Kategorija:Filosfi Ġermaniżi	Kategori:Tyska filosofer
Kategorija:Filosfi Brittaniċi	Kategori:Brittiska filosofer
Kategorija:Bavarja	Kategori:Bayern
Kategorija:Futbolers Niġerjani	Kategori:Nigerianska fotbollsspelare
Kategorija:Futbolers Rumeni	Kategori:Rumänska fotbollsspelare
Kategorija:Futbolers Bulgari	Kategori:Bulgariska fotbollsspelare
Kategorija:Futbolers Żvediżi	Kategori:Svenska fotbollsspelare
Kategorija:Futbolers Skoċċiżi	Kategori:Skotska fotbollsspelare
Kategorija:.NET	Kategori:.NET Framework
Kategorija:Futbolers Ekwadorjani	Kategori:Ecuadorianska fotbollsspelare
Kategorija:Futbolers Urugwajani	Kategori:Uruguayanska fotbollsspelare
Kategorija:Futbolers Eġizzjani	Kategori:Egyptiska fotbollsspelare
Kategorija:Futbolers Ċiniżi	Kategori:Kinesiska fotbollsspelare
Kategorija:Futbolers Franċiżi	Kategori:Franska fotbollsspelare
Kategorija:Teorija tal-logħob	Kategori:Spelteori
Kategorija:1789	Kategori:1789
Kategorija:Mietu fl-1809	Kategori:Avlidna 1809
Kategorija:1821	Kategori:1821
Kategorija:1828	Kategori:1828
Kategorija:1841	Kategori:1841
Kategorija:1867	Kategori:1867
Kategorija:1873	Kategori:1873
Kategorija:1878	Kategori:1878
Kategorija:1896	Kategori:1896
Kategorija:1963	Kategori:1963
Kategorija:Mietu fl-1981	Kategori:Avlidna 1981
Kategorija:Mietu fl-1999	Kategori:Avlidna 1999
Kategorija:2012	Kategori:2012
Kategorija:Sportivi Sud-Koreani	Kategori:Sydkoreanska idrottare
Kategorija:Imprendituri Amerikani	Kategori:Personer inom USA:s näringsliv
Kategorija:Inventuri Brittaniċi	Kategori:Brittiska uppfinnare
Kategorija:Futbolers Torok	Kategori:Turkiska fotbollsspelare
Kategorija:Futbolers Montenegrini	Kategori:Montenegrinska fotbollsspelare
Kategorija:Futbolers Żvizzeri	Kategori:Schweiziska fotbollsspelare
Kategorija:Futbolers Spanjoli	Kategori:Spanska fotbollsspelare
Kategorija:Futbolers Ungeriżi	Kategori:Ungerska fotbollsspelare
Kategorija:Futbolers Serbi	Kategori:Serbiska fotbollsspelare
Kategorija:Futbolers Taljani	Kategori:Italienska fotbollsspelare
Kategorija:Futbolers Daniżi	Kategori:Danska fotbollsspelare
Kategorija:Futbolers Galliċi	Kategori:Walesiska fotbollsspelare
Kategorija:Futbolers Nord-Irlandiżi	Kategori:Nordirländska fotbollsspelare
Kategorija:Futbolers Irlandiżi	Kategori:Irländska fotbollsspelare
Kategorija:Futbolers Kolombjani	Kategori:Colombianska fotbollsspelare
Kategorija:Futbolers Kroati	Kategori:Kroatiska fotbollsspelare
Kategorija:Futbolers Portugiżi	Kategori:Portugisiska fotbollsspelare
Kategorija:Kantanti Norveġiżi	Kategori:Norska sångare
Kategorija:Kantanti Brażiljani	Kategori:Brasilianska sångare
Kategorija:Kantanti Russi	Kategori:Ryska sångare
Kategorija:Kantanti Daniżi	Kategori:Danska sångare
Kategorija:Denominazzjonijiet Kristjani	Kategori:Kristna samfund
Kategorija:Kategoriji ta' abbozzi	Kategori:Alla stubkategorier
Kategorija:Abbozzi tat-trasport	Kategori:Transportstubbar
Kategorija:Abbozzi tal-militar	Kategori:Militärstubbar
Kategorija:Abbozzi tal-matematika	Kategori:Matematikstubbar
Kategorija:Abbozzi tal-bijoloġija	Kategori:Biologistubbar
Kategorija:Abbozzi tal-ġeografija	Kategori:Geografistubbar
Kategorija:Abbozzi ta' ikel u xorb	Kategori:Matstubbar
Kategorija:Seklu 15	Kategori:1400-talet
Kategorija:Mietu fis-seklu 16	Kategori:Avlidna 1500-talet
Kategorija:Mietu fis-seklu 17	Kategori:Avlidna 1600-talet
Kategorija:Mietu fis-seklu 18	Kategori:Avlidna 1700-talet
Kategorija:Mietu fis-seklu 19	Kategori:Avlidna 1800-talet
Kategorija:Mietu fis-seklu 20	Kategori:Avlidna 1900-talet
Kategorija:Mietu fis-seklu 21	Kategori:Avlidna 2000-talet
Kategorija:Futbol fi New Zealand	Kategori:Fotboll i Nya Zeeland
Kategorija:Futbol fil-Messiku	Kategori:Fotboll i Mexiko
Kategorija:Futbol fl-Iżvezja	Kategori:Fotboll i Sverige
Kategorija:Futbol fl-Ukrajna	Kategori:Fotboll i Ukraina
Kategorija:Futbol fil-Kroazja	Kategori:Fotboll i Kroatien
Kategorija:Futbol fi Franza	Kategori:Fotboll i Frankrike
Kategorija:Ġeorġja	Kategori:Georgien
Kategorija:Taljani skont ix-xogħol tagħhom	Kategori:Italienare efter yrke
Kategorija:Kantanti Amerikani	Kategori:Amerikanska sångare
Kategorija:Bijoloġi Brittaniċi	Kategori:Brittiska biologer
Kategorija:Probabbiltà u statistika	Kategori:Sannolikhet och statistik
Kategorija:Mużiċisti Żvizzeri	Kategori:Schweiziska musiker
Kategorija:Mużiċisti Armeni	Kategori:Armeniska musiker
Kategorija:Mużiċisti Ażerbajġani	Kategori:Azeriska musiker
Kategorija:Mużiċisti Iżraeljani	Kategori:Israeliska musiker
Kategorija:Ġeoloġi Brittaniċi	Kategori:Brittiska geologer
Kategorija:Futbolers Ganiżi	Kategori:Ghananska fotbollsspelare
Kategorija:1727	Kategori:1727
Kategorija:1744	Kategori:1744
Kategorija:1808	Kategori:1808
Kategorija:1824	Kategori:1824
Kategorija:Mietu fl-1835	Kategori:Avlidna 1835
Kategorija:Mietu fl-1868	Kategori:Avlidna 1868
Kategorija:Mietu fl-1888	Kategori:Avlidna 1888
Kategorija:Mietu fl-1933	Kategori:Avlidna 1933
Kategorija:Mietu fl-1961	Kategori:Avlidna 1961
Kategorija:1968	Kategori:1968
Kategorija:Futbol fir-Russja	Kategori:Fotboll i Ryssland
Kategorija:Futbol fl-Ekwador	Kategori:Fotboll i Ecuador
Kategorija:Futbol fl-Eġittu	Kategori:Fotboll i Egypten
Mudell:Dati pajjiż Repubblika Ċentru-Afrikana	Mall:Landsdata Centralafrikanska republiken
Kategorija:Kantanti Torok	Kategori:Turkiska sångare
Kategorija:Plejers ta' FC Spartak Moscow	Kategori:Spelare i FC Spartak Moskva
Kategorija:Futbol fl-Andorra	Kategori:Fotboll i Andorra
Kategorija:Nies Maltin	Kategori:Malteser
Kategorija:Matematiċi Brittaniċi	Kategori:Brittiska matematiker
Mudell:Infobox Eurovision	Mall:ESC-fakta
Kategorija:Mużiċisti Belġjani	Kategori:Belgiska musiker
Kategorija:Futbolers Gambjani	Kategori:Gambiska fotbollsspelare
Kategorija:Futbolers Griegi	Kategori:Grekiska fotbollsspelare
Kategorija:Futbolers Sud-Afrikani	Kategori:Sydafrikanska fotbollsspelare
Kategorija:Futbolers Litwani	Kategori:Litauiska fotbollsspelare
Kategorija:Futbolers Maċedoni	Kategori:Makedonska fotbollsspelare
Kategorija:Futbolers Maltin	Kategori:Maltesiska fotbollsspelare
Kategorija:Futbolers Senegaliżi	Kategori:Senegalesiska fotbollsspelare
Kategorija:Futbolers Iżlandiżi	Kategori:Isländska fotbollsspelare
Kategorija:Futbolers Iżraeljani	Kategori:Israeliska fotbollsspelare
Kategorija:Futbolers Kamerunjani	Kategori:Kamerunska fotbollsspelare
Kategorija:1817	Kategori:1817
Kategorija:1898	Kategori:1898
Kategorija:1998	Kategori:1998
Mudell:Klassifika tal-futbol tmiem	Mall:Fb cl footer
Kategorija:Libanu	Kategori:Libanon
Kategorija:Mietu fis-seklu 15	Kategori:Avlidna 1400-talet
Kategorija:Kantanti Ġermaniżi	Kategori:Tyska sångare
Kategorija:Kantanti Belġjani	Kategori:Belgiska sångare
Kategorija:Mużiċisti Iżlandiżi	Kategori:Isländska musiker
Kategorija:Kompożituri Irlandiżi	Kategori:Irländska kompositörer
Kategorija:Futbolers Messikani	Kategori:Mexikanska fotbollsspelare
Kategorija:2003	Kategori:2003
Kategorija:Mietu fis-seklu 14	Kategori:Avlidna 1300-talet
Kategorija:Futbol fid-Danimarka	Kategori:Fotboll i Danmark
Kategorija:Mudelli tal-Unjoni Ewropea	Kategori:EU-mallar
Kategorija:Xjenzati Brittaniċi	Kategori:Brittiska forskare
Kategorija:Mudelli tal-klabbs tal-futbol Taljani	Kategori:Spelartruppsmallar för klubblag - Italien
Kategorija:1971	Kategori:1971
Kategorija:Mietu fis-seklu 13	Kategori:Avlidna 1200-talet
Mudell:Isem tal-lingwa	Mall:Språknamn
Kategorija:Abbozzi tal-politika	Kategori:Politikstubbar
Kategorija:Abbozzi tal-astronomija	Kategori:Astronomistubbar
Kategorija:Abbozzi tal-istorja	Kategori:Historiestubbar
Kategorija:Abbozzi tal-arti	Kategori:Konststubbar
Kategorija:Abbozzi tar-reliġjon	Kategori:Religionsstubbar
Kategorija:Abbozzi tat-teknoloġija	Kategori:Teknikstubbar
Kategorija:Abbozzi tal-ekonomija	Kategori:Ekonomistubbar
Kategorija:Futbol Asjatiku	Kategori:Fotboll i Asien
Kategorija:Futbol fl-Afrika	Kategori:Fotboll i Afrika
Kategorija:Futbol fl-Amerika t'Isfel	Kategori:Fotboll i Sydamerika
Kategorija:Futbol fl-Ewropa	Kategori:Fotboll i Europa
Kategorija:Futbol fl-Oċeanja	Kategori:Fotboll i Oceanien
Kategorija:Futbol skont il-kontinent	Kategori:Fotboll efter världsdel
Kategorija:Plejers ta' PSV Eindhoven	Kategori:Spelare i PSV Eindhoven
Kategorija:Plejers ta' Aston Villa FC	Kategori:Spelare i Aston Villa FC
Kategorija:Plejers ta' CA Osasuna	Kategori:Spelare i CA Osasuna
Kategorija:Plejers ta' AFC Ajax	Kategori:Spelare i AFC Ajax
Kategorija:Plejers ta' MSV Duisburg	Kategori:Spelare i MSV Duisburg
Kategorija:Plejers ta' Empoli FC	Kategori:Spelare i Empoli FC
Kategorija:Plejers ta' Eintracht Braunschweig	Kategori:Spelare i Eintracht Braunschweig
Kategorija:Plejers tal-Fußball-Bundesliga	Kategori:Spelare i Fußball-Bundesliga
Kategorija:Plejers ta' La Liga	Kategori:Spelare i La Liga
Kategorija:Plejers tal-Premier League	Kategori:Spelare i Premier League
Kategorija:Plejers tas-Serie A	Kategori:Spelare i Serie A
Kategorija:Plejers tal-Primeira Liga	Kategori:Spelare i Primeira Liga
Kategorija:Plejers tal-Ewwel Diviżjoni Belġjana	Kategori:Spelare i Jupiler League
Kategorija:Futbolers fil-Bulgarija skont il-klabb	Kategori:Fotbollsspelare i klubblag i Bulgarien
Kategorija:Plejers tal-Ligue 1	Kategori:Spelare i Ligue 1
Kategorija:Plejers ta' Tippeligaen	Kategori:Spelare i Tippeligaen
Kategorija:Plejers tal-Eredivisie	Kategori:Spelare i Eredivisie
Kategorija:Plejers ta' Red Star Belgrade	Kategori:Spelare i Röda Stjärnan
Kategorija:Plejers ta' FC Basel	Kategori:Spelare i FC Basel
Kategorija:Plejers ta' Bayer 04 Leverkusen	Kategori:Spelare i Bayer Leverkusen
Kategorija:Plejers ta' Birmingham City FC	Kategori:Spelare i Birmingham City FC
Kategorija:Plejers ta' Blackburn Rovers FC	Kategori:Spelare i Blackburn Rovers FC
Kategorija:Plejers ta' VfL Bochum	Kategori:Spelare i VfL Bochum
Kategorija:Plejers ta' Portsmouth FC	Kategori:Spelare i Portsmouth FC
Kategorija:Plejers ta' Borussia Dortmund	Kategori:Spelare i Borussia Dortmund
Kategorija:Plejers ta' Bolton Wanderers FC	Kategori:Spelare i Bolton Wanderers FC
Kategorija:Plejers ta' Piacenza Calcio	Kategori:Spelare i Piacenza Calcio
Kategorija:Plejers ta' Charlton Athletic FC	Kategori:Spelare i Charlton Athletic FC
Kategorija:Plejers ta' Torino FC	Kategori:Spelare i Torino FC
Kategorija:Plejers ta' Genoa CFC	Kategori:Spelare i Genoa CFC
Kategorija:Plejers tas-Serie B	Kategori:Spelare i Serie B
Kategorija:Plejers ta' FC Dynamo Moscow	Kategori:Spelare i FC Dynamo Moskva
Kategorija:Plejers ta' Stade de Reims	Kategori:Spelare i Stade de Reims
Kategorija:Plejers ta' Racing de Santander	Kategori:Spelare i Racing Santander
Kategorija:Plejers ta' Real Valladolid	Kategori:Spelare i Real Valladolid
Kategorija:Plejers ta' R. Charleroi SC	Kategori:Spelare i R Charleroi SC
Kategorija:Plejers ta' Sporting de Gijón	Kategori:Spelare i Sporting de Gijón
Kategorija:Plejers ta' Real Sociedad	Kategori:Spelare i Real Sociedad
Kategorija:Plejers ta' RCD Mallorca	Kategori:Spelare i RCD Mallorca
Kategorija:Plejers ta' Recreativo de Huelva	Kategori:Spelare i Recreativo de Huelva
Kategorija:Plejers ta' FC Zürich	Kategori:Spelare i FC Zürich
Kategorija:Plejers ta' UC Sampdoria	Kategori:Spelare i UC Sampdoria
Kategorija:Plejers ta' Santos Futebol Clube	Kategori:Spelare i Santos FC
Kategorija:Plejers ta' São Paulo Futebol Clube	Kategori:Spelare i São Paulo FC
Kategorija:Plejers ta' Sporting Clube de Portugal	Kategori:Spelare i Sporting Lissabon
Kategorija:Plejers ta' Stoke City FC	Kategori:Spelare i Stoke City FC
Kategorija:Plejers ta' Sunderland AFC	Kategori:Spelare i Sunderland AFC
Kategorija:Plejers ta' VfB Stuttgart	Kategori:Spelare i VfB Stuttgart
Kategorija:Plejers ta' Sheffield Wednesday FC	Kategori:Spelare i Sheffield Wednesday FC
Kategorija:Plejers ta' Sheffield United FC	Kategori:Spelare i Sheffield United FC
Kategorija:Plejers ta' Grêmio Foot-Ball Porto Alegrense	Kategori:Spelare i Grêmio FBPA
Kategorija:Plejers ta' KAA Gent	Kategori:Spelare i KAA Gent
Mudell:Dati pajjiż Wales	Mall:Landsdata Wales
Kategorija:Plejers ta' Fluminense Football Club	Kategori:Spelare i Fluminense FC
Kategorija:Plejers ta' Fulham FC	Kategori:Spelare i Fulham FC
Kategorija:Plejers ta' FC Carl Zeiss Jena	Kategori:Spelare i FC Carl Zeiss Jena
Kategorija:Plejers ta' Cagliari Calcio	Kategori:Spelare i Cagliari Calcio
Kategorija:Plejers ta' AS Cannes	Kategori:Spelare i AS Cannes
Kategorija:Plejers ta' 1. FC Kaiserslautern	Kategori:Spelare i FC Kaiserslautern
Kategorija:Futbolers fi Spanja skont il-klabb	Kategori:Fotbollsspelare i klubblag i Spanien
Kategorija:Futbolers fl-Iskozja skont il-klabb	Kategori:Fotbollsspelare i klubblag i Skottland
Kategorija:Futbolers fil-Portugall skont il-klabb	Kategori:Fotbollsspelare i klubblag i Portugal
Kategorija:Futbolers fl-Ungerija skont il-klabb	Kategori:Fotbollsspelare i klubblag i Ungern
Kategorija:Futbolers fir-Russja skont il-klabb	Kategori:Fotbollsspelare i klubblag i Ryssland
Kategorija:Futbolers fir-Rumanija skont il-klabb	Kategori:Fotbollsspelare i klubblag i Rumänien
Kategorija:Plejers ta' Cruzeiro Esporte Clube	Kategori:Spelare i Cruzeiro EC
Kategorija:Plejers ta' Queens Park Rangers FC	Kategori:Spelare i Queens Park Rangers FC
Kategorija:Imwiet skont is-sena	Kategori:Avlidna
Mudell:Dati pajjiż Papwa Ginea Ġdida	Mall:Landsdata Papua Nya Guinea
Kategorija:Plejers ta' Calcio Lecco 1912	Kategori:Spelare i Calcio Lecco 1912
Kategorija:Plejers ta' US Lecce	Kategori:Spelare i US Lecce
Kategorija:San Marino	Kategori:San Marino
Kategorija:Liechtenstein	Kategori:Liechtenstein
Kategorija:Andorra	Kategori:Andorra
Kategorija:Serbja	Kategori:Serbien
Kategorija:Albanija	Kategori:Albanien
Kategorija:Pajjiżi tal-Karibew	Kategori:Västindiens länder
Kategorija:Pajjiżi tal-Oċeanja	Kategori:Oceaniens länder
Kategorija:Pajjiżi tal-Amerika ta' Fuq	Kategori:Nordamerikas länder
Kategorija:Klabbs tal-futbol Litwani	Kategori:Fotbollsklubbar i Litauen
Kategorija:Plejers ta' Modena FC	Kategori:Spelare i Modena FC
Kategorija:Plejers ta' AC Monza Brianza 1912	Kategori:Spelare i AC Monza Brianza 1912
Kategorija:Plejers ta' SSC Napoli	Kategori:Spelare i SSC Napoli
Kategorija:Plejers ta' Calcio Padova	Kategori:Spelare i Calcio Padova
Kategorija:Plejers ta' Perugia Calcio	Kategori:Spelare i Perugia Calcio
Kategorija:Plejers ta' Burnley FC	Kategori:Spelare i Burnley FC
Kategorija:Plejers ta' Getafe CF	Kategori:Spelare i Getafe CF
Kategorija:Plejers ta' Swansea City AFC	Kategori:Spelare i Swansea City AFC
Kategorija:Plejers ta' Villarreal CF	Kategori:Spelare i Villarreal CF
Kategorija:Plejers ta' Málaga CF	Kategori:Spelare i Málaga CF
Kategorija:Plejers ta' Watford FC	Kategori:Spelare i Watford FC
Kategorija:Plejers ta' Novara Calcio	Kategori:Spelare i Novara Calcio
Kategorija:Plejers ta' Newcastle United FC	Kategori:Spelare i Newcastle United FC
Kategorija:Plejers ta' Hannover 96	Kategori:Spelare i Hannover 96
Kategorija:Plejers ta' Huddersfield Town FC	Kategori:Spelare i Huddersfield Town AFC
Kategorija:Plejers ta' Hertha BSC	Kategori:Spelare i Hertha BSC Berlin
Kategorija:Plejers ta' Hellas Verona FC	Kategori:Spelare i Hellas Verona FC
Kategorija:Plejers ta' Wolverhampton Wanderers FC	Kategori:Spelare i Wolverhampton Wanderers FC
Kategorija:Plejers ta' Wigan Athletic FC	Kategori:Spelare i Wigan Athletic FC
Kategorija:Plejers ta' West Bromwich Albion FC	Kategori:Spelare i West Bromwich Albion FC
Kategorija:Plejers tas-Süper Lig	Kategori:Spelare i Süper Lig
Kategorija:Rebbieħa tal-Festival tal-Eurovision	Kategori:Artister som vunnit i Eurovision Song Contest
Kategorija:Referis tal-futbol Ingliżi	Kategori:Fotbollsdomare från England
Kategorija:Referis tal-futbol Taljani	Kategori:Fotbollsdomare från Italien
Kategorija:Plejers ta' FC Barcelona	Kategori:Spelare i FC Barcelona
Kategorija:Plejers ta' Valencia CF	Kategori:Spelare i Valencia CF
Kategorija:Plejers ta' Liverpool FC	Kategori:Spelare i Liverpool FC
Kategorija:Plejers ta' FC Bayern Munich	Kategori:Spelare i FC Bayern München
Kategorija:Plejers ta' Manchester City FC	Kategori:Spelare i Manchester City FC
Kategorija:Plejers ta' Atlético Madrid	Kategori:Spelare i Atlético Madrid
Kategorija:Plejers ta' Arsenal FC	Kategori:Spelare i Arsenal FC
Kategorija:Plejers ta' FC Porto	Kategori:Spelare i FC Porto
Kategorija:Plejers ta' AS Roma	Kategori:Spelare i AS Roma
Kategorija:Timijiet nazzjonali tal-futbol	Kategori:Fotbollslandslag
Kategorija:Reġjuni tal-Ewropa	Kategori:Regioner i Europa
Kategorija:Vulkani tal-Italja	Kategori:Vulkaner i Italien
Kategorija:Antropoloġija	Kategori:Antropologi
Kategorija:Pajjiżi stabbiliti fl-1801	Kategori:Stater och territorier bildade 1801
Kategorija:Pajjiżi stabbiliti fl-1803	Kategori:Stater och territorier bildade 1803
Kategorija:Pajjiżi stabbiliti fl-1830	Kategori:Stater och territorier bildade 1830
Kategorija:Pajjiżi stabbiliti fl-1839	Kategori:Stater och territorier bildade 1839
Kategorija:Pajjiżi stabbiliti fl-1866	Kategori:Stater och territorier bildade 1866
Kategorija:Pajjiżi stabbiliti fl-1910	Kategori:Stater och territorier bildade 1910
Kategorija:Pajjiżi stabbiliti fl-1946	Kategori:Stater och territorier bildade 1946
Kategorija:Pajjiżi stabbiliti fl-1944	Kategori:Stater och territorier bildade 1944
Kategorija:Pajjiżi stabbiliti fl-1929	Kategori:Stater och territorier bildade 1929
Kategorija:Pajjiżi stabbiliti fl-1923	Kategori:Stater och territorier bildade 1923
Kategorija:Pajjiżi stabbiliti fl-1955	Kategori:Stater och territorier bildade 1955
Kategorija:Pajjiżi stabbiliti fl-1960	Kategori:Stater och territorier bildade 1960
Kategorija:Pajjiżi stabbiliti fl-1964	Kategori:Stater och territorier bildade 1964
Kategorija:Pajjiżi stabbiliti fl-1974	Kategori:Stater och territorier bildade 1974
Kategorija:Pajjiżi stabbiliti fl-1975	Kategori:Stater och territorier bildade 1975
Kategorija:Pajjiżi stabbiliti fl-1989	Kategori:Stater och territorier bildade 1989
Kategorija:Pajjiżi stabbiliti fl-1991	Kategori:Stater och territorier bildade 1991
Kategorija:Pajjiżi stabbiliti fl-1993	Kategori:Stater och territorier bildade 1993
Kategorija:Pajjiżi stabbiliti fl-2003	Kategori:Stater och territorier bildade 2003
Kategorija:Pajjiżi stabbiliti fl-2006	Kategori:Stater och territorier bildade 2006
Kategorija:Pajjiżi stabbiliti fl-2010	Kategori:Stater och territorier bildade 2010
Kategorija:Pajjiżi stabbiliti fl-2011	Kategori:Stater och territorier bildade 2011
Kategorija:Bliet tal-Veneżwela	Kategori:Orter i Venezuela
Mudell:Tim ta' Inter Milan	Mall:FC Internazionale Milano trupp
Kategorija:Kowċis fil-Belġju skont il-klabb	Kategori:Fotbollstränare i klubblag i Belgien
Kategorija:Chelsea FC	Kategori:Chelsea FC
Kategorija:Arsenal FC	Kategori:Arsenal FC
Kategorija:Liverpool FC	Kategori:Liverpool FC
Kategorija:Inter Milan	Kategori:FC Internazionale Milano
Kategorija:Manchester United FC	Kategori:Manchester United FC
Kategorija:AC Milan	Kategori:AC Milan
Kategorija:Blackburn Rovers FC	Kategori:Blackburn Rovers FC
Kategorija:Klabbs tal-futbol Olandiżi	Kategori:Fotbollsklubbar i Nederländerna
Kategorija:Tupaja	Kategori:Scandentia
Kategorija:Lagomorpha	Kategori:Lagomorpha
Kategorija:Proboscidea	Kategori:Elefantdjur
Kategorija:Hyracoidea	Kategori:Hyracoidea
Kategorija:Kantanti Albaniżi	Kategori:Albanska sångare
Kategorija:Kantanti Rumeni	Kategori:Rumänska sångare
Kategorija:Kontestanti fil-Festival tal-Eurovision	Kategori:Deltagare i Eurovision Song Contest
Kategorija:Pajjiżi tal-Amerika t'Isfel	Kategori:Sydamerikas länder
Kategorija:Abbozzi tal-isport	Kategori:Sportstubbar
Kategorija:Staġuni tal-UEFA Champions League	Kategori:Säsonger av UEFA Champions League
Kategorija:Presidenti ta' Malta	Kategori:Maltas presidenter
Kategorija:Klabbs tal-futbol tal-Andorra	Kategori:Fotbollsklubbar i Andorra
Kategorija:Analisi matematika	Kategori:Matematisk analys
Kategorija:Sirenia	Kategori:Sirendjur
Kategorija:Mitoloġija Griega	Kategori:Grekisk mytologi
Kategorija:Bliet kapitali	Kategori:Huvudstäder
Kategorija:Avvenimenti	Kategori:Evenemang
Kategorija:HIV/AIDS	Kategori:HIV/AIDS
Kategorija:Tazza Ażjatika tal-Futbol	Kategori:Asiatiska mästerskapet i fotboll
Kategorija:Filatelija	Kategori:Filateli
Kategorija:Arkeoloġija	Kategori:Arkeologi
Kategorija:Astroloġija	Kategori:Astrologi
Kategorija:Logħob Olimpiku tas-sajf 2008	Kategori:Olympiska sommarspelen 2008
Kategorija:Ho Chi Minh (belt)	Kategori:Ho Chi Minh-staden
Kategorija:Elettriċità	Kategori:Elektricitet
Kategorija:Posta	Kategori:Postväsen
Kategorija:Utenti pl	Kategori:Användare pl
Kategorija:Trasport	Kategori:Transport
Kategorija:Ir-Rivoluzzjoni Franċiża	Kategori:Franska revolutionen
Kategorija:Żfin	Kategori:Dans
Kategorija:Sports tat-timijiet	Kategori:Lagsport
Kategorija:Ċaħdiet tal-Wikipedija	Kategori:Wikipedia:Förbehåll
Kategorija:Teorija tal-grafi	Kategori:Grafteori
Kategorija:Teorija tan-numri	Kategori:Talteori
Kategorija:Kantanti	Kategori:Sångare
Kategorija:Futbolers	Kategori:Fotbollsspelare
Kategorija:Matematiċi	Kategori:Matematiker
Kategorija:Futbolers fl-Italja skont il-klabb	Kategori:Fotbollsspelare i klubblag i Italien
Kategorija:Futbolers fl-Olanda skont il-klabb	Kategori:Fotbollsspelare i klubblag i Nederländerna
Kategorija:Futbolers fl-Ingilterra skont il-klabb	Kategori:Fotbollsspelare i klubblag i England
Kategorija:Futbolers skont il-klabb	Kategori:Fotbollsspelare efter klubblag
Mudell:Bandierapajjiż	Mall:Flaggbild2
Kategorija:Presidenti tal-Italja	Kategori:Italiens presidenter
Kategorija:Kompetizzjonijiet tal-futbol fil-Ġermanja	Kategori:Tyska fotbollstävlingar
Kategorija:Sportivi	Kategori:Idrottare
Kategorija:Dermoptera	Kategori:Dermoptera
Kategorija:Skultura	Kategori:Skulptur
Kategorija:Montenegro	Kategori:Montenegro
Kategorija:Plejers ta' Everton FC	Kategori:Spelare i Everton FC
Kategorija:Plejers ta' West Ham United FC	Kategori:Spelare i West Ham United FC
Kategorija:Plejers ta' Manchester United FC	Kategori:Spelare i Manchester United FC
Kategorija:Kampjonati Ewropej tal-Futbol 2008	Kategori:Europamästerskapet i fotboll för herrar 2008
Mudell:Hu	Mall:Hu ikon
Kategorija:Pajjiżi stabbiliti fl-1800	Kategori:Stater och territorier bildade 1800
Kategorija:Pajjiżi stabbiliti fl-1890	Kategori:Stater och territorier bildade 1890
Kategorija:Pajjiżi stabbiliti fl-1917	Kategori:Stater och territorier bildade 1917
Kategorija:Pajjiżi stabbiliti fl-1967	Kategori:Stater och territorier bildade 1967
Kategorija:Pajjiżi stabbiliti fl-1905	Kategori:Stater och territorier bildade 1905
Kategorija:Pajjiżi stabbiliti fl-1990	Kategori:Stater och territorier bildade 1990
Mudell:G14	Mall:G-14
Kategorija:Kultura tal-Veneżwela	Kategori:Kultur i Venezuela
Kategorija:Bliet ta' Malta	Kategori:Orter på Malta
Kategorija:Bliet kapitali fl-Ewropa	Kategori:Europas huvudstäder
Kategorija:Partiti politiċi ta' Malta	Kategori:Politiska partier i Malta
Kategorija:Plejers ta' Djurgårdens IF Fotboll	Kategori:Spelare i Djurgårdens IF Fotboll
Mudell:Dati pajjiż Renju tal-Bulgarija	Mall:Landsdata Kungariket Bulgarien
Kategorija:Logħob tal-ballun	Kategori:Bollsport
Kategorija:Belt Valletta	Kategori:Valletta
Kategorija:Kittieba Maltin	Kategori:Maltesiska författare
Kategorija:Mediterran	Kategori:Medelhavet
Kategorija:Mużiċisti Albaniżi	Kategori:Albanska musiker
Kategorija:Pholidota	Kategori:Pholidota
Kategorija:Storja tal-matematika	Kategori:Matematikens historia
Kategorija:Mudelli tal-klabbs tal-futbol Ingliżi	Kategori:Spelartruppsmallar för klubblag - England
Mudell:Żoni tal-ħin	Mall:Tidszoner
Kategorija:Plejers ta' Lille OSC	Kategori:Spelare i Lille OSC
Kategorija:Abbozzi tal-antropoloġija	Kategori:Antropologistubbar
Kategorija:Abbozzi tal-lingwistika	Kategori:Språkstubbar
Kategorija:Abbozzi tal-elettronika	Kategori:Elektronikstubbar
Kategorija:Plejers ta' Millwall FC	Kategori:Spelare i Millwall FC
Kategorija:Etoloġi	Kategori:Etologer
Kategorija:Kowċis ta' Juventus FC	Kategori:Tränare i Juventus FC
Kategorija:Kowċis ta' FC Barcelona	Kategori:Tränare i FC Barcelona
Kategorija:Kowċis ta' Real Madrid CF	Kategori:Tränare i Real Madrid
Kategorija:Kowċis ta' Borussia Mönchengladbach	Kategori:Tränare i Borussia Mönchengladbach
Kategorija:Kowċis ta' Borussia Dortmund	Kategori:Tränare i Borussia Dortmund
Kategorija:Kowċis ta' FC Bayern Munich	Kategori:Tränare i FC Bayern München
Kategorija:Klabbs tal-futbol Belġjani	Kategori:Fotbollsklubbar i Belgien
Kategorija:Saħħa	Kategori:Hälsa
Kategorija:Futbolers fil-Ġermanja skont il-klabb	Kategori:Fotbollsspelare i klubblag i Tyskland
Mudell:Fussballdaten	Mall:Fussballdaten
Mudell:Dati pajjiż Spanja	Mall:Landsdata Spanien
Mudell:Dati pajjiż Kanada	Mall:Landsdata Kanada
Mudell:Klassifika tal-futbol bidu	Mall:Fb cl header
Kategorija:Klabbs tal-futbol Russi	Kategori:Fotbollsklubbar i Ryssland
Mudell:Bandiera	Mall:Flagga
Mudell:Dati pajjiż Angwilla	Mall:Landsdata Anguilla
Mudell:Dati pajjiż Barbados	Mall:Landsdata Barbados
Mudell:Dati pajjiż Bermuda	Mall:Landsdata Bermuda
Mudell:Dati pajjiż Bonaire	Mall:Landsdata Bonaire
Mudell:Dati pajjiż Gżejjer Verġni Brittaniċi	Mall:Landsdata Brittiska Jungfruöarna
Mudell:Dati pajjiż Burma	Mall:Landsdata Burma
Mudell:Dati pajjiż Gżejjer Kokos	Mall:Landsdata Kokosöarna
Mudell:Dati pajjiż Komunità tal-Istati Indipendenti	Mall:Landsdata Oberoende staters samvälde
Mudell:Dati pajjiż Renju tal-Jugożlavja	Mall:Landsdata Kungariket Jugoslavien
Mudell:Dati pajjiż Martinika	Mall:Landsdata Martinique
Mudell:Dati pajjiż Antilli Olandiżi	Mall:Landsdata Nederländska Antillerna
Mudell:Dati pajjiż Singapor	Mall:Landsdata Singapore
Kategorija:Mudelli tat-timijiet tat-Tazza tal-Konfederazzjonijiet 2009	Kategori:Spelartruppsmallar i Fifa Confederations Cup 2009
Kategorija:Mudelli tal-klabbs tal-futbol Spanjoli	Kategori:Spelartruppsmallar för klubblag - Spanien
Kategorija:Abbozzi tax-xjenza	Kategori:Vetenskapsstubbar
Kategorija:Plejers ta' US Avellino	Kategori:Spelare i US Avellino
Kategorija:Plejers ta' Albacete Balompié	Kategori:Spelare i Albacete Balompié
Kategorija:Plejers ta' SC Rheindorf Altach	Kategori:Spelare i SC Rheindorf Altach
Kategorija:Plejers ta' Royal Antwerp FC	Kategori:Spelare i Royal Antwerp FC
Kategorija:Plejers ta' FC Aarau	Kategori:Spelare i FC Aarau
Kategorija:Plejers ta' Besa Kavajë	Kategori:Spelare i KS Besa Kavajë
Kategorija:Plejers ta' Birkirkara FC	Kategori:Spelare i Birkirkara FC
Kategorija:Plejers ta' Brighton & Hove Albion FC	Kategori:Spelare i Brighton & Hove Albion FC
Kategorija:Plejers ta' Bristol City FC	Kategori:Spelare i Bristol City FC
Kategorija:Plejers ta' KS Bylis Ballsh	Kategori:Spelare i KS Bylis Ballsh
Kategorija:Plejers ta' RKC Waalwijk	Kategori:Spelare i RKC Waalwijk
Kategorija:Plejers ta' Valletta FC	Kategori:Spelare i Valletta FC
Kategorija:Isqfijiet Taljani	Kategori:Italienska biskopar
Kategorija:Plejers ta' Wellington Phoenix FC	Kategori:Spelare i Wellington Phoenix FC
Kategorija:Plejers ta' KS Vllaznia Shkodër	Kategori:Spelare i Vllaznia Shkodër
Kategorija:Plejers ta' Chivas de Guadalajara	Kategori:Spelare i Club Deportivo Guadalajara
Kategorija:Plejers ta' KRC Genk	Kategori:Spelare i KRC Genk
Kategorija:Plejers ta' Defensor Sporting Club	Kategori:Spelare i Defensor Sporting
Kategorija:Plejers ta' Beerschot AC	Kategori:Spelare i KFC Germinal Beerschot
Kategorija:Plejers ta' KS Kastrioti	Kategori:Spelare i KS Kastrioti
Kategorija:Plejers ta' FC Crotone	Kategori:Spelare i FC Crotone
Kategorija:Plejers ta' Lillestrøm SK	Kategori:Spelare i Lillestrøm SK
Kategorija:Plejers ta' KSC Lokeren Oost-Vlaanderen	Kategori:Spelare i KSC Lokeren Oost-Vlaanderen
Kategorija:Plejers ta' PFC Lokomotiv Sofia	Kategori:Spelare i PFC Lokomotiv Sofia
Kategorija:Plejers ta' AC Lugano	Kategori:Spelare i AC Lugano
Kategorija:Plejers ta' AC Lumezzane	Kategori:Spelare i AC Lumezzane
Kategorija:Plejers ta' Luton Town FC	Kategori:Spelare i Luton Town FC
Kategorija:Plejers ta' Lierse SK	Kategori:Spelare i Lierse SK
Kategorija:Plejers ta' FC Lucerne	Kategori:Spelare i FC Luzern
Kategorija:Plejers ta' Manisaspor	Kategori:Spelare i Manisaspor
Kategorija:Plejers ta' Marsaxlokk FC	Kategori:Spelare i Marsaxlokk FC
Kategorija:Plejers ta' KV Mechelen	Kategori:Spelare i KV Mechelen
Kategorija:Plejers ta' RAEC Mons	Kategori:Spelare i RAEC Mons
Kategorija:Plejers ta' CD Nacional	Kategori:Spelare i CD Nacional
Kategorija:Plejers ta' AC Omonia	Kategori:Spelare i AC Omonia
Kategorija:Plejers ta' SK Rapid Wien	Kategori:Spelare i Rapid Wien
Kategorija:Plejers ta' Rimini Calcio FC	Kategori:Spelare i Rimini Calcio
Kategorija:Plejers ta' FC St. Gallen	Kategori:Spelare i FC St. Gallen
Kategorija:Plejers ta' FK Sarajevo	Kategori:Spelare i FK Sarajevo
Kategorija:Plejers ta' Servette FC	Kategori:Spelare i Servette FC
Kategorija:Plejers ta' Cercle Brugge KSV	Kategori:Spelare i Cercle Brugge KSV
Kategorija:Plejers ta' KF Skënderbeu Korçë	Kategori:Spelare i Skënderbeu Korçë
Kategorija:Plejers ta' Sliema Wanderers FC	Kategori:Spelare i Sliema Wanderers FC
Kategorija:Plejers ta' Standard Liège	Kategori:Spelare i Standard Liège
Kategorija:Plejers ta' FC Sion	Kategori:Spelare i FC Sion
Kategorija:Plejers ta' KS Teuta Durrës	Kategori:Spelare i KS Teuta Durrës
Kategorija:Plejers ta' KF Tirana	Kategori:Spelare i KF Tirana
Kategorija:Plejers ta' Ferencváros TC	Kategori:Spelare i Ferencváros TC
Kategorija:Plejers ta' KS Flamurtari Vlorë	Kategori:Spelare i Flamurtari Vlorë
Kategorija:Plejers ta' Hibernian FC	Kategori:Spelare i Hibernian FC
Kategorija:Plejers ta' Hull City AFC	Kategori:Spelare i Hull City AFC
Kategorija:Plejers ta' Chester City FC	Kategori:Spelare i Chester City FC
Kategorija:Plejers ta' FC Schaffhausen	Kategori:Spelare i FC Schaffhausen
Kategorija:Plejers ta' Shamrock Rovers FC	Kategori:Spelare i Shamrock Rovers FC
Kategorija:Plejers ta' SD Eibar	Kategori:Spelare i SD Eibar
Kategorija:Plejers ta' BSC Young Boys	Kategori:Spelare i BSC Young Boys
Kategorija:Plejers ta' Sociedade Esportiva e Recreativa Caxias do Sul	Kategori:Spelare i SER Caxias do Sul
Kategorija:Plejers ta' PFC CSKA Sofia	Kategori:Spelare i CSKA Sofia
Portal:Matematika	Portal:Matematik
Kategorija:Mużiċisti Litwani	Kategori:Litauiska musiker
Kategorija:Kompożituri Iżlandiżi	Kategori:Isländska kompositörer
Timijiet parteċipanti fit-Tazza tad-Dinja tal-Futbol 2006	Spelartrupper under världsmästerskapet i fotboll 2006
Kategorija:William Shakespeare	Kategori:Shakespeare
Kategorija:Wolverhampton Wanderers FC	Kategori:Wolverhampton Wanderers FC
Kategorija:Galatasaray SK	Kategori:Galatasaray SK
Kategorija:Plejers ta' Galatasaray SK	Kategori:Spelare i Galatasaray SK
Kategorija:Mudelli tal-Festival tal-Eurovision	Kategori:Eurovision Song Contest-mallar
Kategorija:Mudelli tal-mużika	Kategori:Musikmallar
Kategorija:Kantanti Montenegrini	Kategori:Montenegrinska sångare
Kategorija:Kantanti Armeni	Kategori:Armeniska sångare
Kategorija:Kittieba tar-Rinaxximent	Kategori:Renässansens författare
Mudell:Infobox Kulur	Mall:Färg infobox
Kategorija:Kompożituri	Kategori:Kompositörer
Kategorija:Kowċis ta' CD Tenerife	Kategori:Tränare i CD Tenerife
Kategorija:Macroscelididae	Kategori:Macroscelididae
Kategorija:Futbolers f'Ċipru skont il-klabb	Kategori:Fotbollsspelare i klubblag på Cypern
Mudell:Kampjonati tal-UEFA	Mall:UEFA:s nationella serier
Mudell:Skwadra Ġermaniża Kampjonati Ewropej tal-Futbol 2012	Mall:Tysklands trupp i EM i fotboll 2012
Mudell:Skwadra Ġermaniża Tazza tad-Dinja tal-Futbol 2006	Mall:Tysklands trupp i VM i fotboll 2006
Mudell:Utent hi-2	Mall:Användare hi-2
Mudell:Suboff	Mall:Utbytt
Mudell:Sent off	Mall:Röttkort
Mudell:MLT	Mall:MLT
Kategorija:Plejers ta' FC Dynamo Kyiv	Kategori:Spelare i FC Dynamo Kiev
Mudell:Dati pajjiż Prussja	Mall:Landsdata Preussen
Kategorija:Tazza tad-Dinja tal-Futbol 2006	Kategori:Världsmästerskapet i fotboll 2006
Kategorija:Kwalifikazzjoni għat-Tazza tad-Dinja tal-Futbol 2010	Kategori:Kvalspelet till världsmästerskapet i fotboll 2010
Kategorija:Plejers ta' AC ChievoVerona	Kategori:Spelare i AC ChievoVerona
Kategorija:Kowċis ta' AC Milan	Kategori:Tränare i AC Milan
Kategorija:Plejers ta' AFC Bournemouth	Kategori:Spelare i AFC Bournemouth
Kategorija:ACF Fiorentina	Kategori:ACF Fiorentina
Kategorija:Plejers ta' ACF Fiorentina	Kategori:Spelare i ACF Fiorentina
Kategorija:Plejers ta' AS Monaco FC	Kategori:Spelare i AS Monaco FC
Kategorija:Plejers ta' AS Saint-Étienne	Kategori:Spelare i AS Saint-Étienne
Kategorija:Federazzjonijiet tal-futbol	Kategori:Fotbollsförbund
Kategorija:Kowċis skont il-klabb	Kategori:Fotbollstränare efter klubblag
Kategorija:Futbolers fi New Zealand skont il-klabb	Kategori:Fotbollsspelare i klubblag i Nya Zeeland
Kategorija:Futbolers fl-Irlanda skont il-klabb	Kategori:Fotbollsspelare i klubblag i Irland
Kategorija:Plejers ta' Atalanta BC	Kategori:Spelare i Atalanta BC
Kategorija:Kowċis ta' Athletic Bilbao	Kategori:Tränare i Athletic Bilbao
Kategorija:Kantanti Ażerbajġani	Kategori:Azeriska sångare
Kategorija:Plejers ta' Barnsley FC	Kategori:Spelare i Barnsley FC
Kategorija:Kowċis ta' Bayer 04 Leverkusen	Kategori:Tränare i Bayer 04 Leverkusen
Kategorija:Kantanti Bjelorussi	Kategori:Vitryska sångare
Kategorija:Plejers ta' Boca Juniors	Kategori:Spelare i CA Boca Juniors
Kategorija:Ktieb ta' Mormon	Kategori:Mormons bok
Kategorija:Borussia Dortmund	Kategori:Borussia Dortmund
Mudell:Dati pajjiż Gwadelup	Mall:Landsdata Guadeloupe
Kategorija:Referis tal-futbol Brażiljani	Kategori:Fotbollsdomare från Brasilien
Kategorija:Pajjiżi tal-Amerika Ċentrali	Kategori:Centralamerikas länder
Kategorija:Dasyuromorphia	Kategori:Dasyuromorphia
Mudell:TOCleft	Mall:TOCvänster
Kategorija:Kowċis ta' Club Brugge KV	Kategori:Tränare i Club Brügge KV
Kategorija:Abbozzi tal-edukazzjoni	Kategori:Utbildningsstubbar
Kategorija:Kowċis ta' Eintracht Frankfurt	Kategori:Tränare i Eintracht Frankfurt
Kategorija:Plejers ta' Eintracht Frankfurt	Kategori:Spelare i Eintracht Frankfurt
Kategorija:Empoli FC	Kategori:Empoli FC
Kategorija:Edizzjonijiet tal-Festival tal-Eurovision	Kategori:Eurovision Song Contest efter år
Kategorija:FC Barcelona	Kategori:FC Barcelona
Kategorija:FC Bayern Munich	Kategori:FC Bayern München
Kategorija:Plejers ta' FC Girondins de Bordeaux	Kategori:Spelare i FC Girondins de Bordeaux
Kategorija:Plejers ta' FC Lausanne-Sport	Kategori:Spelare i FC Lausanne-Sport
Kategorija:Kowċis ta' FC Schalke 04	Kategori:Tränare i FC Schalke 04
Kategorija:Plejers ta' FC Schalke 04	Kategori:Spelare i FC Schalke 04
Kategorija:Plejers ta' FC Sochaux-Montbéliard	Kategori:Spelare i FC Sochaux-Montbéliard
Kategorija:Plejers ta' FC Thun	Kategori:Spelare i FC Thun
Kategorija:Plejers ta' FC Utrecht	Kategori:Spelare i FC Utrecht
Kategorija:Tazza tad-Dinja tal-Futbol tal-Klabbs	Kategori:Världsmästerskapet i fotboll för klubblag
Kategorija:Tazza tad-Dinja tal-Futbol	Kategori:Världsmästerskapet i fotboll
Kategorija:Plejers ta' FK Borac Banja Luka	Kategori:Spelare i FK Borac Banja Luka
Kategorija:Kowċis ta' FK Khazar Lankaran	Kategori:Tränare i FK Chazar Lenkoran
Kategorija:Plejers ta' FK Partizan	Kategori:Spelare i FK Partizan Belgrad
Kategorija:Kantanti Ċiprijotti	Kategori:Cypriotiska sångare
Kategorija:Klabbs tal-futbol Armeni	Kategori:Fotbollsklubbar i Armenien
Kategorija:Klabbs tal-futbol Awstrijaċi	Kategori:Fotbollsklubbar i Österrike
Kategorija:Klabbs tal-futbol Bożnijaċi	Kategori:Fotbollsklubbar i Bosnien och Hercegovina
Kategorija:Klabbs tal-futbol Estonjani	Kategori:Fotbollsklubbar i Estland
Kategorija:Klabbs tal-futbol Iżraeljani	Kategori:Fotbollsklubbar i Israel
Kategorija:Klabbs tal-futbol Serbi	Kategori:Fotbollsklubbar i Serbien
Kategorija:Futbol fil-Korea t'Isfel	Kategori:Fotboll i Sydkorea
Kategorija:Kowċis fl-Ażerbajġan skont il-klabb	Kategori:Fotbollstränare i klubblag i Azerbajdzjan
Kategorija:Kowċis fil-Portugall skont il-klabb	Kategori:Fotbollstränare i klubblag i Portugal
Kategorija:Kowċis fl-Olanda skont il-klabb	Kategori:Fotbollstränare i klubblag i Nederländerna
Kategorija:Grawnds tal-futbol fil-Belġju	Kategori:Fotbollsanläggningar i Belgien
Kategorija:Futbolers fl-Arġentina skont il-klabb	Kategori:Fotbollsspelare i klubblag i Argentina
Kategorija:Futbolers fil-Belġju skont il-klabb	Kategori:Fotbollsspelare i klubblag i Belgien
Kategorija:Futbolers fil-Bożnija u Ħerżegovina skont il-klabb	Kategori:Fotbollsspelare i klubblag i Bosnien och Hercegovina
Kategorija:Futbolers fil-Brażil skont il-klabb	Kategori:Fotbollsspelare i klubblag i Brasilien
Kategorija:Futbolers fl-Ekwador skont il-klabb	Kategori:Fotbollsspelare i klubblag i Ecuador
Kategorija:Futbolers fi Franza skont il-klabb	Kategori:Fotbollsspelare i klubblag i Frankrike
Kategorija:Futbolers fil-Greċja skont il-klabb	Kategori:Fotbollsspelare i klubblag i Grekland
Kategorija:Futbolers fl-Iżrael skont il-klabb	Kategori:Fotbollsspelare i klubblag i Israel
Kategorija:Futbolers f'Malta skont il-klabb	Kategori:Fotbollsspelare i klubblag på Malta
Kategorija:Futbolers fil-Messiku skont il-klabb	Kategori:Fotbollsspelare i klubblag i Mexiko
Kategorija:Futbolers fin-Norveġja skont il-klabb	Kategori:Fotbollsspelare i klubblag i Norge
Kategorija:Futbolers fis-Serbja skont il-klabb	Kategori:Fotbollsspelare i klubblag i Serbien
Kategorija:Futbolers fil-Korea t'Isfel skont il-klabb	Kategori:Fotbollsspelare i klubblag i Sydkorea
Kategorija:Futbolers fl-Iżvezja skont il-klabb	Kategori:Fotbollsspelare i klubblag i Sverige
Kategorija:Futbolers fl-Iżvizzera skont il-klabb	Kategori:Fotbollsspelare i klubblag i Schweiz
Kategorija:Futbolers fit-Turkija skont il-klabb	Kategori:Fotbollsspelare i klubblag i Turkiet
Kategorija:Futbolers fl-Urugwaj skont il-klabb	Kategori:Fotbollsspelare i klubblag i Uruguay
Kategorija:Mudelli ta' kwotazzjoni	Kategori:Citatmallar
Kategorija:Logħob tal-Pajjiżi ż-Żgħar tal-Ewropa	Kategori:Spelen för små stater i Europa
Mudell:Preċiżjoni1	Mall:Precision1
Kategorija:Gran Mastri tal-Ordni ta' San Ġwann	Kategori:Stormästare av Malteserorden
Kategorija:Plejers ta' Grasshopper-Club Zürich	Kategori:Spelare i Grasshopper-Club Zürich
Kategorija:Plejers ta' Hamburger SV	Kategori:Spelare i Hamburger SV
Kategorija:Kowċis ta' Inter Milan	Kategori:Tränare i FC Internazionale Milano
Kategorija:Plejers ta' Inter Milan	Kategori:Spelare i FC Internazionale Milano
Kategorija:Plejers ta' Ipswich Town FC	Kategori:Spelare i Ipswich Town FC
Kategorija:Irlanda	Kategori:Ön Irland
Kategorija:Preżentaturi televiżivi Taljani	Kategori:Italienska TV-programledare
Għajnuna:Kronoloġija	Wikipedia:Versionshistorik
Kategorija:Kowċis fil-Ġermanja skont il-klabb	Kategori:Fotbollstränare i klubblag i Tyskland
Kategorija:Kowċis fi Spanja skont il-klabb	Kategori:Fotbollstränare i klubblag i Spanien
Kategorija:Festival tal-Eurovision taż-Żgħar	Kategori:Junior Eurovision Song Contest
Kategorija:Plejers ta' Juventus FC	Kategori:Spelare i Juventus FC
Kategorija:KAA Gent	Kategori:KAA Gent
Kategorija:Kowċis ta' KAA Gent	Kategori:Tränare i KAA Gent
Kategorija:Kowċis ta' Lierse SK	Kategori:Tränare i Lierse SK
Kategorija:KV Mechelen	Kategori:KV Mechelen
Kategorija:Plejers ta' Larissa FC	Kategori:Spelare i AEL 1964
Kategorija:Plejers ta' Legia Warszawa	Kategori:Spelare i Legia Warszawa
Portal:Kimika	Portal:Kemi
Kategorija:Plejers ta' Macclesfield Town FC	Kategori:Spelare i Macclesfield Town FC
Kategorija:Abbozzi tal-letteratura	Kategori:Litteraturstubbar
Kategorija:Kunjomijiet Maltin	Kategori:Maltesiska efternamn
Kategorija:Kompożituri Maltin	Kategori:Maltesiska kompositörer
Kategorija:Lingwa Maltija	Kategori:Maltesiska
Kategorija:Mużiċisti Maltin	Kategori:Maltesiska musiker
Kategorija:Poeti Maltin	Kategori:Maltesiska poeter
Kategorija:Kantanti Maltin	Kategori:Maltesiska sångare
Kategorija:Plejers ta' Mansfield Town FC	Kategori:Spelare i Mansfield Town FC
Kategorija:RSC Anderlecht	Kategori:RSC Anderlecht
Kategorija:Kowċis ta' RSC Anderlecht	Kategori:Tränare i RSC Anderlecht
Kategorija:Plejers ta' RSC Anderlecht	Kategori:Spelare i RSC Anderlecht
Kategorija:Abbozzi tal-mediċina	Kategori:Medicinstubbar
Kategorija:Plejers ta' RC Strasbourg	Kategori:Spelare i RC Strasbourg
Kategorija:Plejers ta' Racing Club	Kategori:Spelare i Racing Club de Avellaneda
Kategorija:Plejers ta' Real Madrid CF	Kategori:Spelare i Real Madrid
Kategorija:Plejers ta' Real Zaragoza	Kategori:Spelare i Real Zaragoza
Kategorija:Modena FC	Kategori:Modena FC
Kategorija:Mużiċisti Montenegrini	Kategori:Montenegrinska musiker
Kategorija:Plejers ta' NEC Nijmegen	Kategori:Spelare i NEC Nijmegen
Kategorija:Plejers ta' River Plate	Kategori:Spelare i CA River Plate
Kategorija:Kompożituri Romantiċi	Kategori:Romantiska kompositörer
Kategorija:Plejers ta' Rosario Central	Kategori:Spelare i CA Rosario Central
Kategorija:Kowċis ta' SL Benfica	Kategori:Tränare i SL Benfica
Kategorija:SSC Napoli	Kategori:SSC Napoli
Kategorija:Plejers ta' SS Lazio	Kategori:Spelare i SS Lazio
Kategorija:Abbozzi tas-sesswalità	Kategori:Sexstubbar
Kategorija:Abbozzi tal-filosofija	Kategori:Filosofistubbar
Kategorija:Plejers ta' SC Heerenveen	Kategori:Spelare i SC Heerenveen
Kategorija:SK Rapid Wien	Kategori:SK Rapid Wien
Kategorija:SK Sturm Graz	Kategori:SK Sturm Graz
Kategorija:Plejers ta' SV Werder Bremen	Kategori:Spelare i Werder Bremen
Kategorija:Ortografija	Kategori:Ortografi
Kategorija:Plejers ta' PFC CSKA Moscow	Kategori:Spelare i PFC CSKA Moskva
Kategorija:Plejers ta' Parma FC	Kategori:Spelare i Parma FC
Kategorija:Lingwi Semitiċi	Kategori:Semitiska språk
Kategorija:Paucituberculata	Kategori:Paucituberculata
Kategorija:Kantanti Ġeorġjani	Kategori:Georgiska sångare
Kategorija:Mużiċisti Slovakki	Kategori:Slovakiska musiker
Kategorija:Kantanti Slovakki	Kategori:Slovakiska sångare
Kategorija:Futbolers fl-Istati Uniti skont il-klabb	Kategori:Fotbollsspelare i klubblag i USA
Kategorija:Grawnds tal-futbol fl-Afrika t'Isfel	Kategori:Fotbollsanläggningar i Sydafrika
Kategorija:Plejers ta' Sociedade Esportiva Palmeiras	Kategori:Spelare i Sociedade Esportiva Palmeiras
Kategorija:Referis tal-futbol Spanjoli	Kategori:Fotbollsdomare från Spanien
Kategorija:Mużewijiet sportivi	Kategori:Idrottsmuseer
Kategorija:Ateiżmu	Kategori:Ateism
Kategorija:Plejers ta' Stade Rennais FC	Kategori:Spelare i Stade Rennais FC
Kategorija:Standard Liège	Kategori:Standard Liège
Kategorija:Kowċis ta' Standard Liège	Kategori:Tränare i Standard Liège
Kategorija:Pajjiżi skond is-sena li spiċċaw	Kategori:Stater och territorier efter upplösning
Kategorija:Pajjiżi li spiċċaw fl-1964	Kategori:Stater och territorier upplösta 1964
Kategorija:Pajjiżi stabbiliti fl-1278	Kategori:Stater och territorier bildade 1278
Kategorija:Pajjiżi stabbiliti fl-1798	Kategori:Stater och territorier bildade 1798
Kategorija:Pajjiżi stabbiliti fl-1937	Kategori:Stater och territorier bildade 1937
Kategorija:Pajjiżi stabbiliti fl-2008	Kategori:Stater och territorier bildade 2008
Kategorija:Plejers ta' Swindon Town FC	Kategori:Spelare i Swindon Town FC
Kategorija:Edizzjonijiet tal-Kampjonati Ewropej tal-Futbol	Kategori:Europamästerskapet i fotboll för herrar
Kategorija:Kompożituri Klassiċi	Kategori:Klassiska kompositörer
Mudell:Dati pajjiż Repubblika Għarbija Magħquda	Mall:Landsdata Förenade Arabrepubliken
Kategorija:Kowċis ta' Villarreal CF	Kategori:Tränare i Villarreal CF
Kategorija:Didelphimorphia	Kategori:Pungråttor
Kategorija:Bolol	Kategori:Frimärken
Kategorija:Xjenza Applikati	Kategori:Tillämpade vetenskaper
Kategorija:Għall-kontroll	Kategori:Faktakoll
Kategorija:Trattati tal-Unjoni Ewropea	Kategori:Europeiska unionens fördrag
Kategorija:Coritiba Foot Ball Club	Kategori:Coritiba Foot Ball Club
Kategorija:Futbol fil-Maċedonja	Kategori:Fotboll i Makedonien
Kategorija:Football League	Kategori:The Football League
Kategorija:Logħob tat-tfal	Kategori:Lekar
Kategorija:Provinċja ta' Bergamo	Kategori:Provinsen Bergamo
Kategorija:Kantanti Bulgari	Kategori:Bulgariska sångare
Kategorija:Tupaiidae	Kategori:Tupaiidae
Mudell:Premier League Armen	Mall:Armeniska fotbollsligan
Kategorija:Provinċja ta' Lodi	Kategori:Provinsen Lodi
Kategorija:Kantanti Żvizzeri	Kategori:Schweiziska sångare
Kategorija:Microbiotheria	Kategori:Microbiotheria
Kategorija:Plejers ta' Beşiktaş JK	Kategori:Spelare i Beşiktaş JK
Kategorija:Plejers ta' Chelsea FC	Kategori:Spelare i Chelsea FC
Kategorija:Plejers ta' Club Brugge KV	Kategori:Spelare i Club Brügge KV
Kategorija:Plejers ta' Coventry City FC	Kategori:Spelare i Coventry City FC
Kategorija:Plejers ta' Neuchâtel Xamax	Kategori:Spelare i Neuchâtel Xamax FC
Kategorija:Plejers ta' Nottingham Forest FC	Kategori:Spelare i Nottingham Forest FC
Kategorija:Plejers ta' Panathinaikos	Kategori:Spelare i Panathinaikos FC
Kategorija:Plejers ta' Paris Saint-Germain FC	Kategori:Spelare i Paris Saint-Germain FC
Kategorija:Plejers ta' Tottenham Hotspur FC	Kategori:Spelare i Tottenham Hotspur FC
Kategorija:Plejers ta' VfL Wolfsburg	Kategori:Spelare i VfL Wolfsburg
Kategorija:Plejers ta' Wrexham FC	Kategori:Spelare i Wrexham AFC
Kategorija:Plejers ta' 1. FC Köln	Kategori:Spelare i 1. FC Köln
Kategorija:Plejers ta' OGC Nice	Kategori:Spelare i OGC Nice
Kategorija:Plejers ta' Olympique Lyonnais	Kategori:Spelare i Olympique Lyonnais
Kategorija:Pedagoġija	Kategori:Pedagogik
Serie A 2013–14	Serie A 2013/2014
Kategorija:Sports ta' preċiżjoni	Kategori:Precisionssport
Kategorija:Preistorja	Kategori:Förhistoria
Kategorija:Drammi ta' William Shakespeare	Kategori:Pjäser av William Shakespeare
Kategorija:Mużiċisti Torok	Kategori:Turkiska musiker
Kategorija:Ptilocercidae	Kategori:Ptilocercidae
Kategorija:Mużiċisti Bjelorussi	Kategori:Vitryska musiker
Kategorija:Mużiċisti Ċiprijotti	Kategori:Cypriotiska musiker
Kategorija:Abbozzi tal-mitoloġija	Kategori:Mytologistubbar
Kategorija:Staġuni tal-Premier League	Kategori:Säsonger av Premier League
Kategorija:Abbozzi tal-arkitettura	Kategori:Arkitekturstubbar
Kategorija:Artikli b'sezzjonijiet għall-espansjoni	Kategori:Artiklar med stubavsnitt
Mudell:Infobox Gazzetta	Mall:Publikation
Kategorija:Eutheria	Kategori:Eutheria
Mudell:IMSLP	Mall:IMSLP
Kategorija:Klassifikazzjoni xjentifika	Kategori:Systematik
Kategorija:Abbozzi ta' organizzazzjonijiet	Kategori:Organisationsstubbar
Kategorija:Utenti en-1	Kategori:Användare en-1
Kategorija:Twieldu fl-1930	Kategori:Födda 1930
Kategorija:Twieldu fl-1946	Kategori:Födda 1946
Kategorija:Utenti de-1	Kategori:Användare de-1
Kategorija:Twieldu fl-1920	Kategori:Födda 1920
Kategorija:Twieldu fl-1956	Kategori:Födda 1956
Kategorija:Twieldu fl-1933	Kategori:Födda 1933
Kategorija:Twieldu fl-1911	Kategori:Födda 1911
Kategorija:Twieldu fl-1937	Kategori:Födda 1937
Kategorija:Twieldu fl-1948	Kategori:Födda 1948
Kategorija:Mietu fl-1978	Kategori:Avlidna 1978
Kategorija:Twieldu fl-1921	Kategori:Födda 1921
Kategorija:Twieldu fl-1924	Kategori:Födda 1924
Kategorija:Twieldu fl-1926	Kategori:Födda 1926
Kategorija:Twieldu fl-1950	Kategori:Födda 1950
Kategorija:Twieldu fl-1964	Kategori:Födda 1964
Kategorija:Atturi Amerikani	Kategori:Amerikanska skådespelare
Kategorija:Mietu fl-1979	Kategori:Avlidna 1979
Kategorija:Mietu fl-2010	Kategori:Avlidna 2010
Kategorija:Macroscelidea	Kategori:Macroscelidea
Kategorija:Manis	Kategori:Manis
Kategorija:Mużiċisti Rumeni	Kategori:Rumänska musiker
Mudell:Nowrap begin	Mall:Nowrap begin
Mudell:Soccerbase	Mall:Soccerbase-spelare
Mudell:Tim ta' Sunderland AFC	Mall:Sunderland AFC trupp
Mudell:Tim ta' Borussia Dortmund	Mall:Borussia Dortmund trupp
Mudell:Tim ta' SS Lazio	Mall:SS Lazio trupp
Mudell:Fbf	Mall:Dff
Għajnuna:Żbalji komuni fl-użu tal-Wikipedija	Wikipedia:Vanliga nybörjarfel på Wikipedia
Wikipedija:Ċaħda medika	Wikipedia:Medicinskt förbehåll
Mudell:Kunsill Nordiku	Mall:Nordiska rådet
Kategorija:Premier League	Kategori:Premier League
Mudell:Tim ta' Real Madrid CF	Mall:Real Madrid trupp
Għajnuna:Gwida essenzjali/Linji gwida	Wikipedia:Kom ihåg
Wikipedija:Traduzzjoni tal-ġimgħa	Wikipedia:Veckans översättning
Mudell:Skwadra Spanjola Tazza tal-Konfederazzjonijiet 2009	Mall:Spaniens trupp i FIFA Confederations Cup 2009
Mudell:Amerika ta' Fuq	Mall:Nordamerika metamall
Mudell:Tim ta' Manchester City FC	Mall:Manchester City FC trupp
Mudell:Leqstat	Mall:Leqstat
Mudell:Infobox kompetizzjoni sportiva	Mall:Infobox Liga
Mudell:Federazzjonijiet tal-UEFA	Mall:Medlemmar av UEFA
Mudell:Skwadra Slovena Tazza tad-Dinja tal-Futbol 2010	Mall:Sloveniens trupp i VM i fotboll 2010
Mudell:Superliga Albaniża	Mall:Kategoria Superiore
Mudell:Tim ta' Liverpool FC	Mall:Liverpool FC trupp
Mudell:Tim ta' Aston Villa FC	Mall:Aston Villa FC trupp
Wikipedija:Ċaħda fuq il-kontenut	Wikipedia:Förbehåll för innehåll
Mudell:Lfpfr	Mall:Lfpfr
Mudell:Tim ta' Tottenham Hotspur FC	Mall:Tottenham Hotspur FC trupp
Wikipedija:VisualEditor	Wikipedia:VisualEditor
Mudell:Tim ta' Paris Saint-Germain FC	Mall:Paris Saint-Germain FC trupp
Mudell:Skwadra Taljana Kampjonati Ewropej tal-Futbol 2012	Mall:Italiens trupp i EM i fotboll 2012
Premier League 2013–14	Premier League 2013/2014
Kategorija:Abbozzi ta' logħob	Kategori:Spelstubbar
Kategorija:Pajjiżi li spiċċaw fl-1800	Kategori:Stater och territorier upplösta 1800
Mudell:Tim ta' Olympique Lyonnais	Mall:Olympique Lyonnais trupp
Mudell:Tim ta' Fulham FC	Mall:Fulham FC trupp
Mudell:UEFA Jubilee Awards	Mall:UEFA Jubilee Awards
Mudell:Skwadra Brażiljana Tazza tal-Konfederazzjonijiet 2013	Mall:Brasiliens trupp i Fifa Confederations Cup 2013
Birdman (film)	Birdman
Mudell:Skwadra Ġermaniża Kampjonati Ewropej tal-Futbol 2004	Mall:Tysklands trupp i EM i fotboll 2004
Mudell:Skwadra Taljana Tazza tal-Konfederazzjonijiet 2013	Mall:Italiens trupp i Fifa Confederations Cup 2013
Edward Snowden	Edward Snowden
Mudell:Rawnd16	Mall:Round16 utan bronsmatch
Mudell:VisualEditor	Mall:VisualEditor portal
Mudell:Dati pajjiż Kamerun	Mall:Landsdata Kamerun
Gaia Cauchi	Gaia Cauchi
Coreca	Coreca
Speċjali:TibdilRiċenti	Special:Senaste ändringar
Kategorija:Utenti ja-4	Kategori:Användare ja-4
Module:Navbox	Modul:Navbox
Kategorija:Mietu fl-1976	Kategori:Avlidna 1976
Kategorija:Mietu fl-1975	Kategori:Avlidna 1975
Kategorija:Mietu fl-1974	Kategori:Avlidna 1974
Krimea	Republiken Krim
Kategorija:Pajjiżi stabbiliti fl-2014	Kategori:Stater och territorier bildade 2014
Mudell:Traduzzjoni tal-ġimgħa	Mall:Veckoöversättning
Wikipedija:Traduzzjoni tal-ġimgħa/Lingwi	Wikipedia:Veckans översättning/Andra språk
Jezidiżmu	Jezidism
Mudell:Indiċi	Mall:AlfabetiskA-Z
