Africa	Afrika
Xapon	Japan
Ixachitlān Huitztlāmpa	Sydamerika
Noruega	Norge
Inglatlālpan	England
Wales	Wales
Irtlālpan	Irland
Hungria	Ungern
Caxtillān	Spanien
Tlacetilīlli Tlahtohcāyōtl Ixachitlān	USA
Belgica	Belgien
Luxemburgo	Luxemburg
Cemānāhuac	Universum
Tlālticpactli	Jorden
Miquiztli	Döden
Tlācatl	Människa
George Washington	George Washington
Stanley Kubrick	Stanley Kubrick
Fintlālpan	Finland
Suecia	Sverige
Dinamarca	Danmark
Polonia	Polen
Lituania	Litauen
Italia	Italien
Suiza	Schweiz
Austria	Österrike
Grecia	Grekland
Turquia	Turkiet
Portugal	Portugal
Europan	Europa
Asia	Asien
Ixachitlān Mictlāmpa	Nordamerika
Antartida	Antarktis
Huiquipedia	Wikipedia
Tlanitlālpan	Nederländerna
Tepōlli	Penis
Āltepētl Yancuīc York	New York
Washington, D.C.	Washington, D.C.
San Francisco, California	San Francisco
Berlin	Berlin
Los Ángeles	Los Angeles
Chīuhpōhualhuaztli	Dator
Berna	Bern
Zurich	Zürich
Mātlatzālantli	Internet
Barack Obama	Barack Obama
Uruguay	Uruguay
Londres	London
In Cairo	Kairo
Alexandria	Alexandria
Manzana	Äpple
Paris	Paris
Abraham Lincoln	Abraham Lincoln
Google	Google
Mēxihco	Mexiko
Ilhuicaātl Atlántico	Atlanten
Tēpāpāquiltiliztli Ilhuicaātl	Stilla havet
California	Kalifornien
Mētztlitōnal	Måndag
Ic cē mētztli	Januari
Ic ōme mētztli	Februari
Ic ēyi mētztli	Mars (månad)
Chīchīlcītlalli	Mars (planet)
Quenia	Kenya
Etiopia	Etiopien
Ghana	Ghana
Ic nāuhtetl mētztli	April
Ic mācuīlli mētztli	Maj
Ic chicuacen mētztli	Juni
Ic chicōme mētztli	Juli
Ic chicuēyi mētztli	Augusti
Ic chiucnāhui mētztli	September
Ic mahtlāctetl mētztli	Oktober
Ic mahtlāctetl oncē mētztli	November
Ic mahtlāctetl omōme mētztli	December
Huītzilōpōchtōnal	Tisdag
Yacatlipotōnal	Onsdag
Tezcatlipotōnal	Torsdag
Quetzalcōātōnal	Fredag
Tlāloctitōnal	Lördag
Tōnatiuhtōnal	Söndag
Cuāmiztli	Lejon
Francia	Frankrike
Esperantotlahtōlli	Esperanto
Itzcuintli	Hund
Tlacetilīlli Huēyitlahtohcāyōtl	Storbritannien
Miztōn	Katt
China	Kina
Franciatlahtōlli	Franska
Michin	Fiskar
Octli	Alkoholdryck
Brasil	Brasilien
Rusia	Ryssland
Huēyātl	Hav
Π	Pi (bokstav)
Wiki	Wiki
Alabama	Alabama
São Paulo	São Paulo
São Paulo (tlahtohcāyōtl)	São Paulo (delstat)
Quebec	Québec
Jimmy Wales	Jimmy Wales
Alemania	Tyskland
Belarus	Vitryssland
Alemantlahtōlli	Tyska
Iztlālpan	Island
Estonia	Estland
Tzitzimicītlalli	Saturnus
Xocolātl	Choklad
Tepoztōtōtl	Flygplan
Cē (tlapōhualli)	1 (tal)
Ōme	2 (tal)
Ēyi	3 (tal)
Nāhui	4 (tal)
Mācuīlli	5 (tal)
George W. Bush	George W. Bush
Letonia	Lettland
Ucrania	Ukraina
Chequia	Tjeckien
Eslovaquia	Slovakien
Eslovenia	Slovenien
Vilnius	Vilnius
Moldova	Moldavien
Rumania	Rumänien
Bulgaria	Bulgarien
Roma	Rom
Tlācatlahtohcāyōtl Macedonia	Makedonien
Albania	Albanien
Groentlālpan	Grönland
Croacia	Kroatien
Bosnia īhuān Hertzegovina	Bosnien och Hercegovina
Nuuk	Nuuk
Azerbaiyan	Azerbajdzjan
Andorra	Andorra
Chipre	Cypern
Georgia	Georgien
Cazaquistan	Kazakstan
Malta	Malta
Flandes	Flandern
Monaco	Monaco
Tlīltepēc	Montenegro
In Vaticano	Vatikanstaten
San Marino	San Marino
Brusel	Bryssel (kommun)
Cuba	Kuba
Belice	Belize
Eiffel Huehcapan Calli	Eiffeltornet
Barbados	Barbados
Volkswagen	Volkswagen
Volkswagen Golf	Volkswagen Golf
Indonesia	Indonesien
Wolfgang Amadeus Mozart	Wolfgang Amadeus Mozart
Ludwig van Beethoven	Ludwig van Beethoven
Africa Huitztlāmpa	Sydafrika
Argelia	Algeriet
Ehecanamictiliztli Sandy	Orkanen Sandy
Uzbequistan	Uzbekistan
Poznan	Poznań
Varsovia	Warszawa
Modena	Modena
Huino	Vin
Ātl	Vatten
Huehcaīxipcaxitl	Television
Iztlahtōlli	Isländska
Chile	Chile
Jesucristo	Jesus
Elvis Presley	Elvis Presley
Galileo Galilei	Galileo Galilei
Payīnalcītlalli	Merkurius
Huēhuehcāyōmatiliztli	Historia
Apple Computer	Apple Inc.
Cītlalpōl	Venus
Tlahtōlli (tlahtōlmatiliztli)	Språk
Tlazohtiliztli	Kärlek
Huēyitzitzimicītlalli	Jupiter
Cītlalin īcue (Ilhuicamatiliztli)	Vintergatan
Ilhuicateōcītlalli	Uranus
Ricardo Lagos	Ricardo Lagos
Tlāloccītlalli	Neptunus
Ilhuicamatiliztli	Astronomi
Singapur	Singapore
Tlamatiliztli	Vetenskap
Mictlāntēuccītlalli	Pluto
María Ichpōchtli	Jungfru Maria
Liechtenstein	Liechtenstein
Adolf Hitler	Adolf Hitler
Facebook	Facebook
Īyāōyo in Cemānāhuac Inic Cē	Första världskriget
Īyāōyo in Cemānāhuac Inic Ōme	Andra världskriget
Köln	Köln
Vodka	Vodka
Tlapōhualtepoztli	Ur
Tlapōhualmatiliztli	Matematik
U2 (tlacuīcaliztli)	U2
Latintlahtōlli	Latin
Bahrein	Bahrain
Armenia	Armenien
Serbia	Serbien
Mētztli	Månen
Estambul	Istanbul
Australia	Australien
Carl Sagan	Carl Sagan
Iuhcāyōtl	Fysik
Argentina	Argentina
Peru	Peru
Yōlizmatiliztli	Biologi
Corea Mictlāmpa	Nordkorea
Camboya	Kambodja
Tēpouhtitlāzcuetzpalin	Dinosaurier
Islam	Islam
Pera	Päronsläktet
Liubliana	Ljubljana
Tlanelhuayōmatiliztli	Botanik
Malacatl	Hjul
Denis Diderot	Denis Diderot
Lyon	Lyon
Europan Cētiliztli	Europeiska unionen
Cihuātl	Kvinna
Sofiya	Sofia
Ñ	Ñ
El Ingenioso Hidalgo Don Quixote de la Mancha	Don Quijote
Xōchicuīcayōtl	Poesi
Milano	Milano
Torino	Turin
Cuichilli	Analöppning
Limacuahuitl	Citron
Émile Zola	Émile Zola
666	666
Xōchitl	Blomma
Āltepētl	Stad
Cītlalli	Stjärna
Tōnatiuh	Solen
Ilhuicatl	Himmel
Tlāhuīlxihuitl	Ljusår
Victor Hugo	Victor Hugo
Oceania	Oceanien
Tonacayōhuapāhualiztli	Friidrott
Tōnatiuh Īchān	Solsystemet
Baltico huēyātl	Östersjön
Āyōcoxqui	Väte
Tōnatiuhyoh	Helium
Angela Merkel	Angela Merkel
Iztactlāltepoztli	Beryllium
Āmoxtli	Bok
Tōnalli	Dygn
Timor Tlāpcopa	Östtimor
Yohualli	Natt
Xihuitl (cāhuitl)	År
Mācuīlpōhualxihuitl	Sekel
Lodz	Łódź
Oslo	Oslo
Bonn	Bonn
Katowice	Katowice
Ceres	Ceres (dvärgplanet)
Lisboa	Lissabon
Makemake	Makemake (dvärgplanet)
Eris	Eris (dvärgplanet)
Lionel Messi	Lionel Messi
Padova	Padua
Xacoiztatl	Bor
Mikołaj Kopernik	Nicolaus Copernicus
Tecolli	Kol
Ehēcatehuiltic	Kväve
Bergamo	Bergamo
Ehēcayoh	Syre
Nehnencācītlalli	Planet
Cuīcayōtl	Musik
Venezia	Venedig
Naruto	Naruto
Moscohuia	Moskva
Italiatlahtōlli	Italienska
Techichi	Chihuahua (hundras)
Yancuīquehēcatl	Neon
Chihuahhua	Chihuahua (delstat)
Sankt Peterburg	Sankt Petersburg
Chad	Tchad
Yancuīc Zetlālpan	Nya Zeeland
India	Indien
Tecpatepozteuh	Kisel
Tuvalu	Tuvalu
Tlīltic tepoztli	Järn
Tonga	Tonga
Tlequiquiztlālli	Svavel
Samoa	Samoa
Salomón Tlālhuāctli	Salomonöarna
Vanuatu	Vanuatu
Papua Yancuīc Guinea	Papua Nya Guinea
William Shakespeare	William Shakespeare
Palaos	Palau
Nauru	Nauru
Micronesia	Mikronesiens federerade stater
Tenextepoztli	Kalcium
Temētztli	Bly
Marshall Tlālhuāctli	Marshallöarna
Quiribati	Kiribati
Mongolia	Mongoliet
Fiyi	Fiji
Venezuela	Venezuela
Cuappatōlli	Schack
Maine	Maine
Tlapāltepoztli	Krom
Cahuāyoh	Häst
Amsterdam	Amsterdam
Yōlcatl	Djur
Surinam	Surinam
Paraguay	Paraguay
Guyana	Guyana
Tōltēcayōtl	Konst
Ecuador	Ecuador
Colombia	Colombia
Iztāctepoztli	Nickel
Bolivia	Bolivia
Chīchīltic tepoztli	Koppar
Trinidad īhuān Tobago	Trinidad och Tobago
Tlanelhuayōtl	Växt
San Vicente īhuān in Granadinas	Saint Vincent och Grenadinerna
Yancuīc Hampshire	New Hampshire
Santa Lucía	Saint Lucia
Leonardo da Vinci	Leonardo da Vinci
San Cristóbal īhuān Nevis	Saint Kitts och Nevis
Nanacatl	Svampar
Xamaica	Jamaica
Granada (tlācatiyān)	Grenada
Massachusetts	Massachusetts
Cuauhtēmallān	Guatemala
Bahamas	Bahamas
Connecticut	Connecticut
Cuānaca	Tamhöna
Antigua īhuān Barbuda	Antigua och Barbuda
Hawaii	Hawaii
Honduras	Honduras
Dominica	Dominica
Domingotlācatlahtohcāyōtl	Dominikanska republiken
Ilhuicaātl Ártico	Norra ishavet
Haiti	Haiti
Cōzcatlān	El Salvador
Iran	Iran
Irac	Irak
Alaska	Alaska
Costa Rica	Costa Rica
Israel	Israel
Utrecht	Utrecht
Panama	Panama
Yemen	Jemen
Poloniatlahtōlli	Polska
Iordania	Jordanien
Nicānāhuac	Nicaragua
Florida	Florida
Quirhuistan	Kirgizistan
Arizona	Arizona
Cuhuait	Kuwait
Lao	Laos
Libano	Libanon
Oregon	Oregon
Maldivas	Maldiverna
Ixachitlān	Amerika
Utah	Utah
Cuācuahueh	Nötkreatur
Malasia	Malaysia
Mianma	Burma
Nepal	Nepal
Omān	Oman
Paquistan	Pakistan
Catar	Qatar
Saudarabia	Saudiarabien
Sri Lanca	Sri Lanka
Siria	Syrien
Plátōn	Platon
Tayiquistan	Tadzjikistan
Pokémon	Pokémon
Taihuan	Taiwan
YouTube	Youtube
Aristotelēs	Aristoteles
Taitlālpan	Thailand
Tepozcōātl	Tåg
Turcmenistan	Turkmenistan
Tlacetilīlli Arabiaemiryōtl	Förenade Arabemiraten
Vietnam	Vietnam
Charles Chaplin	Charlie Chaplin
Novosibirsk	Novosibirsk
Corea Huitztlāmpa	Sydkorea
The Simpsons	Simpsons
Yekaterinburg	Jekaterinburg
Afganistan	Afghanistan
Nizhniy Novgorod	Nizjnij Novgorod
J.R.R. Tolkien	J.R.R. Tolkien
Cōztic teōcuitlatl	Guld
Omsk	Omsk
Tlamatiliztlācatl	Vetenskapsman
Bangladex	Bangladesh
Chelyabinsk	Tjeljabinsk
Rostov na Donu	Rostov-na-Donu
Mali	Mali
Sōcratēs	Sokrates
Volgograd	Volgograd
Angola	Angola
Butan	Bhutan
Brunei	Brunei
Tanzania	Tanzania
Yōliamochitl	Kvicksilver
Roald Amundsen	Roald Amundsen
Filipinas	Filippinerna
Tlācatlahtohcāyōtl Tlahco Africa	Centralafrikanska republiken
Isaac Newton	Isaac Newton
Albert Einstein	Albert Einstein
Cōztic	Gul
Togo	Togo
Tunez	Tunisien
Zambia	Zambia
Zimbahue	Zimbabwe
Pequin	Peking
Sudan Huitztlāmpa	Sydsudan
Benin	Benin
Botzhuana	Botswana
Burquina Faso	Burkina Faso
Burundi	Burundi
Comoras	Komorerna
Tlācatlahtohcāyōtl in Congo	Kongo-Brazzaville
Tlācatlahtohcāyōtl Tlācatēpacholiztli in Congo	Kongo-Kinshasa
San Antonio, Texas	San Antonio
Yibuti	Djibouti
Bavaria	Bayern
Guinea Tlahcotlālticpac	Ekvatorialguinea
Baden-Württemberg	Baden-Württemberg
Eritrea	Eritrea
Yancuīc Delhi	New Delhi
Ioannes Paulus II	Johannes Paulus II
Tibilisi	Tbilisi
Conētzintli	Spädbarn
Gabon	Gabon
Gambia	Gambia
Guinea	Guinea
Guinea Bissau	Guinea-Bissau
Tlanomihuēyātēnco	Elfenbenskusten
Camerun	Kamerun
Cabo Xoxoctic	Kap Verde
Lesoto	Lesotho
Liberia	Liberia
Libia	Libyen
Madagascar	Madagaskar
Malahui	Malawi
Stuttgart	Stuttgart
Mauritania	Mauretanien
Mauricio	Mauritius
Marruecos	Marocko
Mozambique	Moçambique
Namibia	Namibia
Niger	Niger
Nigeria	Nigeria
Charles Darwin	Charles Darwin
Uganda	Uganda
Ruanda	Rwanda
Santo Tomé īhuān Tlahtohcāpilli	São Tomé och Príncipe
Senegal	Senegal
Seychelles	Seychellerna
Sierra Leona	Sierra Leone
Somalia	Somalia
Nextictepoztli	Niob
Julius Caesar	Julius Caesar
Sudan	Sudan
Suazitlālpan	Swaziland
Cōzamālōtl	Regnbåge
Hamburg	Hamburg
Tlacetilīlli Tlācatiyān	Förenta nationerna
Dante Alighieri	Dante Alighieri
Tlālmatiliztli	Geologi
Cemānāhuacāyōtl	Geografi
Yōllōtl	Hjärta
Cuāyōllōtl	Hjärna
Cuetlaxtli	Hud
Tlapālli	Färg
Praha	Prag
Texohtic	Blå
Iztāc teōcuitlatl	Silver
Amochitl	Tenn
Ilhuicateōtepoztli	Uran
Mictlāntēuctepoztli	Plutonium
Tlāloctepoztli	Neptunium
Anime	Anime
Nelnextictepoztli	Tantal
Bill Clinton	Bill Clinton
Mumbai	Bombay
Michigan	Michigan
Aquitania	Aquitaine
Puerto Rico	Puerto Rico
Schleswig-Holstein	Schleswig-Holstein
Mecklenburg-Pommern Cihuātlāmpa	Mecklenburg-Vorpommern
Tlani Saxonia	Niedersachsen
Rhein Mictlāmpa-Westfalen	Nordrhein-Westfalen
Hessen	Hessen
Rheinland-Pfalz	Rheinland-Pfalz
Saarland	Saarland
Saxonia	Sachsen
John Lennon	John Lennon
Illinois	Illinois
Thüringen	Thüringen
Saxonia-Anhalt	Sachsen-Anhalt
Dakota Mictlāmpa	North Dakota
Brandenburg	Brandenburg
Bremen	Bremen (delstat)
Lombardia	Lombardiet
Dakota Huitztlāmpa	South Dakota
Montana	Montana
Wyoming	Wyoming
Ierusalem	Jerusalem
Idaho	Idaho
Washington	Washington (delstat)
Nevada	Nevada
Ilhuicaātl Índico	Indiska oceanen
Cosovo	Kosovo
Huēyātl Caribe	Karibiska havet
Ban Ki-moon	Ban Ki-moon
Kofi Annan	Kofi Annan
Javier Pérez de Cuéllar	Javier Pérez de Cuéllar
Colorado	Colorado
Frédéric Chopin	Frédéric Chopin
Neneuhcāyōtl:Índice de categorías	Kategori:Topp
Gent	Gent
Chicago	Chicago
The Beatles	The Beatles
Maastricht	Maastricht
Cehuetzilizpan	Vinter
Xōxōpan	Vår
Xōpantlah	Sommar
Pixcayān	Höst
Caxtillāntlahtōlli	Spanska
Montevideo	Montevideo
Johann Sebastian Bach	Johann Sebastian Bach
Antonio Vivaldi	Antonio Vivaldi
Opera	Opera
Calcuta	Calcutta
Opel Astra	Opel Astra
Daca	Dhaka
Tocatl	Spindlar
Islamabad	Islamabad
Virginia	Virginia
Virginia Tlāpcopa	West Virginia
Yancuīc York	New York (delstat)
Rhode Island	Rhode Island
Yolcatzin	Insekter
Maryland	Maryland
Delaware	Delaware
Ohio	Ohio
Pennsylvania	Pennsylvania
Uetersen	Uetersen
Augustus	Augustus
Yancuīc Jersey	New Jersey
Fintlahtōlli	Finska
Indiana	Indiana
Nokia	Nokia
Tepozmalacatl	Bil
Georgia (Tlacetilīlli Tlahtohcāyōtl)	Georgia
Zagreb	Zagreb
Texas	Texas
Genova	Genua
Carolina Mictlāmpa	North Carolina
Carolina Huitztlāmpa	South Carolina
Calabria	Kalabrien
Sicilia	Sicilien
Manillah	Manila
Sardegna	Sardinien
Feltre	Feltre
Buenos Aires	Buenos Aires
Āltepētl Mēxihco	Mexico City
Tōquiō	Tokyo prefektur
La Paz, Bolivia	La Paz
Barcelona	Barcelona
Matzahtli	Ananas
Mississippi	Mississippi
Tennessee	Tennessee
Richard Wagner	Richard Wagner
Astana	Astana
Yancuīc Mēxihco	New Mexico
Atēna	Aten
Minnesota	Minnesota
Bagdād	Bagdad
Caracas	Caracas
Tlatēcpānalli cemānāhuaccāhuitl	Koordinerad universell tid
Wisconsin	Wisconsin
Cyndi Lauper	Cyndi Lauper
Iowa	Iowa
Nebraska	Nebraska
Āltepētl Cuauhtēmallān	Guatemala City
Kansas	Kansas
La Ahuana	Havanna
Inditlahtōlli	Hindi
Maratitlahtōlli	Marathi
Missouri	Missouri
Louisiana	Louisiana
Kentucky	Kentucky
Arkansas	Arkansas
Urdutlahtōlli	Urdu
Oklahoma	Oklahoma
Danubio	Donau
Kiel	Kiel
Schwerin	Schwerin
Potsdam	Potsdam
Hannover	Hannover
Düsseldorf	Düsseldorf
Mainz	Mainz
Wiesbaden	Wiesbaden
Saarbrücken	Saarbrücken
Munich	München
Erfurt	Erfurt
Dresden	Dresden
Magdeburg	Magdeburg
Innsbruck	Innsbruck
Viena	Wien
Madonna	Madonna (artist)
Copenague	Köpenhamn
Estocolmo	Stockholm
Helsinqui	Helsingfors
Dublin	Dublin
Reikiavik	Reykjavik
Tallin	Tallinn
Rīga	Riga
Bratislava	Bratislava
Budapest	Budapest
Gdansk	Gdańsk
Frankfurt in Main	Frankfurt am Main
Wroclaw	Wrocław
Cemānāuhtic Quixtianayōtl	Katolicism
Vaduz	Vaduz
Teōāmoxtli	Bibeln
Āltepētl San Marino	San Marino (stad)
Nom Pen	Phnom Penh
Āltepētl Ho Chi Minh	Ho Chi Minh-staden
Hanoi	Hanoi
Jesús Nelli Iglesia	The True Jesus Church
Inglatlahtōlli	Engelska
Andorra in Huehcāuh	Andorra la Vella
Dong Hoi	Dong Hoi
Concepción, Chile	Concepción, Chile
Bologna	Bologna
Cagliari	Cagliari
Kiev	Kiev
Ontario	Ontario
Ottawa	Ottawa
Huēyitzitzimicītlalli īmētz	Jupiters naturliga satelliter
Yuba	Juba
Manitoba	Manitoba
Alberta	Alberta
Yancuīc Escocia	Nova Scotia
Erevan	Jerevan
Końskowola	Końskowola
Formula 1	Formel 1
Tzitzimicītlalli īmētz	Saturnus naturliga satelliter
British Columbia	British Columbia
2000	2000
2003	2003
2002	2002
2001	2001
Saskatchewan	Saskatchewan
2012	2012
2011	2011
2010	2010
2009	2009
2013	2013
2014	2014
2015	2015
2008	2008
Yukon	Yukon
2004	2004
2005	2005
2006	2006
Nunavut	Nunavut
2007	2007
Verona	Verona
1900	1900
1901	1901
1902	1902
Florencia	Florens
1903	1903
1904	1904
1905	1905
1907	1907
1906	1906
1908	1908
1909	1909
1992	1992
1991	1991
1990	1990
1993	1993
Essen	Essen
1994	1994
1995	1995
1996	1996
1910	1910
1911	1911
1912	1912
Leipzig	Leipzig
1913	1913
1914	1914
1915	1915
1916	1916
1997	1997
1998	1998
Nürnberg	Nürnberg
1999	1999
1917	1917
1918	1918
Tlacualli	Mat
Cōātl	Ormar
Onohuayān Arica īhuān Parinacota	Región de Arica y Parinacota
Onohuayān Antofagasta	Región de Antofagasta
Onohuayān Atacama	Región de Atacama
Onohuayān Coquimbo	Región de Coquimbo
Winnipeg	Winnipeg
Tlāloccītlalli īmētz	Neptunus naturliga satelliter
Āltepētl Quebec	Québec (stad)
1 ic cē mētztli	1 januari
2 ic cē mētztli	2 januari
Ilhuicateōcītlalli īmētz	Uranus naturliga satelliter
1920	1920
3 ic cē mētztli	3 januari
1919	1919
1921	1921
1922	1922
Onohuayān Maule	Región del Maule
4 ic cē mētztli	4 januari
1923	1923
Onohuayān Biobío	Región del Biobío
1924	1924
Onohuayān La Araucanía	Región de la Araucanía
Onohuayān Los Ríos	Región de Los Ríos
Onohuayān Los Lagos	Región de Los Lagos
5 ic cē mētztli	5 januari
Arica	Arica
6 ic cē mētztli	6 januari
7 ic cē mētztli	7 januari
8 ic cē mētztli	8 januari
9 ic cē mētztli	9 januari
10 ic cē mētztli	10 januari
11 ic cē mētztli	11 januari
12 ic cē mētztli	12 januari
13 ic cē mētztli	13 januari
14 ic cē mētztli	14 januari
15 ic cē mētztli	15 januari
16 ic cē mētztli	16 januari
17 ic cē mētztli	17 januari
18 ic cē mētztli	18 januari
19 ic cē mētztli	19 januari
20 ic cē mētztli	20 januari
21 ic cē mētztli	21 januari
22 ic cē mētztli	22 januari
23 ic cē mētztli	23 januari
Roma Emperadoryōtl	Romerska kejsardömet
24 ic cē mētztli	24 januari
25 ic cē mētztli	25 januari
Minsk	Minsk
26 ic cē mētztli	26 januari
27 ic cē mētztli	27 januari
28 ic cē mētztli	28 januari
29 ic cē mētztli	29 januari
30 ic cē mētztli	30 januari
31 ic cē mētztli	31 januari
2 Tlamahtlācōnti	2 december
1 Tlamahtlācōnti	1 december
Tlamahtlācōnti 3	3 december
Tlamahtlācōnti 7	7 december
Tlamahtlācōnti 5	5 december
Tlamahtlācōnti 8	8 december
Tlamahtlācōnti 10	10 december
Tlamahtlācōnti 6	6 december
Tlamahtlācōnti 9	9 december
Pink Floyd	Pink Floyd
AvtoVAZ	AvtoVAZ
Tlamahtlācōnti 4	4 december
1 Tlaōnti	1 februari
2 Tlaōnti	2 februari
3 Tlaōnti	3 februari
Kurów	Kurów
Tlaōnti 4	4 februari
Tlaōnti 5	5 februari
Tlaōnti 6	6 februari
Tlaōnti 7	7 februari
Tlaōnti 8	8 februari
Tlaōnti 9	9 februari
10 Tlaōnti	10 februari
14 Tlaōnti	14 februari
13 Tlaōnti	13 februari
15 Tlaōnti	15 februari
11 Tlaōnti	11 februari
12 Tlaōnti	12 februari
19 Tlaōnti	19 februari
17 Tlaōnti	17 februari
16 Tlaōnti	16 februari
18 Tlaōnti	18 februari
Tlaōnti 20	20 februari
21 Tlaōnti	21 februari
Tlaōnti 22	22 februari
Tlaōnti 23	23 februari
24 tlaōnti	24 februari
25 tlaōnti	25 februari
Tlaōnti 26	26 februari
27	27
Tlaōnti 27	27 februari
Tlaōnti 28	28 februari
Tlamahtlācōnti 11	11 december
Tlaōnti 29	29 februari
Tlamahtlācōnti 12	12 december
Tlamahtlācōnti 13	13 december
Tlamahtlācōnti 14	14 december
Tlamahtlācōnti 15	15 december
Tlayēti 2	2 mars
Tlayēti 3	3 mars
Tlayēti 5	5 mars
Tlayēti 1	1 mars
Tlayēti 7	7 mars
Tlayēti 8	8 mars
Tlayēti 4	4 mars
Tlayēti 10	10 mars
11 tlayēti	11 mars
Tlayēti 6	6 mars
Tlayēti 13	13 mars
Tlayēti 9	9 mars
12 tlayēti	12 mars
Tlayēti 15	15 mars
Tlayēti 14	14 mars
Tlamahtlācōnti 16	16 december
Tlamahtlācōnti 17	17 december
Tlayēti 16	16 mars
Tlayēti 17	17 mars
Tlayēti 18	18 mars
Tlayēti 19	19 mars
1989	1989
1988	1988
Tlayēti 20	20 mars
1987	1987
1986	1986
1985	1985
1984	1984
Tlayēti 21	21 mars
1983	1983
Tlayēti 22	22 mars
1982	1982
1981	1981
Tlamahtlācōnti 18	18 december
1980	1980
Tlayēti 23	23 mars
19 tlamahtlācōnti	19 december
Tlayēti 24	24 mars
Tlayēti 25	25 mars
Tlamahtlācōnti 20	20 december
Tlayēti 26	26 mars
Tlayēti 27	27 mars
Tlayēti 28	28 mars
Tlayēti 29	29 mars
Tlayēti 30	30 mars
Tlayēti 31	31 mars
Nassau	Nassau, Bahamas
1970	1970
1971	1971
1972	1972
1973	1973
1974	1974
1975	1975
1976	1976
1977	1977
1978	1978
1979	1979
1969	1969
Konrad Adenauer	Konrad Adenauer
Benedictus XVI	Benedictus XVI
Ludwig Erhard	Ludwig Erhard
15 Tlanāuhti	15 april
Tlanāuhti 13	13 april
Tlanāuhti 12	12 april
Tlanāuhti 14	14 april
Tlanāuhti 11	11 april
Tlanāuhti 10	10 april
Tlanāuhti 8	8 april
Tlanāuhti 9	9 april
7 tlanāuhti	7 april
Tlanāuhti 6	6 april
Tlanāuhti 5	5 april
Tlanāuhti 4	4 april
Tlanāuhti 3	3 april
Tlanāuhti 1	1 april
Tlanāuhti 2	2 april
Kurt Georg Kiesinger	Kurt Georg Kiesinger
Willy Brandt	Willy Brandt
Helmut Schmidt	Helmut Schmidt
Helmut Kohl	Helmut Kohl
Tlanāuhti 16	16 april
Tlanāuhti 17	17 april
Tlanāuhti 18	18 april
Tlanāuhti 19	19 april
20 Tlanāuhti	20 april
Tlanāuhti 21	21 april
22 Tlanāuhti	22 april
Tlanāuhti 23	23 april
Tlanāuhti 24	24 april
Gerhard Schröder	Gerhard Schröder
Tlanāuhti 25	25 april
Tlanāuhti 26	26 april
Tlanāuhti 27	27 april
Tlanāuhti 28	28 april
Tlanāuhti 29	29 april
Tlanāuhti 30	30 april
Christian Wulff	Christian Wulff
Horst Köhler	Horst Köhler
Tlamācuīlti 1	1 maj
Tlamācuīlti 2	2 maj
Tlamācuīlti 3	3 maj
Tlamācuīlti 4	4 maj
Tlamācuīlti 5	5 maj
Johannes Rau	Johannes Rau
Tlamācuīlti 6	6 maj
Tlamācuīlti 7	7 maj
Tlamācuīlti 8	8 maj
Tlamācuīlti 9	9 maj
Tlamācuīlti 10	10 maj
Tlamācuīlti 11	11 maj
Tlamācuīlti 12	12 maj
Tlamācuīlti 13	13 maj
Tlamācuīlti 14	14 maj
Tlamācuīlti 15	15 maj
Tlamācuīlti 16	16 maj
Tlamācuīlti 17	17 maj
Tlamācuīlti 18	18 maj
Tlamācuīlti 19	19 maj
Tlamācuīlti 20	20 maj
Tlamācuīlti 21	21 maj
Tlamācuīlti 22	22 maj
Tlamācuīlti 23	23 maj
Tlamācuīlti 24	24 maj
Tlamācuīlti 25	25 maj
Tlamācuīlti 26	26 maj
Tlamācuīlti 27	27 maj
Tlamācuīlti 28	28 maj
Tlamācuīlti 29	29 maj
Tlamācuīlti 30	30 maj
Tlamācuīlti 31	31 maj
Paul McCartney	Paul McCartney
Tlamahtlācōnti 21	21 december
Erich Honecker	Erich Honecker
Tlachicuazti 14	14 juni
Tlachicuazti 15	15 juni
Tlachicuazti 13	13 juni
Tlachicuazti 10	10 juni
7 Tlachicuazti	7 juni
Tlachicuazti 11	11 juni
9 Tlachicuazti	9 juni
Tlachicuazti 12	12 juni
6 Tlachicuazti	6 juni
8 Tlachicuazti	8 juni
5 Tlachicuazti	5 juni
3 Tlachicuazti	3 juni
2 Tlachicuazti	2 juni
1 Tlachicuazti	1 juni
4 Tlachicuazti	4 juni
Ringo Starr	Ringo Starr
Napoli	Neapel
Tlamahtlācōnti 22	22 december
George Harrison	George Harrison
1968	1968
Friedrich Ebert	Friedrich Ebert
1967	1967
1966	1966
1965	1965
1964	1964
Tlachicuazti 16	16 juni
Palermo	Palermo
Tlachicuazti 30	30 juni
Tlachicuazti 29	29 juni
Tlachicuazti 28	28 juni
Tlachicuazti 26	26 juni
Tlachicuazti 25	25 juni
Tlachicuazti 22	22 juni
Tlachicuazti 27	27 juni
Tlachicuazti 24	24 juni
Tlachicuazti 20	20 juni
Paul von Hindenburg	Paul von Hindenburg
Tlachicuazti 23	23 juni
Tlachicuazti 19	19 juni
Tlachicuazti 18	18 juni
Tlachicuazti 21	21 juni
Tlachicuazti 17	17 juni
Tlamahtlācōnti 23	23 december
Bruce Willis	Bruce Willis
Tlachicōnti 15	15 juli
13 Tlachicōnti	13 juli
Tlachicōnti 12	12 juli
10 Tlachicōnti	10 juli
Tlachicōnti 9	9 juli
Tlachicōnti 14	14 juli
Tlachicōnti 8	8 juli
Tlachicōnti 7	7 juli
Tlachicōnti 6	6 juli
Tlachicōnti 5	5 juli
Tlachicōnti 2	2 juli
Tlachicōnti 4	4 juli
Tlachicōnti 3	3 juli
1 Tlachicōnti	1 juli
Tlachicōnti 11	11 juli
Tlamahtlācōnti 24	24 december
Tlachicōnti 31	31 juli
Tlachicōnti 30	30 juli
Tlachicōnti 29	29 juli
Tlachicōnti 28	28 juli
Tlachicōnti 27	27 juli
Tlachicōnti 25	25 juli
Tlachicōnti 24	24 juli
Tlachicōnti 23	23 juli
Tlachicōnti 26	26 juli
Tlachicōnti 22	22 juli
Tlachicōnti 19	19 juli
Tlachicōnti 21	21 juli
Tlachicōnti 20	20 juli
Tlachicōnti 17	17 juli
Tlachicōnti 18	18 juli
Tlachicōnti 16	16 juli
Neicxitapayōlhuiliztli	Fotboll
Tlamahtlācōnti 25	25 december
Augsburg	Augsburg
1963	1963
Tlamahtlācōnti 26	26 december
1962	1962
Tlachicuēiti 14	14 augusti
Tlachicuēiti 15	15 augusti
Tlachicuēiti 13	13 augusti
Tlachicuēiti 12	12 augusti
Tlachicuēiti 11	11 augusti
Tlachicuēiti 10	10 augusti
Tlachicuēiti 8	8 augusti
Tlachicuēiti 7	7 augusti
Tlachicuēiti 9	9 augusti
Tlachicuēiti 5	5 augusti
Tlachicuēiti 4	4 augusti
Tlachicuēiti 2	2 augusti
Tlachicuēiti 3	3 augusti
Tlachicuēiti 6	6 augusti
Tlachicuēiti 1	1 augusti
Tlamahtlācōnti 27	27 december
Madrid	Madrid
Tlachicuēiti 16	16 augusti
Coca-Cola	Coca-Cola
Tlachicuēiti 29	29 augusti
Tlachicuēiti 28	28 augusti
Tlachicuēiti 30	30 augusti
Tlachicuēiti 25	25 augusti
Tlachicuēiti 26	26 augusti
23 Tlachicuēiti	23 augusti
Tlachicuēiti 27	27 augusti
Tlachicuēiti 21	21 augusti
Tlachicuēiti 20	20 augusti
Tlachicuēiti 24	24 augusti
Tlachicuēiti 18	18 augusti
Tlachicuēiti 17	17 augusti
Tlachicuēiti 22	22 augusti
Tlachicuēiti 19	19 augusti
Tlachicuēiti 31	31 augusti
Michael Jackson	Michael Jackson
Tlamahtlācōnti 28	28 december
Freiburg im Breisgau	Freiburg im Breisgau
Bogotá	Bogotá
Brasilia	Brasília
Tlachiucnāuhti 15	15 september
Tlachiucnāuhti 14	14 september
Tlachiucnāuhti 13	13 september
Tlachiucnāuhti 12	12 september
Tlachiucnāuhti 8	8 september
Tlachiucnāuhti 11	11 september
Tlachiucnāuhti 7	7 september
Tlachiucnāuhti 10	10 september
Tlachiucnāuhti 5	5 september
Tlachiucnāuhti 4	4 september
Tlachiucnāuhti 9	9 september
Tlachiucnāuhti 2	2 september
Tlachiucnāuhti 6	6 september
Tlachiucnāuhti 1	1 september
Tlachiucnāuhti 3	3 september
Tlamahtlācōnti 29	29 december
Lima	Lima
Tlachiucnāuhti 30	30 september
Tlachiucnāuhti 29	29 september
Tlachiucnāuhti 28	28 september
27 tlachiucnāuhti	27 september
Tlachiucnāuhti 26	26 september
Tlachiucnāuhti 25	25 september
Santiago de Chile	Santiago de Chile
Tlachiucnāuhti 23	23 september
Tlachiucnāuhti 22	22 september
Tlachiucnāuhti 24	24 september
Tlachiucnāuhti 21	21 september
Tlachiucnāuhti 20	20 september
Tlachiucnāuhti 18	18 september
Tlachiucnāuhti 17	17 september
Tlachiucnāuhti 19	19 september
16 tlachiucnāuhti	16 september
Quito	Quito
Tlamahtlācōnti 30	30 december
Sucre	Sucre
Tlamahtlācōnti 31	31 december
Tlamahtlācti 1	1 oktober
Tlamahtlācti 15	15 oktober
Tlamahtlācti 12	12 oktober
Tlamahtlācti 10	10 oktober
Tlamahtlācti 14	14 oktober
Tlamahtlācti 9	9 oktober
Tlamahtlācti 8	8 oktober
Tlamahtlācti 13	13 oktober
Tlamahtlācti 7	7 oktober
Tlamahtlācti 11	11 oktober
Tlamahtlācti 6	6 oktober
4 Tlamahtlācti	4 oktober
Tlamahtlācti 5	5 oktober
Tlamahtlācti 3	3 oktober
Tlamahtlācti 2	2 oktober
Asunción	Asunción
31 Tlamahtlācti	31 oktober
Tlamahtlācti 30	30 oktober
Tlamahtlācti 29	29 oktober
Tlamahtlācti 28	28 oktober
Tlamahtlācti 26	26 oktober
Tlamahtlācti 25	25 oktober
Tlamahtlācti 24	24 oktober
Tlamahtlācti 27	27 oktober
Tlamahtlācti 22	22 oktober
Tlamahtlācti 23	23 oktober
Tlamahtlācti 20	20 oktober
Tlamahtlācti 21	21 oktober
Tlamahtlācti 19	19 oktober
Tlamahtlācti 17	17 oktober
Tlamahtlācti 16	16 oktober
Tlamahtlācti 18	18 oktober
Heidelberg	Heidelberg
Ratisbona	Regensburg
Tlamahtlāccēti 15	15 november
Tlamahtlāccēti 14	14 november
Tlamahtlāccēti 13	13 november
Tlamahtlāccēti 12	12 november
Tlamahtlāccēti 11	11 november
Tlamahtlāccēti 10	10 november
Tlamahtlāccēti 7	7 november
Tlamahtlāccēti 8	8 november
Tlamahtlāccēti 9	9 november
Tlamahtlāccēti 6	6 november
Tlamahtlāccēti 5	5 november
Tlamahtlāccēti 4	4 november
Tlamahtlāccēti 3	3 november
Tlamahtlāccēti 2	2 november
Tlamahtlāccēti 1	1 november
Wurzburg	Würzburg
Paramaribo	Paramaribo
Ulm	Ulm
Tlamahtlāccēti 30	30 november
Tlamahtlāccēti 29	29 november
Tlamahtlāccēti 28	28 november
27 Tlamahtlāccēti	27 november
Tlamahtlāccēti 26	26 november
Tlamahtlāccēti 25	25 november
Tlamahtlāccēti 23	23 november
Tlamahtlāccēti 24	24 november
21 Tlamahtlāccēti	21 november
Tlamahtlāccēti 20	20 november
Tlamahtlāccēti 22	22 november
Tlamahtlāccēti 19	19 november
Tlamahtlāccēti 18	18 november
Tlamahtlāccēti 17	17 november
Tlamahtlāccēti 16	16 november
Belmopan	Belmopan
Carolus Magnus	Karl den store
San José, Costa Rica	San José, Costa Rica
San Salvador	San Salvador
Camberra	Canberra
Sydney	Sydney
Xoxoctic	Grön
Chīchīltic	Röd
Tletl	Eld
Tēuctzincalpan	Tegucigalpa
Mānāhuac	Managua
Āltepētl Panama	Panama City
George Orwell	George Orwell
Aosta	Aosta
Trento	Trento
Nilo	Nilen
Perugia	Perugia
Bari	Bari
Rabāt	Rabat
Popōcacītlallīn	Komet
Argel	Alger, Algeriet
Antofagasta	Antofagasta
Tehrān	Teheran
Adis Abeba	Addis Abeba
Yakarta	Jakarta
Ankara	Ankara
Asmara	Asmara
Yamena	N'Djamena
1961	1961
Bamako	Bamako
Belgrado	Belgrad
Banyul	Banjul
Conacri	Conakry
Bissau	Bissau
Neneuhcāyōtl:Nemachiyōtīlli	Kategori:Mallar
Praia	Praia
1960	1960
Acra	Accra
Damasco	Damaskus
Yamusukro	Yamoussoukro
Chillán	Chillán
Uagadugu	Ouagadougou
Ātōyātl Amazonas	Amazonfloden
Abuya	Abuja
Porto Novo	Porto-Novo
Ammān	Amman
Yaundé	Yaoundé
Coyhaique	Coyhaique
Malabo	Malabo
Libreville	Libreville
Malucca	Moluckerna
Buyumbura	Bujumbura
Nicosia	Nicosia
Doha	Doha
Copiapó	Copiapó
Nairobi	Nairobi
Manāmah	Manama
Catanzaro	Catanzaro
Luanda	Luanda
Moroni	Moroni
Galicia	Galicien
Maseru	Maseru
Huēyitlamachticalli	Universitet
Gaborone	Gaborone
Pretoria	Pretoria
Bamberg	Bamberg
Aschaffenburg	Aschaffenburg
Cantabria	Kantabrien
Chāntli	Hus
Liège	Liège
Vasconia	Baskien (autonom region)
Rosenheim	Rosenheim
Navarra	Navarra
Ātōyātl	Flod
Osasco	Osasco
Aragón	Aragonien
-36	36 f.Kr.
-20	20 f.Kr.
-40	40 f.Kr.
-39	39 f.Kr.
-37	37 f.Kr.
-22	22 f.Kr.
-38	38 f.Kr.
Cabo de Buena Esperanza	Godahoppsudden
Glasgow	Glasgow
-28	28 f.Kr.
-18	18 f.Kr.
-15	15 f.Kr.
-33	33 f.Kr.
Neu Ulm	Neu-Ulm
-30	30 f.Kr.
-12	12 f.Kr.
Ehēcalquixohuayān Dong Hoi	Dong Hoi flygplats
-45	45 f.Kr.
-46	46 f.Kr.
Passau	Passau
-41	41 f.Kr.
-49	49 f.Kr.
-42	42 f.Kr.
Tlīlcuauhtlah	Schwarzwald
-25	25 f.Kr.
-47	47 f.Kr.
-10	10 f.Kr.
Tlacetilīztli Huitzixachitēcatl Tlācatiyān	Sydamerikanska nationernas union
Curitiba	Curitiba
Chīchīltechalōtl	Ekorre
Cuauhtlah	Skog
Talca	Talca
Anna Faris	Anna Faris
Neneuhcāyōtl:Ōmicqueh xiuhpan 1481	Kategori:Avlidna 1481
Neneuhcāyōtl:Tuneztlācah	Kategori:Tunisier
Ātōyātl Andalién	Andalién
Jonathan Winters	Jonathan Winters
Neneuhcāyōtl:Āltepētl īpan Liechtenstein	Kategori:Liechtensteins kommuner
Sean Connery	Sean Connery
Rancagua	Rancagua
Marilyn Monroe	Marilyn Monroe
Corbin Bleu	Corbin Bleu
Neneuhcāyōtl:Tlapōhualmatiliztli	Kategori:Matematik
Aimaratlahtōlli	Aymara (språk)
Sherlock Holmes	Sherlock Holmes
Le Corbusier	Le Corbusier
Mēxihcatl peso	Mexikansk peso
1488	1488
Euro	Euro
Georgia (tlahtohcāyōtl)	Georgia (olika betydelser)
1004	1004
Berlin pāntli	Berlinmuren
Ācintli	Ris
Céline Dion	Céline Dion
Cemantoc tlālli	Världsdelar och kontinenter
Tōtōtl	Fåglar
Tēcuacān	Huvudstad
Monzón	Monzón
Portugallahtōlli	Portugisiska
Mētztli (cāhuitl)	Månad
1948	1948
1949	1949
Tlaōnti 2008	Februari 2008
Almazán	Almazán
Huang Xianfan	Huang Xianfan
Quechhuatlahtōlli	Quechua
1956	1956
1200	1200
1201	1201
1202	1202
1203	1203
1204	1204
1205	1205
1206	1206
1941	1941
1207	1207
1208	1208
1945	1945
1209	1209
1210	1210
1211	1211
1958	1958
1212	1212
1926	1926
1213	1213
1947	1947
1944	1944
1952	1952
Bill Gates	Bill Gates
Xapontlahtōlli	Japanska
Cēntlamatilizāmoxtli	Uppslagsverk
Vīdeocaquizcopīnalōni	DVD
Calīxatl	Portal:Huvudsida
1959	1959
Nemachiyōtīlli:Cualli tlahcuilōlli	Mall:Bra
1957	1957
1214	1214
1215	1215
Chiquiuhtapayōlhuiliztli	Basket
1216	1216
1217	1217
1218	1218
Mimalacatl	Bilsport
1219	1219
Olimpicayoh neāhuiltiliztli	Olympiska spelen
1220	1220
1221	1221
1222	1222
1223	1223
1224	1224
1225	1225
1226	1226
1227	1227
1228	1228
1229	1229
1230	1230
1231	1231
1232	1232
1233	1233
1234	1234
1235	1235
1236	1236
1237	1237
1238	1238
1239	1239
1240	1240
1241	1241
1242	1242
1243	1243
1244	1244
1245	1245
1246	1246
Āltepētl In Cabo	Kapstaden
Chuvasia	Tjuvasjien
Bart Simpson	Bart Simpson
1247	1247
1248	1248
1249	1249
1250	1250
1251	1251
1252	1252
1253	1253
1254	1254
1255	1255
1256	1256
Tepozocuilin	Tunnelbana
1257	1257
1258	1258
1259	1259
1260	1260
1261	1261
1262	1262
1263	1263
1264	1264
1265	1265
1266	1266
1267	1267
1268	1268
1269	1269
1270	1270
1271	1271
1272	1272
1273	1273
1274	1274
1275	1275
1276	1276
1277	1277
1278	1278
1279	1279
1280	1280
1281	1281
1282	1282
1283	1283
1284	1284
1285	1285
1286	1286
1287	1287
1288	1288
1289	1289
1290	1290
1291	1291
1292	1292
1293	1293
1294	1294
1295	1295
1296	1296
1297	1297
1298	1298
1299	1299
Salvador Dalí	Salvador Dalí
Albrecht Dürer	Albrecht Dürer
Vincent van Gogh	Vincent van Gogh
Frida Kahlo	Frida Kahlo
Pablo Picasso	Pablo Picasso
Frank Lloyd Wright	Frank Lloyd Wright
1300	1300
1301	1301
1302	1302
1303	1303
1304	1304
1305	1305
Miguel de Cervantes	Miguel Cervantes
Charles Dickens	Charles Dickens
Catalania	Katalonien
1306	1306
1307	1307
Cemāxcāyōtl Valencia	Valencia (autonom region)
1308	1308
1309	1309
La Rioja (Caxtillān)	La Rioja (autonom region)
1310	1310
1311	1311
1312	1312
1313	1313
Castillān īhuān León	Kastilien och León
1314	1314
1315	1315
1316	1316
1317	1317
Castillān-La Mancha	Kastilien-La Mancha
1318	1318
Cemāxcāyōtl Madrid	Madrid (autonom region)
Baleares	Balearerna
1319	1319
1320	1320
1321	1321
1322	1322
1323	1323
Cemāxcāyōtl Murcia	Murcia (autonom region)
1324	1324
1325	1325
Belen	Betlehem
Extremadura	Extremadura
1326	1326
Andalucía	Andalusien
1327	1327
1328	1328
Ernesto Guevara	Che Guevara
Canarias	Kanarieöarna
Córdoba, Caxtillān	Córdoba, Spanien
Ceuta	Ceuta
Melilla	Melilla
Toledo	Toledo, Spanien
Kabul	Kabul
Cuitlāmatl	Toalettpapper
Chichén Itzá	Chichén Itzá
Gabriel García Márquez	Gabriel García Márquez
Tamillahtōlli	Tamil
Tlazohmatiliztli	Filosofi
1329	1329
Neneuhcāyōtl:Huiquipedia:Borrar (definitivo)	Kategori:Snabbraderingar
Pianotli	Piano
1330	1330
1331	1331
1332	1332
1333	1333
1334	1334
1335	1335
1336	1336
1337	1337
1338	1338
1339	1339
1340	1340
1341	1341
1342	1342
1343	1343
1344	1344
1345	1345
1346	1346
1347	1347
1348	1348
1349	1349
1350	1350
Marco Polo	Marco Polo
1351	1351
Hebe Camargo	Hebe Camargo
1400	1400
1401	1401
1352	1352
1402	1402
1353	1353
1403	1403
1354	1354
1404	1404
1355	1355
1405	1405
1500	1500
1406	1406
1356	1356
1501	1501
1407	1407
1357	1357
1502	1502
1408	1408
1358	1358
1503	1503
1359	1359
1409	1409
1504	1504
1360	1360
1410	1410
1505	1505
1506	1506
1411	1411
1361	1361
1507	1507
1412	1412
1362	1362
1413	1413
1508	1508
1363	1363
1509	1509
1414	1414
1510	1510
1415	1415
1364	1364
1511	1511
1416	1416
1365	1365
1512	1512
1417	1417
1366	1366
Quintus Horatius Flaccus	Horatius
1513	1513
1418	1418
1367	1367
1514	1514
1419	1419
1368	1368
1515	1515
1420	1420
1369	1369
1516	1516
1421	1421
1370	1370
1371	1371
1372	1372
Pahuia	Pavia
1373	1373
1422	1422
1517	1517
1423	1423
1518	1518
1374	1374
1424	1424
1375	1375
1519	1519
1376	1376
1425	1425
1520	1520
1521	1521
1377	1377
1426	1426
1522	1522
1523	1523
1427	1427
1378	1378
1524	1524
1525	1525
1428	1428
1379	1379
1526	1526
1429	1429
1380	1380
1381	1381
1382	1382
1383	1383
1430	1430
1431	1431
1384	1384
1432	1432
1385	1385
1386	1386
1433	1433
1387	1387
1434	1434
1435	1435
1388	1388
1436	1436
1389	1389
1437	1437
1390	1390
1438	1438
1391	1391
1439	1439
1392	1392
1440	1440
Tlamānelōliztli	Simning
1393	1393
1394	1394
1395	1395
1441	1441
1396	1396
1397	1397
1442	1442
1527	1527
1528	1528
1398	1398
1443	1443
1444	1444
1529	1529
1399	1399
1445	1445
1530	1530
1446	1446
1531	1531
1447	1447
1532	1532
1448	1448
1533	1533
1449	1449
1534	1534
1450	1450
1535	1535
1451	1451
1536	1536
1452	1452
1537	1537
1453	1453
1538	1538
1454	1454
1539	1539
1455	1455
1540	1540
Neneuhcāyōtl:Ilhuicamatiliztli	Kategori:Astronomi
1541	1541
1456	1456
1457	1457
1542	1542
1458	1458
1543	1543
1459	1459
1544	1544
Bolzano	Bolzano
1460	1460
1545	1545
1461	1461
1546	1546
Günter Grass	Günter Grass
1462	1462
1547	1547
1463	1463
1548	1548
1464	1464
1549	1549
1465	1465
1550	1550
1466	1466
1551	1551
1467	1467
1468	1468
1552	1552
1469	1469
1553	1553
1470	1470
1554	1554
1471	1471
1555	1555
1472	1472
1556	1556
1473	1473
1557	1557
1474	1474
1558	1558
Strasbourg	Strasbourg
Mecahuēhuētl	Gitarr
1475	1475
1559	1559
1476	1476
1560	1560
1477	1477
1478	1478
1561	1561
1479	1479
1562	1562
1480	1480
1563	1563
1481	1481
1564	1564
1482	1482
1565	1565
Cuīlonyōtl	Homosexualitet
1483	1483
1566	1566
1484	1484
1567	1567
1485	1485
1486	1486
1568	1568
1487	1487
1569	1569
Croaciatlahtōlli	Kroatiska
1570	1570
Hamburtēcanacatl	Hamburgare
1489	1489
1571	1571
1490	1490
1572	1572
Tlācatecolōtl	Djävul
1491	1491
1573	1573
1492	1492
1574	1574
Renault	Renault
1493	1493
1575	1575
1494	1494
1495	1495
1496	1496
1576	1576
1497	1497
1577	1577
1498	1498
1578	1578
1499	1499
1579	1579
1580	1580
1581	1581
1582	1582
1600	1600
1601	1601
1583	1583
1602	1602
1584	1584
1603	1603
1585	1585
1604	1604
1586	1586
1605	1605
Peugeot	Peugeot
1587	1587
Citroën	Citroën
1606	1606
1607	1607
1588	1588
1608	1608
1589	1589
1609	1609
1590	1590
1610	1610
1591	1591
1611	1611
1592	1592
1612	1612
1593	1593
1613	1613
1594	1594
1614	1614
1595	1595
1615	1615
1596	1596
1616	1616
1597	1597
1617	1617
1598	1598
1618	1618
1599	1599
1619	1619
1620	1620
1621	1621
1700	1700
1701	1701
1622	1622
1623	1623
1702	1702
1624	1624
1703	1703
1704	1704
1625	1625
1705	1705
1626	1626
1627	1627
1706	1706
1628	1628
1707	1707
1708	1708
1629	1629
1630	1630
1709	1709
1631	1631
1710	1710
1632	1632
1711	1711
1633	1633
1712	1712
1634	1634
1713	1713
1800	1800
1801	1801
1714	1714
1635	1635
1802	1802
1715	1715
1636	1636
1803	1803
1637	1637
1716	1716
1638	1638
1804	1804
1717	1717
1639	1639
1805	1805
1718	1718
1640	1640
1719	1719
1806	1806
1641	1641
1720	1720
1807	1807
1642	1642
1721	1721
1808	1808
1643	1643
1722	1722
1809	1809
1644	1644
1723	1723
1810	1810
1645	1645
1724	1724
Mācuīlpōhualxihuitl XX	1900-talet
1811	1811
1646	1646
1725	1725
1812	1812
1647	1647
1726	1726
1813	1813
Mācuīlpōhualxihuitl XXI	2000-talet
1648	1648
1727	1727
1814	1814
1649	1649
1728	1728
1815	1815
1650	1650
1729	1729
1816	1816
Mācuīlpōhualxihuitl XIX	1800-talet
1651	1651
1730	1730
1817	1817
1652	1652
1731	1731
1818	1818
1653	1653
1732	1732
1819	1819
1654	1654
1733	1733
1820	1820
1655	1655
1821	1821
1734	1734
1656	1656
1822	1822
1735	1735
1657	1657
1823	1823
1736	1736
1658	1658
1737	1737
1824	1824
1659	1659
1738	1738
1825	1825
Silbermond	Silbermond
1660	1660
1739	1739
1826	1826
1661	1661
1740	1740
1827	1827
Mācuīlpōhualxihuitl 18	1700-talet
Mācuīlpōhualxihuitl 17	1600-talet
Mācuīlpōhualxihuitl 16	1500-talet
Mācuīlpōhualxihuitl 15	1400-talet
Catalantlahtōlli	Katalanska
Mācuīlpōhualxihuitl 14	1300-talet
Neneuhcāyōtl:Cīcītlaltin	Kategori:Stjärnor
Girona	Girona
Amberg	Amberg
Mācuīlpōhualxihuitl 13	1200-talet
Mācuīlpōhualxihuitl 12	1100-talet
Mācuīlpōhualxihuitl XI	1000-talet
Ahteōmatiliztli	Ateism
Cemitquimatiliztli	Politik
Tlācatēpacholiztli	Demokrati
Marie Curie	Marie Curie
Rosa Luxemburg	Rosa Luxemburg
Centēpacholiztli	Monarki
Pyotr Ilyich Tchaikovsky	Pjotr Tjajkovskij
Jacques Cartier	Jacques Cartier
Cristoforo Colombo	Christofer Columbus
Hernán Cortés	Hernán Cortés
Vasco da Gama	Vasco da Gama
Ilhuicaātl Antártico	Antarktiska oceanen
Nacaztli	Öra
Yacatl	Nos
Īxtelolotl	Öga
Cuīcatl	Sång
Mōyōtl	Stickmyggor
Ichcatl (yōlcatl)	Tamfår
Federico Fellini	Federico Fellini
Alfred Hitchcock	Alfred Hitchcock
Cameyoh	Kameler
Mammalia	Däggdjur
Āzcatl	Myror
Tozquitl	Rösten
Tlanitlālpantlahtōlli	Nederländska
Ingmar Bergman	Ingmar Bergman
Canauhtli	Egentliga andfåglar
Nantli	Moder
Cepayahuitl	Snö
Tahtli	Fader
Conētl	Barn
1828	1828
1829	1829
1741	1741
1662	1662
1742	1742
1830	1830
1663	1663
1831	1831
1743	1743
1664	1664
1665	1665
1744	1744
1832	1832
1666	1666
1745	1745
1833	1833
1667	1667
1746	1746
Huaznenqui	Transport
1834	1834
1668	1668
1747	1747
1835	1835
1748	1748
1836	1836
1669	1669
1670	1670
1749	1749
1837	1837
1671	1671
1750	1750
1838	1838
1672	1672
1751	1751
1839	1839
1673	1673
1752	1752
1840	1840
1674	1674
1753	1753
1841	1841
1754	1754
1675	1675
1842	1842
1755	1755
1676	1676
1843	1843
1677	1677
1756	1756
1844	1844
1678	1678
1757	1757
1845	1845
1679	1679
1758	1758
1846	1846
1680	1680
1759	1759
1847	1847
1681	1681
1760	1760
1848	1848
1682	1682
1761	1761
1849	1849
1683	1683
1762	1762
1850	1850
1684	1684
1763	1763
1851	1851
1764	1764
1685	1685
1852	1852
1686	1686
1765	1765
1853	1853
1687	1687
1766	1766
1854	1854
1688	1688
1767	1767
1855	1855
1689	1689
1768	1768
1856	1856
1690	1690
1769	1769
1857	1857
1691	1691
1770	1770
1858	1858
1692	1692
1771	1771
1859	1859
1693	1693
1772	1772
1860	1860
1773	1773
1861	1861
1694	1694
1695	1695
1774	1774
1862	1862
1696	1696
1775	1775
1863	1863
1697	1697
1776	1776
1864	1864
1698	1698
1865	1865
1777	1777
1699	1699
1866	1866
1778	1778
1779	1779
1867	1867
1780	1780
1868	1868
1781	1781
1869	1869
Minuto	Minut
Rusiatlahtōlli	Ryska
1782	1782
1870	1870
1783	1783
1871	1871
Vladimir Putin	Vladimir Putin
1784	1784
1872	1872
1785	1785
1873	1873
1786	1786
1874	1874
1787	1787
1875	1875
1788	1788
1876	1876
1789	1789
1877	1877
1790	1790
1878	1878
Ītlahtōllō Caxtillān	Spaniens historia
1879	1879
1791	1791
1792	1792
1880	1880
1793	1793
1881	1881
Homer Simpson	Homer Simpson
1794	1794
1882	1882
1795	1795
1883	1883
1796	1796
1884	1884
1797	1797
1885	1885
1886	1886
1798	1798
1887	1887
1799	1799
1888	1888
1889	1889
1890	1890
René Magritte	René Magritte
1891	1891
Suahilitlahtōlli	Swahili
1892	1892
1893	1893
1894	1894
1895	1895
1896	1896
1897	1897
1898	1898
Chinatlahtōlli	Kinesiska
1899	1899
Cuitlacalli	Toalett
Yeliztli	Natur
Achyolli	Cell
Eztli	Blod
Toulouse	Toulouse
Miquiztetl	Skelett
Casablanca	Casablanca
Rumaniatlahtōlli	Rumänska
Quiyahuitl	Regn
Tlālolīniliztli	Jordbävning
Sergej Ėjzenštejn	Sergej Eisenstein
Akira Kurosawa	Akira Kurosawa
Nelson Mandela	Nelson Mandela
Mācuīlpōhualxihuitl X	900-talet
Tletepētl	Vulkan
Mixtli	Moln
Atēna 1896	Olympiska sommarspelen 1896
Mācuīlpōhualxihuitl IX	800-talet
Mācuīlpōhualxihuitl VIII	700-talet
Paris 1900	Olympiska sommarspelen 1900
Mācuīlpōhualxihuitl VII	600-talet
Mācuīlpōhualxihuitl VI	500-talet
Ehēcatl	Vind
Mācuīlpōhualxihuitl V	400-talet
Telugutlahtōlli	Telugu
Saint Louis 1904	Olympiska sommarspelen 1904
Mācuīlpōhualxihuitl IV	300-talet
Mācuīlpōhualxihuitl III	200-talet
Mācuīlpōhualxihuitl II	100-talet
Mācuīlpōhualxihuitl I	000-talet
Londin 1908	Olympiska sommarspelen 1908
Antwerpen 1920	Olympiska sommarspelen 1920
Paris 1924	Olympiska sommarspelen 1924
Amsterdam 1928	Olympiska sommarspelen 1928
Los Ángeles 1932	Olympiska sommarspelen 1932
Xapon Yen	Yen
Berlin 1936	Olympiska sommarspelen 1936
Tlahtōlmatiliztli	Språkvetenskap
Cirilo īmachiyōtlahtōltecpantiliz	Kyrilliska alfabetet
Greciamachiyōtlahtōltecpantiliztli	Grekiska alfabetet
Latinmachiyōtlahtōltecpantiliztli	Latinska alfabetet
Neneuhcāyōtl:Bulgaria	Kategori:Bulgarien
Tlahcuilōcāyōtl	Litteratur
Neneuhcāyōtl:Francia	Kategori:Frankrike
Neneuhcāyōtl:Cuīcayōtl	Kategori:Musik
Neneuhcāyōtl:Tlahcuilōcāyōtl	Kategori:Litteratur
Manga	Manga
Tepozquiquiztli	Trumpet
Jazz	Jazz
Ehuatlapitzalli	Säckpipa
Violin	Violin
Valladolid	Valladolid
Londin 1948	Olympiska sommarspelen 1948
Helsinqui 1952	Olympiska sommarspelen 1952
Melbourne 1956	Olympiska sommarspelen 1956
Roma 1960	Olympiska sommarspelen 1960
Tōquiō 1964	Olympiska sommarspelen 1964
Āltepētl Mēxihco 1968	Olympiska sommarspelen 1968
Munich 1972	Olympiska sommarspelen 1972
Hugo Chávez Frías	Hugo Chávez
Oquichtli	Man
Montreal 1976	Olympiska sommarspelen 1976
Moscohuia 1980	Olympiska sommarspelen 1980
Los Ángeles 1984	Olympiska sommarspelen 1984
Seul 1988	Olympiska sommarspelen 1988
Barcelona 1992	Olympiska sommarspelen 1992
Pātzcatl	Juice
Chīchīhualātl	Mjölk
Tepētl	Berg
Huāccāīxtlāhuatl	Öken
Atlanta 1996	Olympiska sommarspelen 1996
Sydney 2000	Olympiska sommarspelen 2000
Atēna 2004	Olympiska sommarspelen 2004
Pequin 2008	Olympiska sommarspelen 2008
Olimpiayōtl Nemīmīnaliztli Londres 2012	Olympiska sommarspelen 2012
Simón Bolívar	Simón Bolívar
Hong Kong	Hongkong
Miami	Miami
Lagos	Lagos
Rio de Janeiro	Rio de Janeiro
Seul	Seoul
Xanghai	Shanghai
Bilbao	Bilbao
Walt Disney	Walt Disney
Sevilla	Sevilla
Thomas Alva Edison	Thomas Edison
Vigo	Vigo
Michael Faraday	Michael Faraday
Vascotlahtōlli	Baskiska
In Coruña	A Coruña
Granada, Caxtillān	Granada (stad)
Valencia	Valencia
Palma de Mallorca	Palma de Mallorca
Málaga	Málaga
Cītlalōlli	Lejonet (stjärnbild)
Cītlallachtli	Orion (stjärnbild)
Cītlalcuetzpalli	Pegasus (stjärnbild)
Cītlalcōlōtl	Skorpionen (stjärnbild)
Satyajit Ray	Satyajit Ray
Cītlalocēlōtl	Stora björnen
Miaccītlalli	Stjärnbild
Johannes Gutenberg	Johannes Gutenberg
Cancún	Cancún
Max Planck	Max Planck
Ātemaxac	Guadalajara, Mexiko
Sueciatlahtōlli	Svenska
Dantlahtōlli	Danska
Karl Marx	Karl Marx
Esloveniatlahtōlli	Slovenska
Voltaire	Voltaire
Machiliztli	Kunskap
Chīchīhualli	Kvinnobröst
Nantzintetl	Atom
Tlāhuīlli	Ljus
Greciatlahtōlli	Grekiska
Tōtōmichin	Pingviner
E-mail	E-post
Teōmatiliztli	Religion
Coreatlahtōlli	Koreanska
René Descartes	René Descartes
Vietnantlahtōlli	Vietnamesiska
Sigmund Freud	Sigmund Freud
Neneuhcāyōtl:Miaccītlalli	Kategori:Stjärnbilder
Mongollahtōlli	Mongoliska
Bacu	Baku
Judaísmo	Judendom
Timbu	Thimphu
Bandar Seri Begawan	Bandar Seri Begawan
Galiciatlahtōlli	Galiciska
Immanuel Kant	Immanuel Kant
Vianchan	Vientiane
Male	Malé
Ēltapachtli	Lever
Tanahtli	Testikel
Tōchtli	Kaniner
Ninja	Ninja
Tlācacuetlāchtli	Varulv
Timbuctu	Timbuktu
Ilhuicaātl	Ocean
Mahoma	Muhammed
IPod	Ipod
Burgos, Caxtillān	Burgos
Honda	Honda
ITunes	Itunes
Catolicismo Romano	Romersk-katolska kyrkan
Xillāntli	Buken
Bengalatlahtōlli	Bengali
Camatl	Mun
Cuitlaxcolli	Tarm
A	A
Michael Schumacher	Michael Schumacher
Vancouver 2010	Olympiska vinterspelen 2010
Cihuātlahtoāni Elizabeth II	Elizabeth II
B	B
Gioachino Rossini	Gioacchino Rossini
G	G
U	U
Z	Z
Blues	Blues
F	F
J	J
Machiyōtlahtōliztli	Bokstav
Reggae	Reggae
T	T
C	C
R	R
D	D
Α	Alfa
Ω	Omega
I	I
Μ	My
E	E
H	H
K	K
L	L
M	M
Fanta	Fanta
N	N
O	O
P	P
Q	Q
S	S
Ronald Reagan	Ronald Reagan
V	V
W	W
X	X
Y	Y
À	À
Á	Á
Ä	Ä
É	É
È	È
Ë	Ë
Φ	Fi
Zulutlahtōlli	Zulu (språk)
Zazatlahtōlli	Zazaiska
Pamplona	Pamplona
Zaragoza	Zaragoza
Unterallgäu (calpōlli)	Landkreis Unterallgäu
Cītlaltecpatl	Södra fisken
Aichach-Friedberg	Landkreis Aichach-Friedberg
Weilheim-Schongau (calpōlli)	Landkreis Weilheim-Schongau
Cītlalxonecuilli	Stora hunden
Unterfranken	Unterfranken
Mittelfranken	Mittelfranken
Oberfranken	Oberfranken
Oberpfalz	Oberpfalz
Schwaben (Bavaria)	Schwaben (Bayern)
Niederbayern	Niederbayern
Oberbayern	Oberbayern
Cītlalmamalhuāztli	Oxen (stjärnbild)
1100	1100
Neneuhcāyōtl:Venezuela	Kategori:Venezuela
Belfast	Belfast
Cardiff	Cardiff
Tlapēuhcāyōtl nemachiyōtīlpāntli	Periodiska systemet
Georgetown	Georgetown, Guyana
Tēyōllālih	Dildo
Mariano Rajoy	Mariano Rajoy
Nemiltōpīllōtl	Bakterier
Cuahuitl	Träd
Λ	Lambda
Emo	Emo
Tlatetzauhtli	Ost
Xocomecatl	Druva
Neuctli	Honung
Tlālcamohtli	Potatis
Caxtillān chiyancaca	Socker
Xiuhtlacualli	Grönsaker
Āmantēcayōtl	Teknologi
Huehcacaquiztli	Telefon
The Rolling Stones	The Rolling Stones
Chihuātlahcāyōtl	Kultur
Sanscritotlahtōlli	Sanskrit
Lugo	Lugo
Tīciyōtl	Medicinsk vetenskap
Sarayevo	Sarajevo
Tlapōhuallōtl	Aritmetik
Ōme Huēyicnīuhcalli	World Trade Center
Kubuntu	Kubuntu
Iztātl	Salt
Fidel Castro	Fidel Castro
Neneuhcāyōtl:Brasil	Kategori:Brasilien
Neneuhcāyōtl:Rumania	Kategori:Rumänien
Tlātlamantic cuīcayōtl	Alternativ rock
Rock	Rockmusik
Huēhuētl	Trumma
Tlapitzalli	Flöjt
Tlaihīyōānani tetl	Magnet
Āhuilli	Leksak
Īxiptlayōlli	Film
Tlayōlītīliztli	Animering
Ahuiyapopotl	Gas
Omalacatl	Cykel
Ācalli	Skepp
Mīllahcayōtl	Jordbruk
Tlaquēmitl	Kläder
Xaltehuilotl	Glas
Cāhuitl	Tid
Tetehuitl	Papper
Tecololli	Plast
Tlapōhualli	Tal
Huehcan	Meter
Cintli	Majs
Judy Garland	Judy Garland
Mācēhualiztli	Dans
Nirvana (tlacuīcaliztli)	Nirvana (musikgrupp)
Leopold Figl	Leopold Figl
Karl Renner	Karl Renner
Engelbert Dollfuß	Engelbert Dollfuss
Ö	Ö
Tlācatiyān	Lista över självständiga stater
Nagoya	Nagoya
Heinz Fischer	Heinz Fischer
Jürgen Trittin	Jürgen Trittin
Tlācamāyeh	Björnar
John Adams	John Adams
Kevin Costner	Kevin Costner
Quimichin Mickey	Musse Pigg
Quimichin Minnie	Mimmi Pigg
Guadalajara, Caxtillān	Guadalajara, Spanien
Alicante	Alicante
Las Palmas de Gran Canaria	Las Palmas de Gran Canaria
Teōcuahuitl	Eksläktet
1101	1101
1102	1102
Caxtillān tlaōlli	Vetesläktet
2040	2040
2039	2039
2038	2038
2037	2037
2036	2036
2035	2035
Cocoliztli	Sjukdom
Gregorio xiuhpōhualli	Gregorianska kalendern
Cocoliztli īpan mochīuh nepapan āltepētl	Pandemi
Nantes	Nantes
Tētzāuhcocoliztli	Tuberkulos
Mātlālzahuatl	Smittkoppor
Murcia	Murcia
Santander	Santander, Spanien
Huelva	Huelva
Calmanaliztli	Arkitektur
Pontevedra	Pontevedra
1103	1103
1104	1104
அப்பாசியக் கலீபகம்	Abbasidkalifatet
Latinixachitlān	Latinamerika
Āyōllohco Mēxihco	Mexikanska golfen
2034	2034
2033	2033
2032	2032
Tepozmācuahuitl	Svärd
2031	2031
2030	2030
2029	2029
Nepōhualtzintzin	Abakus
2028	2028
2027	2027
Cem Özdemir	Cem Özdemir
Antwerpen	Antwerpen
Yacatēuctli (cītlalli)	Polstjärnan
Īpān Belgica	Belgiens flagga
Teate	Chieti
Tzontecomatl	Kranium
Ronda, Málaga	Ronda
Xālīxco	Jalisco
Ezxocotl	Granatäpple
Duraznocuahuitl	Persika
Naranjaxocotl	Apelsin
Limōnxocotl	Lime
Romanitlahtōlli	Romani
Tzapotēcatlahtōlli	Zapotekiska
Xhosatlahtōlli	Xhosa
Graz	Graz
Nāhuatlahtōlli	Nahuatl
Navajotlahtōlli	Navajo (språk)
Yucatēcatl mayatlahtōlli	Yukatek
Luca	Lucca
Pisa	Pisa
Tiyānquiztli (Ilhuicamatiliztli)	Plejaderna (stjärnhop)
Tarento	Taranto
Yopal	Yopal
Mēxihco Tenōchtitlan	Tenochtitlán
Motēuczōma Ilhuicamīna	Moctezuma I
1105	1105
Angelina Jolie	Angelina Jolie
Arabiatlahtōlli	Arabiska
Zotolin	Palmer
Afrikaantlahtōlli	Afrikaans
Ü	Ü
Ï	Ï
Matlatzalan axcayotl	Toppdomän
Santiago de Compostela	Santiago de Compostela
Oviedo	Oviedo
Vitoria	Vitoria-Gasteiz
The Day After Tomorrow	The Day After Tomorrow
Mérida, Caxtillān	Mérida
Logroño	Logroño
Santa Cruz de Tenerife	Santa Cruz de Tenerife
Michmāliztli	Fiske
Β	Beta
Γ	Gamma
Ε	Epsilon
Ζ	Zeta
Η	Eta
Θ	Theta
Ι	Jota
Κ	Kappa (bokstav)
Ν	Ny
Velociraptor	Velociraptor
Ξ	Xi
Ο	Omikron
Ρ	Rho
Σ	Sigma
Τ	Tau
Υ	Ypsilon
Ψ	Psi
Iquique	Iquique
Pascua tlālhuāctli	Påskön
La Serena, Chile	La Serena
Pāmitl	Flagga
Ć	Ć
Ahcopechtli	Bord
Chictzapocuahuitl	Manilkara zapota
Icpalli	Stol
Tarragona	Tarragona
Albacete	Albacete
Yancuīc León	Nuevo León
Āltepēcalpōllōtl	Kommun
Īxiptlayōltzintli	TV-program
Cáceres	Cáceres
Badajoz	Badajoz
Cádiz	Cádiz
Segovia	Segovia
Salamanca, Caxtillān	Salamanca, Spanien
Zamora, Caxtillān	Zamora (stad)
León, Caxtillān	León
Xotl	Fot
Queen	Queen
Freddie Mercury	Freddie Mercury
Cipactli	Ödlor
Metallica	Metallica
Wolfgang Schäuble	Wolfgang Schäuble
Maldonado	Maldonado
Mario Benedetti	Mario Benedetti
Б	Б
А	А
Г	Г
Д	Д
В	В
Ґ	Ґ
Ahcōlli	Axel (kroppsdel)
Death Cab For Cutie	Death Cab for Cutie
Huiquipedia:Cenca cualtzin tlahcuilōlli	Wikipedia:Utmärkta artiklar
Nemachiyōtīlli:Link FA	Mall:Link FA
Huiquipedia:Tlecuitl	Wikipedia:Bybrunnen
Vermont	Vermont
San Diego, California	San Diego
San José, California	San Jose, Kalifornien
Denver	Denver
Houston	Houston
Phoenix	Phoenix
Dallas	Dallas
Austin	Austin
Īpān Rusia	Rysslands flagga
Nanquin	Nanjing
Edgar Allan Poe	Edgar Allan Poe
Los Ángeles (Chile)	Los Ángeles
Teōpantli	Kyrka
Oakland	Oakland
Ђ	Ђ
Ehēcatlanōnōtzqui	Mobiltelefoni
Stephen Hawking	Stephen Hawking
Safo	Sapfo
Ācacalōtl	Jabirustork
Sacramento, California	Sacramento
Honolulu	Honolulu
1925	1925
1927	1927
ABBA	Abba
1000	1000
999	999
Cuetlāchtli	Varg
Tucson	Tucson
1955	1955
1954	1954
1953	1953
1951	1951
1950	1950
1946	1946
1943	1943
1942	1942
1940	1940
1939	1939
1938	1938
1937	1937
1936	1936
1935	1935
1934	1934
1933	1933
1932	1932
1931	1931
1930	1930
1929	1929
Pionyan	Pyongyang
Chiucnāhui	9 (tal)
Cōlōtl	Skorpioner
1001	1001
1002	1002
1003	1003
1005	1005
1006	1006
1007	1007
1008	1008
1009	1009
1010	1010
1011	1011
1012	1012
1013	1013
1014	1014
1015	1015
1016	1016
1017	1017
1018	1018
1019	1019
1020	1020
1021	1021
1022	1022
1023	1023
1024	1024
1025	1025
1026	1026
1027	1027
1028	1028
1029	1029
1030	1030
1031	1031
1032	1032
1033	1033
1034	1034
1035	1035
1036	1036
1037	1037
1038	1038
1039	1039
1040	1040
1041	1041
San Pedro de la Paz	San Pedro de la Paz
1042	1042
1043	1043
1044	1044
1045	1045
1046	1046
1047	1047
1048	1048
1049	1049
1050	1050
1051	1051
1052	1052
1053	1053
1054	1054
1055	1055
1056	1056
1057	1057
1058	1058
1059	1059
1060	1060
1061	1061
1062	1062
1063	1063
1064	1064
1065	1065
1066	1066
1067	1067
1068	1068
1069	1069
1070	1070
1071	1071
1072	1072
1073	1073
1074	1074
1075	1075
1076	1076
1077	1077
1078	1078
1079	1079
1080	1080
1081	1081
1082	1082
1083	1083
1084	1084
1085	1085
1086	1086
1087	1087
1088	1088
1089	1089
1090	1090
1091	1091
1092	1092
1093	1093
1094	1094
1095	1095
1096	1096
1097	1097
Nha Trang	Nha Trang
1098	1098
1099	1099
1106	1106
1107	1107
1108	1108
1109	1109
1110	1110
Podolsk	Podolsk
1111	1111
1112	1112
1113	1113
1114	1114
1115	1115
1116	1116
1117	1117
1118	1118
1119	1119
1120	1120
Huēyiteōpixcātlahtoāni	Påve
1130	1130
Simferopol	Simferopol
1131	1131
Rafael Correa	Rafael Correa
1132	1132
1133	1133
1134	1134
1135	1135
1136	1136
1137	1137
1138	1138
1139	1139
5	5
1140	1140
1141	1141
1142	1142
1143	1143
1144	1144
4	4
1145	1145
1146	1146
1147	1147
1148	1148
3	3
1149	1149
1150	1150
1151	1151
1152	1152
1153	1153
2	2
1154	1154
1155	1155
1156	1156
1157	1157
1158	1158
1159	1159
1160	1160
1161	1161
1162	1162
1163	1163
1164	1164
Louvre	Louvren
1165	1165
1166	1166
1167	1167
1168	1168
1169	1169
1170	1170
Partido Independentista Puertorriqueño	Puertoricanska självständighetspartiet
1171	1171
1172	1172
1173	1173
Tirana	Tirana
1174	1174
1175	1175
1176	1176
1177	1177
1178	1178
Motorhead	Motörhead
1179	1179
1180	1180
1181	1181
Axno	Åsna
1182	1182
1928	1928
1183	1183
1184	1184
1185	1185
1186	1186
1187	1187
1188	1188
1189	1189
1190	1190
1191	1191
1192	1192
1193	1193
1194	1194
1195	1195
1196	1196
1197	1197
1198	1198
1199	1199
Huiquipedia:Cualtzin tlahcuilōlli	Wikipedia:Bra artiklar
6	6
Josh Duhamel	Josh Duhamel
Tlācatilizilhuitl	Jul
Romatlahtōlli	Romanska språk
Huēytlaōntic xihuitl	Skottår
Steve Jobs	Steve Jobs
Lady Gaga	Lady Gaga
Breinigerberg	Breinigerberg
Huēhuehocēlōtl	Tiger
Juan Carlos I	Juan Carlos I av Spanien
Francesco Totti	Francesco Totti
Nissan	Nissan (bilmärke)
Samsung	Samsung
Paxcua	Påsk
Muse	Muse
Quimichtechalōtl	Jordekorrar
Chapopohtli	Petroleum
Cemonocāyōtl cemānāhuacāyōcopa	Geografiska koordinatsystem
Atepipitztli	Skalbaggar
Cactli	Sko
Chināncalli	Park
Pennsylvania-teutontlahtōlli	Pennsylvaniatyska
Xocomecamīllah	Vingård
Āxōlōtl	Axolotl
1	1
10	10
20	20
Sussex Tlāpcopa	East Sussex
30	30
Audi	Audi
Abcasia	Abchazien
40	40
9	9
7	7
8	8
Chicōme	7 (tal)
Chicuēyi	8 (tal)
Taylor Lautner	Taylor Lautner
Jeremy Renner	Jeremy Renner
12	12
Chicōntōnalli	Vecka
Mazātl	Hjortdjur
Cetl	Is
Totahtziné	Herrens bön
Ātezcatl	Insjö
Caxtillān xōnacatl	Vitlök
Musée d'Orsay	Musée d’Orsay
930	930
13	13
985	985
1122	1122
981	981
939	939
Osetia Huitztlāmpa	Sydossetien
Ernest Hemingway	Ernest Hemingway
Edinburgh	Edinburgh
51	51
Octave Mirbeau	Octave Mirbeau
Tlālhuāctli	Ö (landområde)
Iztāc	Vit
Tlīltic	Svart
814	814
678	678
950	950
679	679
996	996
680	680
37	37
980	980
900	900
1129	1129
Chris Pine	Chris Pine
843	843
Lordi	Lordi
690	690
691	691
988	988
692	692
476	476
693	693
Marseille	Marseille
694	694
695	695
Xōnacatl	Lök (art)
696	696
Chicuacē	6 (tal)
697	697
698	698
Achcauhtlahtolli	Officiellt språk
699	699
700	700
Moshchena	Mosjtjena
701	701
702	702
703	703
Xītomatl	Tomat
704	704
705	705
George H. W. Bush	George H.W. Bush
706	706
68	68
89	89
707	707
708	708
709	709
11	11
710	710
711	711
Paltoga	Paltoga
712	712
713	713
714	714
715	715
Dmitri Medvedev	Dmitrij Medvedev
716	716
717	717
718	718
719	719
720	720
Protestantismo	Protestantism
721	721
722	722
Selena	Selena Quintanilla
723	723
Bryan Cranston	Bryan Cranston
724	724
Mérida, Venezuela	Mérida, Venezuela
725	725
726	726
727	727
728	728
729	729
963	963
730	730
Podgoritza	Podgorica
731	731
962	962
732	732
733	733
997	997
734	734
972	972
735	735
955	955
901	901
736	736
737	737
936	936
738	738
953	953
902	902
739	739
15	15
740	740
14	14
741	741
742	742
17	17
743	743
958	958
744	744
500	500
745	745
150	150
746	746
880	880
747	747
748	748
Tlahtōltecpantiliztli	Ordbok
749	749
870	870
903	903
750	750
751	751
752	752
Cuaitl	Huvud
753	753
987	987
754	754
965	965
755	755
924	924
951	951
932	932
23	23
800	800
120	120
42	42
967	967
989	989
960	960
969	969
957	957
1124	1124
971	971
937	937
992	992
990	990
899	899
975	975
942	942
966	966
1128	1128
959	959
973	973
18	18
Rowan Atkinson	Rowan Atkinson
19	19
16	16
Las Vegas, Nevada	Las Vegas
21	21
26	26
41	41
32	32
33	33
982	982
974	974
976	976
979	979
986	986
919	919
998	998
Palestina	Palestina
995	995
977	977
1125	1125
934	934
Mahtlāctli	10 (tal)
200	200
876	876
875	875
810	810
929	929
882	882
1127	1127
940	940
889	889
844	844
912	912
838	838
984	984
874	874
38	38
43	43
127	127
954	954
39	39
24	24
79	79
61	61
104	104
29	29
102	102
866	866
839	839
622	622
918	918
100	100
Lila Downs	Lila Downs
961	961
570	570
632	632
Andrew Garfield	Andrew Garfield
946	946
835	835
884	884
859	859
832	832
849	849
877	877
Ocēlōmiztli	Gepard
878	878
861	861
869	869
968	968
983	983
964	964
1121	1121
1123	1123
933	933
915	915
970	970
911	911
993	993
991	991
994	994
898	898
944	944
907	907
943	943
945	945
922	922
905	905
941	941
Ordino	Ordino
925	925
928	928
948	948
947	947
949	949
926	926
126	126
101	101
105	105
108	108
117	117
115	115
Teconalli	Kol (bränsle)
22	22
46	46
25	25
153	153
156	156
31	31
825	825
Vancouver	Vancouver
301	301
116	116
886	886
330	330
860	860
842	842
165	165
871	871
893	893
203	203
909	909
222	222
931	931
938	938
917	917
160	160
28	28
Liverpool	Liverpool
85	85
88	88
76	76
54	54
477	477
914	914
920	920
913	913
Albany	Albany, New York
935	935
841	841
Avatar	Avatar (film)
820	820
906	906
Āltepētl Bremen	Bremen
916	916
885	885
168	168
60	60
47	47
836	836
112	112
854	854
862	862
879	879
887	887
770	770
817	817
864	864
863	863
868	868
855	855
818	818
837	837
845	845
Roald Dahl	Roald Dahl
RMS Titanic	RMS Titanic
Rammstein	Rammstein
166	166
Ehēcalquixohuayān ītlālpancalactihuechiliz Cam Ranh	Cam Ranhs internationella flygplats
Benetice	Benetice (Světlá nad Sázavou)
Īlītl	Alsläktet
2016	2016
Ca Mau	Ca Mau
Mīmiztin	Kattdjur
552	552
2019	2019
Perexil	Persilja
2017	2017
2018	2018
Zōyacapolcuahuitl	Dadelpalm
-2	2 f.Kr.
-1	1 f.Kr.
Pichilemu	Pichilemu
Cōzamatl	Vessla
Teconxinachtli	Gömfröväxter
Chīcuahtli	Tornuggla
Micazayolli	Nyckelpigor
Antoni Gaudí	Antoni Gaudí
Ācuāuhtli	Fiskgjuse
2020	2020
Zōlcanauhtli	Gräsand
Theodor Mommsen	Theodor Mommsen
Āpozonalli	Bärnsten
Xīcohtli	Humlor
Stavanger	Stavanger
Icpitl	Lysmaskar
Cuicuitzcatl	Ladusvala
Coxolihtli	Fasan
Tlani teutontlahtōlli	Lågtyska
Cuauhchochopihtli	Hackspettar
600	600
400	400
300	300
Holger Apfel	Holger Apfel
Xinachtlanelhuayōtl	Fröväxter
Caxtillān canauhtli	Skedand
Hermann Hesse	Hermann Hesse
Tromsø	Tromsø
Klaus Ernst	Klaus Ernst
Universidad Niccolò Cusano	Università degli Studi Niccolò Cusano
Takeshi Kitano	Takeshi Kitano
1040 xiuhtin	1040-talet
Tēucyōtl Hidalgo (Texas)	Hidalgo County, Texas
Āltepētl Juárez	Juárez
BMW	BMW
Bergen	Bergen
Huēyimichtecuani	Späckhuggare
Huehxōlōtl	Kalkon
Camilo Cienfuegos	Camilo Cienfuegos
Alfa Romeo	Alfa Romeo
Aston Martin	Aston Martin
Bentley	Bentley
Alismatales	Svaltingordningen
Bugatti	Bugatti
Buick	Buick
Cadillac	Cadillac
Dodge	Dodge
Ferrari	Ferrari
AC/DC	AC/DC
Ainutlahtōlli	Ainu (språk)
Caxtillān zōlin	Vaktel
Tzinācantli	Fladdermöss
36	36
Tzontli	Hår
Ācatl	Bladvass
Hastings, Sussex Tlāpcopa	Hastings
Willis Tower	Willis Tower
Hyundai	Hyundai
Montgomery, Alabama	Montgomery, Alabama
Chevrolet	Chevrolet
Chrysler	Chrysler
815	815
816	816
822	822
840	840
823	823
811	811
771	771
888	888
768	768
851	851
205	205
159	159
107	107
162	162
103	103
802	802
Āhuitzotl	Utter
804	804
Huēyitlahtohcāyōtl in Tlanitlālpan	Kungariket Nederländerna
119	119
118	118
Extremaduratlahtōlli	Extremaduriska
801	801
807	807
806	806
152	152
240	240
Pipiyōlin	Honungsbi
218	218
655	655
496	496
Jaguar	Jaguar (bilmärke)
238	238
197	197
451	451
775	775
489	489
784	784
661	661
625	625
653	653
904	904
921	921
923	923
1126	1126
668	668
636	636
408	408
464	464
410	410
956	956
952	952
658	658
650	650
518	518
70	70
81	81
69	69
87	87
65	65
66	66
67	67
55	55
34	34
44	44
35	35
64	64
504	504
453	453
161	161
169	169
481	481
151	151
155	155
128	128
129	129
463	463
193	193
674	674
687	687
251	251
337	337
786	786
660	660
50	50
260	260
501	501
45	45
491	491
49	49
Ecser	Ecser
978	978
Silesiatlahtōlli	Schlesiska
221	221
543	543
536	536
230	230
762	762
610	610
787	787
480	480
209	209
202	202
192	192
Zhengzhou	Zhengzhou
681	681
819	819
173	173
867	867
865	865
827	827
824	824
847	847
883	883
829	829
Mōtohtli	Präriehundar
813	813
910	910
850	850
808	808
853	853
872	872
873	873
856	856
858	858
831	831
857	857
828	828
826	826
833	833
848	848
834	834
881	881
852	852
163	163
154	154
201	201
803	803
805	805
52	52
532	532
82	82
84	84
73	73
72	72
62	62
71	71
75	75
74	74
83	83
78	78
77	77
90	90
80	80
627	627
Е	Е
456	456
91	91
190	190
109	109
53	53
270	270
688	688
452	452
795	795
465	465
778	778
846	846
830	830
404	404
Tlahtohcātēīxiptla	President
908	908
896	896
897	897
927	927
63	63
555	555
571	571
86	86
401	401
890	890
533	533
264	264
Mijaíl Gorbachov	Michail Gorbatjov
99	99
415	415
483	483
469	469
462	462
459	459
466	466
402	402
761	761
780	780
675	675
689	689
774	774
759	759
758	758
350	350
782	782
760	760
785	785
783	783
767	767
766	766
211	211
232	232
204	204
188	188
98	98
894	894
891	891
602	602
628	628
892	892
601	601
672	672
682	682
821	821
Cartago, Costa Rica	Cartago, Costa Rica
648	648
686	686
Limón, Costa Rica	Puerto Limón
664	664
677	677
640	640
110	110
111	111
137	137
138	138
122	122
140	140
809	809
167	167
665	665
776	776
763	763
769	769
667	667
529	529
777	777
788	788
671	671
772	772
432	432
231	231
237	237
239	239
130	130
226	226
207	207
475	475
454	454
495	495
206	206
468	468
461	461
460	460
194	194
210	210
Caracalmiztli	Ökenlo
225	225
311	311
220	220
541	541
642	642
390 xihuitl	390-talet
313	313
180	180
794	794
587	587
530	530
609	609
497	497
540	540
428	428
548	548
422	422
549	549
457	457
478	478
253	253
467	467
458	458
350 xihuitl	350-talet
158	158
157	157
164	164
124	124
113	113
121	121
106	106
551	551
494	494
320	320
242	242
Ё	Ё
291	291
48	48
Toloatzin	Spikklubba
97	97
56	56
93	93
57	57
503	503
510	510
509	509
474	474
484	484
576	576
493	493
479	479
287	287
El Alto	El Alto
407	407
485	485
547	547
546	546
544	544
537	537
535	535
502	502
527	527
508	508
Mecatl	Tågvirke
525	525
613	613
618	618
617	617
608	608
645	645
621	621
606	606
623	623
604	604
603	603
626	626
619	619
634	634
630	630
614	614
505	505
446	446
791	791
557	557
656	656
657	657
659	659
651	651
676	676
670	670
652	652
673	673
654	654
647	647
812	812
669	669
792	792
649	649
Nāuhpōhualmahtlāctli omēyi	93 (tal)
895	895
756	756
663	663
779	779
662	662
684	684
773	773
757	757
435	435
790	790
437	437
433	433
764	764
426	426
781	781
425	425
429	429
423	423
765	765
235	235
Reinhard Bütikofer	Reinhard Bütikofer
233	233
223	223
224	224
216	216
219	219
254	254
272	272
208	208
175	175
170	170
171	171
172	172
58	58
59	59
139	139
114	114
134	134
135	135
179	179
142	142
96	96
181	181
146	146
145	145
183	183
182	182
184	184
324	324
589	589
521	521
92	92
597	597
329	329
Cracovia	Kraków
133	133
413	413
258	258
Tehuitztli	Näbb
259	259
196	196
236	236
789	789
332	332
631	631
487	487
638	638
473	473
176	176
143	143
643	643
523	523
215	215
148	148
247	247
424	424
641	641
492	492
639	639
256	256
441	441
Garou	Garou
131	131
191	191
450	450
612	612
635	635
611	611
534	534
488	488
607	607
524	524
282	282
472	472
471	471
Tonantzin Guadalupe	Vår Fru av Guadalupe
490	490
316	316
Ahtēpacholiztli	Anarki
797	797
511	511
295	295
598	598
303	303
250	250
515	515
512	512
418	418
333	333
294	294
217	217
277	277
578	578
312	312
Tlacempōhualiztli	Addition
284	284
283	283
241	241
243	243
262	262
498	498
336	336
334	334
266	266
Māīxnāmiquiliztli	Boxning
261	261
470	470
349	349
271	271
275	275
292	292
296	296
345	345
431	431
380 xihuitl	380-talet
304	304
550	550
586	586
588	588
554	554
229	229
583	583
265	265
263	263
585	585
582	582
556	556
420	420
280	280
581	581
558	558
302	302
309	309
353	353
335	335
367	367
344	344
245	245
290	290
449	449
308	308
255	255
439	439
319	319
318	318
299	299
419	419
416	416
338	338
310	310
315	315
359	359
360	360
273	273
286	286
288	288
278	278
455	455
577	577
575	575
482	482
486	486
580	580
567	567
564	564
561	561
328	328
325	325
317	317
574	574
566	566
249	249
348	348
442	442
443	443
267	267
244	244
248	248
343	343
562	562
417	417
268	268
Vendatlahtōlli	Venda (språk)
590	590
269	269
499	499
409	409
405	405
406	406
403	403
414	414
411	411
412	412
560	560
592	592
Cebra	Zebror
276	276
314	314
323	323
366	366
362	362
545	545
531	531
514	514
513	513
539	539
538	538
519	519
516	516
520	520
522	522
528	528
506	506
526	526
507	507
Valery Leontiev	Valerij Leontiev
214	214
213	213
212	212
228	228
227	227
149	149
174	174
189	189
199	199
141	141
132	132
125	125
123	123
147	147
144	144
198	198
178	178
177	177
187	187
195	195
186	186
347	347
620	620
624	624
605	605
629	629
Tlālocēlōtl	Ozelot
616	616
Las Cruces, Yancuīc Mēxihco	Las Cruces
615	615
644	644
646	646
633	633
637	637
436	436
434	434
Hererotlahtōlli	Herero (språk)
293	293
427	427
185	185
360 xihuitl	360-talet
321	321
327	327
430	430
447	447
569	569
568	568
444	444
796	796
798	798
Buon Ma Thuot	Buon Ma Thuot
793	793
685	685
Hartford	Hartford
799	799
683	683
274	274
579	579
281	281
306	306
438	438
297	297
421	421
298	298
Hawaitlahtōlli	Hawaiiska
351	351
352	352
355	355
Pandatlācamāyeh	Jättepanda
Ātlācamāyeh	Isbjörn
95	95
94	94
594	594
Lozitlahtōlli	Lozi
542	542
448	448
445	445
305	305
234	234
565	565
Otommanguetlahtōlli	Oto-mangueanska språk
381	381
385	385
553	553
307	307
584	584
346	346
257	257
Mayatlahtōlli	Mayaspråk
285	285
591	591
Lombardotlahtōlli	Lombardiska
289	289
Māitl	Hand
563	563
252	252
595	595
246	246
596	596
593	593
Mictlāmpa Sototlahtōlli	Nordsotho
357	357
573	573
Simón Pedro	Petrus
Tel Aviv	Tel Aviv
Tepēitzcuintli	Paka
Izhuatl	Blad
Valparaíso	Valparaíso
Xonatlahtōlli	Shona
Hollywood	Hollywood
Marlon Brando	Marlon Brando
Suatitlahtōlli	SiSwati
559	559
599	599
326	326
341	341
322	322
Yutanāhuatlahtōlli	Uto-aztekiska språk
Nathalia Dill	Nathalia Dill
Huāxyacac	Oaxaca
386	386
Tzhuanatlahtōlli	Setswana
374	374
380	380
Oxford, Oxfordshire	Oxford
136	136
Port-au-Prince	Port-au-Prince
Hutlahtōlli	Wu (dialekt)
370 xihuitl	370-talet
Tsongatlahtōlli	Tsonga
Sototlahtōlli	Sesotho
Rotterdam	Rotterdam
Tlatzotzonalli	Musikinstrument
Quetzalcanauhtli	Svanar
Āmōlli	Tvål
Yancuīc Orleans	New Orleans
Scarlett Johansson	Scarlett Johansson
Gwyneth Paltrow	Gwyneth Paltrow
Yahualtōntli	CD
Tepozmōyōtl	Helikopter
382	382
342	342
373	373
372	372
1980s	1980-talet
J. K. Rowling	J.K. Rowling
Xālli	Sand
Caxtillān tlapalpopozōn	Rossläktet
Xācocēlōtl	Leopard
Salzburg	Salzburg
Albuquerque	Albuquerque
Yancuīc xihuitl	Nyår
Santo Domingo	Santo Domingo
Tequixquiāc	Tequixquiac
Huēyāltepētl	Provins
Ochonetli	Papaya
375	375
Isaac Asimov	Isaac Asimov
Trinidad, Bolivia	Trinidad, Bolivia
Cobija	Cobija
Tarixa	Tarija
1970s	1970-talet
2000 xiuhtin	2000-talet (decennium)
Copacabana	Copacabana (olika betydelser)
Iglesia Ortodoxa	Ortodoxa kyrkor
Potosí	Potosí
Agatha Christie	Agatha Christie
Āltepētl Cuhuait	Kuwait (stad)
Tezcatl	Spegel
Oruro	Oruro
Miztli	Puma
-44	44 f.Kr.
Tēmelāhuanimeh Jehová	Jehovas vittnen
387	387
Brad Pitt	Brad Pitt
Kia	Kia
Huitzollahtōlli	Huichol
Arthur Conan Doyle	Arthur Conan Doyle
Ndebeletlahtōlli mictlāmpa	Nordndebele
Ocēlōtl	Jaguar
1930s	1930-talet
1960s	1960-talet
1920s	1920-talet
Osaka	Osaka
Guaranitlahtōlli	Guaraní
Lamborghini	Lamborghini
Huāxcuahuitl	Leucaena leucocephala
Emmy Rossum	Emmy Rossum
Lotus	Lotus (bilmärke)
Maserati	Maserati
Mazda	Mazda
Mercedes-Benz	Mercedes-Benz
Mitsubishi Motors	Mitsubishi Motors
Huexōtl	Videsläktet
Charles Bronson	Charles Bronson
Tlālpantli	Jord
Hicoxcuahuitl	Fikon
Bridgetown	Bridgetown
Āmatlahcuilo	Skribent
Siligo	Siligo
Xapon tlālolīniliztli īhuān huēyāolīniliztli īpan 2011	Jordbävningen vid Tohoku 2011
Puerto Montt	Puerto Montt
Tlapatiliztōcāitl	Pronomen
Tzilīnitl	Vokal
Saint John	Saint John's, Antigua och Barbuda
Roseau	Roseau
1950s	1950-talet
Salta	Salta
Caxtillān quimichin	Råttor
Porto	Porto
Yōltextli	Mjöl
The Lion King	Lejonkungen
1940s	1940-talet
1910s	1910-talet
Mamut	Mammutar
Mācēhualtlācatl	Indianer
Ndebeletlahtōlli huitztlāmpa	Sydndebele
Calīxtli	Dörr
Michhuahcatlahtōlli	Purepecha
Raramuritlahtōlli	Tarahumara (språk)
Tzeltallahtōlli	Tzeltal
Tzotzillahtōlli	Tzotzil
Tlahtohcāpilli William of Wales	Prins William, hertig av Cambridge
Toquelau	Tokelauöarna
Cuīcapixqui	Kompositör
Ātōnahuiztli Influenza A H1N1	Svininfluensa
Salvador de Bahia	Salvador, Brasilien
Mahtlāctli omōme	12 (tal)
Toshirō Mifune	Toshiro Mifune
Thomas Mann	Thomas Mann
Tallahassee	Tallahassee
José Saramago	José Saramago
Pop	Popmusik
Alajuela	Alajuela
331	331
Mahtlāctli oncē	11 (tal)
365	365
Mahtlāctli omēyi	13 (tal)
Koenigsegg	Koenigsegg
Āhuacacuahuitl	Avokado
379	379
.fi	.fi
Luiz Inácio Lula da Silva	Luiz Inácio Lula da Silva
Āmatlalcāyōtl	Skrivkonst
Lublin	Lublin
John Michael Talbot	John Michael Talbot
Tlālcacahuatl	Jordnöt
Mācuīlpōhualli	100 (tal)
Ixtezcatl	Glasögon
Texihuitl	Hagel
Luciano Pavarotti	Luciano Pavarotti
Mila Kunis	Mila Kunis
-43	43 f.Kr.
Campora San Giovanni	Campora San Giovanni
Bloemfontein	Bloemfontein
.uk	.uk
Camohtli	Sötpotatis
Gregor Mendel	Gregor Mendel
Herta Müller	Herta Müller
Daniel Radcliffe	Daniel Radcliffe
Samurai	Samuraj
-31	31 f.Kr.
Enya	Enya
Alexandre Dumas, père	Alexandre Dumas den äldre
Xena: Warrior Princess	Xena – Krigarprinsessan
Santa Fe Ānalco	Santa Fe, New Mexico
Mahtlāctli onnāhui	14 (tal)
Caxtōlli	15 (tal)
Caxtōlomēyi	18 (tal)
Universidad del Bío-Bío	Universidad del Bío-Bío
Suva	Suva
Xōlōitzcuintli	Mexikansk nakenhund
Tōnēhuiliztli	Feber
-4	4 f.Kr.
Teide	Teide
1890s	1890-talet
-8	8 f.Kr.
Ācalquīxōhuayān Caxtillān	Port of Spain
Quimichin	Möss
Xopaltic	Orange
Anquichichi	Vinthund
Sochi	Sotji
Emma Watson	Emma Watson
1800 xiuhtin	1800-talet (decennium)
Nicolas Appert	Nicolas Appert
Eyjafjallajökull	Eyjafjallajökull
Penélope Cruz	Penélope Cruz
-14	14 f.Kr.
-27	27 f.Kr.
-19	19 f.Kr.
Mario Vargas Llosa	Mario Vargas Llosa
-3	3 f.Kr.
Radio Studio 54 Network	Radio Studio 54 Network
Caxtōlonnāhui	19 (tal)
Āhuacātzin	Svalor
Xōchipaxcua	Pingst
Mezquentli	Byxor
Mahtlācxihuitl	Decennium
Huēyāltepētl Concepción	Provincia de Concepción, Chile
Rio Grande do Sul	Rio Grande do Sul
Amazonas (Brasil)	Amazonas (delstat i Brasilien)
-6	6 f.Kr.
-34	34 f.Kr.
Ilhuicaatentli	Strand
Caxtōlomōme	17 (tal)
Amapá	Amapá
Mazātlān	Mazatlán
Manaus	Manaus
Caxtōloncē	16 (tal)
Porto Alegre	Porto Alegre
Cempōhualli	20 (tal)
Tlācatlahtohcāyōtl Sahara	Sahariska arabiska demokratiska republiken
.eg	.eg
-5	5 f.Kr.
-23	23 f.Kr.
Bahia	Bahia
.se	.se
Jim Carrey	Jim Carrey
Julia Roberts	Julia Roberts
30 Seconds to Mars	30 Seconds to Mars
Tacloban	Tacloban City
Ray Bradbury	Ray Bradbury
Cristina Fernández	Cristina Fernández de Kirchner
Dilma Rousseff	Dilma Rousseff
Acre	Acre (delstat)
Tecuicihtli	Krabbor
Texotlaticiliztli	Kirurgi
-29	29 f.Kr.
Āltepētl Carson	Carson City
Alagoas	Alagoas
Anna Maria Jopek	Anna Maria Jopek
Frank Sinatra	Frank Sinatra
-7	7 f.Kr.
-9	9 f.Kr.
Eva Perón	Eva Perón
-32	32 f.Kr.
Opel	Opel
Porsche	Porsche
Arthur Penn	Arthur Penn
-48	48 f.Kr.
Táchira	Táchira
-26	26 f.Kr.
Apure	Apure (delstat)
Santiago ohtli	Jakobsleden
-11	11 f.Kr.
Jonathan Swift	Jonathan Swift
Calli	Byggnad
Sony	Sony
Tomīn	Mynt
-16	16 f.Kr.
-35	35 f.Kr.
-13	13 f.Kr.
Īxīptlayōlmatiliztli	Biograf
Franz Liszt	Franz Liszt
-17	17 f.Kr.
-24	24 f.Kr.
José Luis Rodríguez Zapatero	José Luis Rodríguez Zapatero
Federico García Lorca	Federico García Lorca
Mark Ruffalo	Mark Ruffalo
Kingstown	Kingstown
Tlanelhuatl	Rot
Saint George	Saint George's
Julia Gillard	Julia Gillard
Haifa	Haifa
Emiliano Zapata	Emiliano Zapata
Joseph Goebbels	Joseph Goebbels
Klagenfurt	Klagenfurt
Beersheba	Be'er Sheva
-50	50 f.Kr.
Talcahuano	Talcahuano
1347 Tlīltic Miquiztli	Digerdöden
In ītlahpalōlōcatzin María	Ave Maria
Mirante do Vale	Mirante do Vale
Ōmpōhualli	40 (tal)
Ichcatohmitl	Ull
Huehcāuh Inglatlahtōlli	Fornengelska
Cacahuacuahuitl	Kakao
Evo Morales	Evo Morales
Īpān Polonia	Polens flagga
Sheffield	Sheffield
Nextic	Grå
Īpān Tlacetilīlli Tlahtohcāyōtl	USA:s flagga
Yama	Lama
Keira Knightley	Keira Knightley
Teōpixqui	Präst
Piauí	Piauí
Santiago de los Caballeros	Santiago de los Caballeros
Johnny Cash	Johnny Cash
Audrey Hepburn	Audrey Hepburn
Tlācamichin	Manater
Belo Horizonte	Belo Horizonte
Cēmpōhualmahtlāctli	30 (tal)
Īpān Italia	Italiens flagga
Calmanani	Arkitekt
1600 xiuhtin	1600-talet (decennium)
Franz Ferdinand	Franz Ferdinand
Heinrich Himmler	Heinrich Himmler
Donetsk	Donetsk
Caxtillān chīlli	Pepparplanta
Huiquipedia:Yequihcuilōtl	Ortografi
Īpān Xapon	Japans flagga
Īpān Francia	Frankrikes flagga
Zacatl	Gräs
Manoel de Oliveira	Manoel de Oliveira
Zulia	Zulia
Barinas	Barinas (delstat)
Membrillocuahuitl	Kvitten
Fresno	Fresno
Folk	Folkmusik
Harry Potter and the Philosopher's Stone	Harry Potter och de vises sten
1700 xiuhtin	1700-talet (decennium)
Ocomiztli	Lodjur
Petlazolcoatl	Enkelfotingar
Fortaleza	Fortaleza
Cuāuhtohtli	Falco (släkte)
Guayaquil	Guayaquil
Quetzalitztli	Smaragd
Gerhart Hauptmann	Gerhart Hauptmann
Tehuilotl	Kristall
Huitzilli	Kolibrier
Xīctli	Navel
Eddie Murphy	Eddie Murphy
Azahuad	Azawad
Matt Groening	Matt Groening
Das Lied der Deutschen	Deutschlandlied
La Plata	La Plata
Reese Witherspoon	Reese Witherspoon
Ciruelacuahuitl	Plommon
1500 xiuhtin	1500-talet (decennium)
San Fernando del Valle de Catamarca	San Fernando del Valle de Catamarca
Tepozyōllōtl	Motor
Radiohead	Radiohead
Resistencia, Argentina	Resistencia, Chaco
Rawson	Rawson
Córdoba, Argentina	Córdoba, Argentina
Corrientes	Corrientes
Paraná, Argentina	Paraná (stad)
Formosa, Argentina	Formosa (stad)
San Salvador de Jujuy	San Salvador de Jujuy
La Rioja, Argentina	La Rioja, Argentina
Mendoza	Mendoza
Posadas	Posadas
Neuquén	Neuquén
San Juan, Argentina	San Juan, Argentina
Río Gallegos	Río Gallegos
San Luis, Argentina	San Luis, Argentina
Santa Fe, Argentina	Santa Fe (stad)
Santiago del Estero	Santiago del Estero
Ushuaia	Ushuaia
San Miguel de Tucumán	Tucumán
Jörg Haider	Jörg Haider
Ford Motor Company	Ford Motor Company
Coyōtl	Prärievarg
Jim Morrison	Jim Morrison
Ronald Golias	Ronald Golias
Quechquentli	Slips
Dan Castallaneta	Dan Castellaneta
Anne Brontë	Anne Brontë
GNU	GNU
1820s	1820-talet
Amazonas (Colombia)	Amazonas (departement)
Heinz-Christian Strache	Heinz-Christian Strache
Francisco Pizarro	Francisco Pizarro
Huēyāltepētl Buenos Aires	Buenos Aires (provins)
Catamarca	Catamarca (provins)
Tzacuapanyan	Hamn
Tucuman	Tucumán (provins)
Chubut	Chubut
Lino	Lin (växt)
Coldplay	Coldplay
The Hound of the Baskervilles	Baskervilles hund
Coimbra	Coimbra
Tlācanēxquimilli	Spöke
Migueltzin Huēyahtlapāleh	Mikael (ärkeängel)
Tlazōlli	Avfall
John Cale	John Cale
Mayātēcah	Mayaindianer
Clive Dunn	Clive Dunn
Cihtli	Harar (släkte)
Tlāhuīlnāuhmecatl	Elbas
Sonora	Sonora (delstat)
Guanajuato	Guanajuato (delstat)
Osiris	Osiris
Tlani California Huitztlāmpa	Baja California Sur
Īpān Tlanitlālpan	Nederländernas flagga
Charles Babbage	Charles Babbage
Tlācatzinācantli	Vampyr
Octavio Paz	Octavio Paz
Harry Potter and the Goblet of Fire	Harry Potter och den flammande bägaren
Īpān Austria	Österrikes flagga
Harry Potter and the Half-Blood Prince	Harry Potter och Halvblodsprinsen
TVR	TVR
Televisa	Televisa
Harry Potter and the Chamber of Secrets	Harry Potter och Hemligheternas kammare
Elfriede Jelinek	Elfriede Jelinek
Ocuilin	Maskar
Kepler-22b	Kepler-22b
Cetepētl	Isberg
Harry Potter and the Prisoner of Azkaban	Harry Potter och fången från Azkaban
Rudolf Eucken	Rudolf Eucken
Jubrān Khalīl Jubrān	Khalil Gibran
Caxtillān epazōtl	Myntasläktet
Āyōtōchtli	Bältdjur
Robbie Williams	Robbie Williams
339	339
340	340
354	354
356	356
358	358
361	361
363	363
364	364
368	368
369	369
370	370
371	371
Nemachiyōtīlli:Commonscat	Mall:Commonscat
376	376
377	377
378	378
383	383
384	384
388	388
389	389
390	390
391	391
392	392
393	393
394	394
395	395
396	396
397	397
398	398
399	399
Īpān Alemania	Tysklands flagga
Cēmpōhualomēyi	23 (tal)
Medellín, Colombia	Medellín
Kōbe	Kobe
Cesarea de Capadocia	Kayseri
Recife	Recife
Ohohuihcan	Labyrint
279	279
Bridgeport	Bridgeport, Connecticut
440	440
517	517
572	572
Scottsdale, Arizona	Scottsdale, Arizona
Reno	Reno
Aurora, Colorado	Aurora, Colorado
Anaheim	Anaheim
Colorado Springs	Colorado Springs
Mesa, Arizona	Mesa
Henderson, Nevada	Henderson, Nevada
Peer Steinbrück	Peer Steinbrück
2026	2026
Ontetocaitl	Smeknamn
2025	2025
2024	2024
2023	2023
2022	2022
2021	2021
Schaan	Schaan
Hoobastank	Hoobastank
2041	2041
2042	2042
2043	2043
2044	2044
2045	2045
2046	2046
2047	2047
2048	2048
2049	2049
Hordaland	Hordaland fylke
Sogn og Fjordane	Sogn og Fjordane fylke
Tepētzallāntli Mēxihco	Anahuac
Santiago de Cali	Cali, Colombia
David Wark Griffith	D.W. Griffith
William Wyler	William Wyler
Luis Buñuel	Luis Buñuel
Billy Wilder	Billy Wilder
Roman Polanski	Roman Polański
Punta Arenas	Punta Arenas
Tempe, Arizona	Tempe
Nemachiyōtīlli:Taxobox	Mall:Taxobox
Rosario, Argentina	Rosario
Mar del Plata	Mar del Plata
Jean-Luc Godard	Jean-Luc Godard
Saltillo	Saltillo
Cōāhuillān Zaragoza	Coahuila
Mexicana de Aviación	Mexicana de Aviación
Acura	Acura
Ōmmalacapayīnaliztli	Cykelsport
Toyota	Toyota
Werner Faymann	Werner Faymann
Calatl	Lövgrodor
Itztli	Obsidian
Paola, Italia	Paola, Italien
Cuenca, Ecuador	Cuenca
Tamazolin	Äkta paddor
Robert Bresson	Robert Bresson
Hayao Miyazaki	Hayao Miyazaki
Nagisa Ōshima	Nagisa Oshima
Ж	Ж
Miguel Hidalgo	Miguel Hidalgo
Colonia del Sacramento	Colonia del Sacramento
Punta del Este	Punta del Este
Vilamoviatlahtōlli	Wymysöriska
Nelly Sachs	Nelly Sachs
Ollanta Humala	Ollanta Humala
Felipe Calderón	Felipe Calderón
Mauricio Funes	Mauricio Funes
Thomas de Maizière	Thomas de Maizière
Norbert Lammert	Norbert Lammert
Otto Ernst Remer	Otto Ernst Remer
Franz Josef Jung	Franz Josef Jung
Jóhanna Sigurðardóttir	Jóhanna Sigurðardóttir
Philipp Rösler	Philipp Rösler
Guido Westerwelle	Guido Westerwelle
Duran Duran	Duran Duran
Tēucyōtl Greenlee	Greenlee County
Tēucyōtl Coconino	Coconino County
Tēucyōtl Gila	Gila County
Tēucyōtl Pima	Pima County
Tēucyōtl Santa Cruz (Arizona)	Santa Cruz County
Tēucyōtl Maricopa	Maricopa County
Tēucyōtl Graham (Arizona)	Graham County, Arizona
Tēucyōtl Navajo	Navajo County
Tēucyōtl Mohave	Mohave County
Tēucyōtl Yuma (Arizona)	Yuma County
Tēucyōtl Yavapai	Yavapai County
Tēucyōtl Pinal	Pinal County
Tlani California	Baja California (delstat)
Tēucyōtl La Paz	La Paz County
Tēucyōtl Apache	Apache County
Tēucyōtl Cochise	Cochise County
Cuitlatexohtli	Akvamarin
Chiyapan	Chiapas
Veracruz de Ignacio de la Llave	Veracruz (delstat)
1150 xihuitl	1150-talet
Īpān Dinamarca	Dannebrogen
Guerrero	Guerrero
Yucatān	Yucatán (delstat)
Cītlalmītl	Meteorit
1030 xiuhtin	1030-talet
1050 xiuhtin	1050-talet
Constantinopla Tēpachoteōpīxqui	Konstantinopels ekumeniska patriarkat
Ursula von der Leyen	Ursula von der Leyen
Kristina Schröder	Kristina Schröder
Winfried Kretschmann	Winfried Kretschmann
San Francisco Campeche	Campeche
Chihuahhua, Chihuahhua	Chihuahua (stad)
Pachtitlan (āltepēcalpōlli)	Guanajuato
Cōlimān	Colima (delstat)
Cōlimān, Cōlimān	Colima
Nehnemiliztli	Resa
Erika Mann	Erika Mann
Ronald Pofalla	Ronald Pofalla
Caxtillān quetzaltōtōtl	Påfågel
Norbert Röttgen	Norbert Röttgen
Sabine Leutheusser-Schnarrenberger	Sabine Leutheusser-Schnarrenberger
Björn Engholm	Björn Engholm (politiker)
Johannes Heesters	Johannes Heesters
Huehcāuh Tlācatiyān	Lista över historiska länder och riken
Daniel Bahr	Daniel Bahr
Barranquilla	Barranquilla
Dirk Niebel	Dirk Niebel
Peter Ramsauer	Peter Ramsauer
Alfred Hugenberg	Alfred Hugenberg
Harald Ringstorff	Harald Ringstorff
Peter Altmaier	Peter Altmaier
Morelos	Morelos
Manfred Stolpe	Manfred Stolpe
Hans-Peter Friedrich	Hans-Peter Friedrich
Mēxihco ītlācaxoxouhcāyō	Mexikanska frihetskriget
Willy Hellpach	Willy Hellpach
Hermann Gröhe	Hermann Gröhe
Garfield	Gustaf (tecknad serie)
Oskar Hergt	Oskar Hergt
Cueyatl	Rana (släkte)
Futurama	Futurama
Trinidad, Colorado	Trinidad, Colorado
Karl Dönitz	Karl Dönitz
Heinrich Mann	Heinrich Mann
Johann Pachelbel	Johann Pachelbel
Paul Heyse	Paul Heyse
Horst Mahler	Horst Mahler
Gregor Strasser	Gregor Strasser
Margot Honecker	Margot Honecker
Karl-Theodor zu Guttenberg	Karl-Theodor zu Guttenberg
Ernst Thälmann	Ernst Thälmann
Paul van Dyk	Paul van Dyk
Klaus Mann	Klaus Mann
Golo Mann	Golo Mann
Wilhelm Marx	Wilhelm Marx
Erwin Pröll	Erwin Pröll
Centzīntiliztica	Enhjärtbladiga växter
San Luis Potosí	San Luis Potosí (delstat)
Tlapaltehuilōtl	Ametist
Querétaro	Querétaro Arteaga
Nogales, Arizona	Nogales, Arizona
930 xihuitl	930-talet
Cuātōchtli	Marsvin
Yuma	Yuma
Flagstaff	Flagstaff
Michhuahcān	Michoacán de Ocampo
Īpān Afganistan	Afghanistans flagga
Isis	Isis
Durango	Durango (delstat)
Nayarit	Nayarit
1130 xihuitl	1130-talet
Puebla	Puebla (delstat)
Aguascalientes	Aguascalientes (delstat)
Cēmpōhualmācuīlli	25 (tal)
Cēmpōhualonnāhui	24 (tal)
Tamaulipas	Tamaulipas
Apipiyalotl	Egentliga trollsländor
Eloy, Arizona	Eloy, Arizona
Caxtillān mexcalmetl	Äkta aloe
Īpān Canada	Kanadas flagga
Emily Brontë	Emily Brontë
Watlasecawiloni	Hatt
Techalōmiztli	Marmorkatt
Tecontli	Flaska
Quintana Roo	Quintana Roo
Sinaloa	Sinaloa
Zacatēcapan	Zacatecas (delstat)
Julianne Moore	Julianne Moore
960 xihuitl	960-talet
990 xihuitl	990-talet
890 xihuitl	890-talet
1190 xihuitl	1190-talet
1180 xihuitl	1180-talet
Hidalgo	Hidalgo (delstat)
Campeche	Campeche (delstat)
Tabasco	Tabasco (delstat)
John Travolta	John Travolta
Fez	Fès
Monterrey	Monterrey
Quiyahuātl	Storm
950 xihuitl	950-talet
1020 xihuitl	1020-talet
1060 xiuhtin	1060-talet
Īpān Suecia	Sveriges flagga
Harrison Ford	Harrison Ford
1010 xihuitl	1010-talet
Ācapōlco	Acapulco
Īpān Lituania	Litauens flagga
Xocoztli	Citrussläktet
Īpān Andorra	Andorras flagga
Alpaca	Alpacka
Melōn	Melon
Calāntōcāitl	Exonym
970 xihuitl	970-talet
Īpān Australia	Australiens flagga
Santos	Santos, São Paulo
Īpān Turquia	Turkiets flagga
Tlahtohcāyōtl Mēxihco	Mexiko (delstat)
Temuco	Temuco
Īpān Brasil	Brasiliens flagga
Hande Yener	Hande Yener
Īpān Azerbaiyan	Azerbajdzjans flagga
920 xihuitl	920-talet
1170 xihuitl	1170-talet
980 xihuitl	980-talet
1080 xiuhtin	1080-talet
К	К
П	П
И	И
Tlaxcallān	Tlaxcala (delstat)
Cuācuauhxōlōtl	Bisonoxe
1090 xiuhtin	1090-talet
Kanji	Kanji
São Paulo Museum of Art	Museu de Arte de São Paulo
Cemitqui	Politiker
1110 xihuitl	1110-talet
1160 xihuitl	1160-talet
940 xihuitl	940-talet
Tecpatl	Flinta
Cuauhcamohtli	Maniok
Goiânia	Goiânia
Quillechuca	Sallat
Galilea	Galileen
Epatl	Skunkar
Īpān Tlacetilīlli Huēyitlahtohcāyōtl	Storbritanniens unionsflagga
870 xihuitl	870-talet
160 xihuitl	160-talet
Béla Bartók	Béla Bartók
880 xihuitl	880-talet
860 xihuitl	860-talet
1070 xiuhtin	1070-talet
Tlālolīnilizmatiliztli	Seismologi
1140 xihuitl	1140-talet
Anthony Quinn	Anthony Quinn
Maximiliano I (Mēxihco)	Maximilian I av Mexiko
Adolf von Thadden	Adolf von Thadden
Polandball	Polandball
Back To The Future	Tillbaka till framtiden
Tōtoltetl	Ägg (livsmedel)
Ātōyātl Biobío	Río Biobío
Palachtli	Arguskalkon
Āpantzincān	Apatzingán de la Constitución
Ourense	Ourense
Huēhcāuhahtlapalli	Archaeopteryx
Huēyicocoliztli influenza A H1N1 xiuhpan 2009	H1N1-utbrottet 2009
Tebas	Thebe (Egypten)
Harry Potter and the Order of the Phoenix	Harry Potter och Fenixorden (film)
Īpān Honduras	Honduras flagga
The Velvet Underground	The Velvet Underground
Tlacuīltīllahtōlli	Lånord
Peter O'Toole	Peter O'Toole
Zabrze	Zabrze
Judea	Judeen
Sidney Poitier	Sidney Poitier
Callao	Callao
Ātenāmitl	Vall (anläggning)
Legnica	Legnica
Alan Rickman	Alan Rickman
Jamie Lee Curtis	Jamie Lee Curtis
Tēucyōtl Alameda	Alameda County
Tlahtohcayotl	Delstat
Tēucyōtl Contra Costa	Contra Costa County
Tēucyōtl Alpine	Alpine County
Tēucyōtl El Dorado	El Dorado County
Tēucyōtl San Diego	San Diego County
Āltepētl Belice	Belize City
Malacactli	Skridskor
Tēucyōtl Zapata	Zapata County
Christopher Lloyd	Christopher Lloyd
Diego Ribas	Diego Ribas da Cunha
Georg von Schönerer	Georg von Schönerer
Barbara Rosenkranz	Barbara Rosenkranz
Joey King	Joey King
Victoria de Durango	Victoria de Durango
Tēucyōtl Doña Ana	Doña Ana County
Mētzcuitlatl	Glimmer
Abelardo Rodríguez	Abelardo L. Rodríguez
MINI	Mini (2001–)
Lemony Snicket's A Series of Unfortunate Events	Lemony Snickets berättelse om syskonen Baudelaires olycksaliga liv
Santiago de Cuba	Santiago de Cuba
Ferrari 360	Ferrari 360
Malcolm McDowell	Malcolm McDowell
Leuven	Leuven
Huezacotl	Känguruspringmöss
Boyacá	Boyacá
Īpān Caxtillān	Spaniens flagga
Philip Fry	Philip J. Fry
Turanga Leela	Leela
Alemania ītlahtōllō	Tysklands historia
Tequillān mexcalli	Tequila
Īpān Mēxihco	Mexikos flagga
Cuetlāchtlācamāyeh	Svartbjörn
Antioquia	Antioquia
Īpān Suiza	Schweiz flagga
Dolores del Río	Dolores Del Rio
Īpān Angola	Angolas flagga
Tijuana	Tijuana
Cuetlaxcōāpan	Puebla
Tlācaxōlōtl	Tapirer
Huēhuētlololli	Trumset
Cōāmichin	Ålartade fiskar
Īpān Portugal	Portugals flagga
Paul Verhoeven	Paul Verhoeven
Ϙ	Koppa
Caxtillān ocomiztli	Panterlo
Russell Crowe	Russell Crowe
Pōctli	Rök
Īpān Argentina	Argentinas flagga
Chiquilichtli	Cikador
James Blunt	James Blunt
Īpān Rumania	Rumäniens flagga
Ceratosaurus	Ceratosaurus
Acocohxōchitl	Dahliasläktet
Cepayauhmelahuaztli	Skidsport
Tlālyacatl Yucatān	Yucatánhalvön
Cītlalin tlamīna	Meteor
Īpān China	Kinas flagga
Caxtillān pitzāhuac etl	Lins (växt)
Tzontecomananacatl	Röd flugsvamp
Immagine & poesia	Immagine & Poesia
Alexander Rybak	Alexander Rybak
Soul	Soulmusik
Caxtillān ayecohtli	Bondböna
Ͳ	Sampi
Huāxyacac Juárez	Oaxaca de Juárez
Brighton, Sussex Tlāpcopa	Brighton
Merano	Merano
Joan Baez	Joan Baez
Ōlli	Gummi
Ocotōchtli	Rödlo
Parachutes	Parachutes
Xbox	Xbox
Tlapoatl	Nyckel
Misa	Mässa
Īchīmal Alemania	Tysklands statsvapen
Bee Gees	Bee Gees
Āltepētlahtohcāyōtl	Stadsstat
Petlāuhxinachtli	Nakenfröiga växter
Agustín de Iturbide	Agustín de Iturbide
Namur	Namur
Oscar Niemeyer	Oscar Niemeyer
Tzīncuauhyōtl	Stjälk
Cēmani (cuīcayōtl)	Singel
Quecehuatl	Bälte (kläddetalj)
Īpān Bolivia	Bolivias flagga
Cuauhnacaztli	Enterolobium cyclocarpum
Ōlmēcah	Olmeker
LG	LG-gruppen
Māpachtlācamāyeh	Glasögonbjörn
Pōchōtl	Kapok
Zacatēcapan, Zacatēcapan	Zacatecas
Motēcuhzōma Xōcoyōtzin	Moctezuma II
Āmapatōlli	Kortspel
Grants Pass, Oregon	Grants Pass
Kanash	Kanasj
Zakopane	Zakopane
Malayotlācamāyeh	Malajbjörn
Tlālyacatl Italia	Apenninska halvön
Tōlli	Kaveldunssläktet
Zamora, Michhuahcān	Zamora de Hidalgo
Zamora	Zamora
Peracuahuitl	Päron
Tzapopan	Zapopan
Tzopelātl	Läskedryck
Āchiyōtl	Bixa orellana
Pēzohtli	Näsbjörnar
Māpachtli	Tvättbjörnar
З	З
Cidracuahuitl	Suckatcitron
Quināmehtlatzcan	Amerikansk sekvoja
Porfirio Díaz	Porfirio Díaz
Ishirō Honda	Ishiro Honda
Westlife	Westlife
Tomo Miličević	Tomo Miličević
2008 Sichuan tlālolīniliztli	Jordbävningen i Sichuan 2008
Police Academy: The Animated Series	Police Academy (TV-serie)
Norberto Rivera Carrera	Norberto Rivera Carrera
Sabrina (1954)	Sabrina (film, 1954)
Volkswagen Käfer	Volkswagen Typ 1
Ilse Aigner	Ilse Aigner
Nana Mouskouri	Nana Mouskouri
Carlos Fuentes	Carlos Fuentes
Arturo Pérez-Reverte	Arturo Pérez-Reverte
Metl	Agavesläktet
Tēucyōtl Amador	Amador County
Tēucyōtl Butte (California)	Butte County, Kalifornien
Tēucyōtl Del Norte	Del Norte County
Tēucyōtl Bernalillo	Bernalillo County
Huauhtli	Amarantsläktet
Volkswagen AG	Volkswagen AG
Manzanacuahuitl	Malus pumila
Ehēcalquixohuayān Stuttgart	Stuttgarts flygplats
Volkswagen Phaeton	Volkswagen Phaeton
X&Y	X&Y
Viva la Vida or Death and All His Friends	Viva la Vida or Death and All His Friends
Tzapotl	Sapotaceae
Capolin	Aroniasläktet
Caxtillān xōchitl	Trädgårdsnejlika
Cuauhtzapotl	Kirimoja
Ēlōcapolcuahuitl	Glanshägg
Nohpalli	Opuntiasläktet
Nequēnnetl	Sisal
Santa Cruz, California	Santa Cruz, Kalifornien
Santa Clara, California	Santa Clara, Kalifornien
Arequipa	Arequipa
Santa Bárbara, California	Santa Barbara
Ayecohtli	Rosenböna
Caxtillān omixōchitl	Madonnalilja
Travis	Travis
Huixachin	Sensitivasläktet
Omixōchitl	Tuberos
Telconalli	Kulspetspenna
Īpān Africa Huitztlāmpa	Sydafrikas flagga
Īpān Peru	Perus flagga
Īpān Colombia	Colombias flagga
Valdivia	Valdivia
Pachyohcān Soto	Pachuca de Soto
Īpān Chile	Chiles flagga
Caxtiltēcah	Spanjorer
Teōmetl	Agave
David Cītlalli	Davidsstjärna
T.A.T.u.	T.A.T.u.
Mango	Mangosläktet
André Breton	André Breton
Tlīlxōchitl	Vaniljsläktet
Comondú	Comondú
Cartagena, Caxtillān	Cartagena, Spanien
Īpān Irac	Iraks flagga
Tlaōlcapolcuahuitl	Virginiahägg
Tlatlīltzicuīniliztli	Diakritiskt tecken
Īpān Cuba	Kubas flagga
Marguerite Yourcenar	Marguerite Yourcenar
Hugh Grant	Hugh Grant
Palpetlatl	Matta
Īpān Birmania	Burmas flagga
Volvo	Volvo
Cuīcatlāhuīlcaxitl	Synthesizer
Alexandr Borodin	Aleksandr Borodin
Funk	Funk
Sergio Leone	Sergio Leone
Momochitl	Popcorn
Javier Hernández Balcázar	Javier Hernández
Mérida, Yucatān	Mérida (Mexiko)
Lope de Vega	Lope de Vega
Teresina	Teresina
Īpān Ecuador	Ecuadors flagga
Mérida (tlahtohcāyōtl)	Mérida (delstat)
Zāyōlin	Husfluga
Xālxocotl	Guava
Ixtehuilli	Förstoringsglas
Alan García	Alan García Pérez
Manzanaoctli	Cider
Alizée Jacotey	Alizée
Amélie Nothomb	Amélie Nothomb
Mayanalo	Hungersnöd
Huēyimichin	Bardvalar
Vitória	Vitória
Santiago Calatrava	Santiago Calatrava
Īpān Cosovo	Kosovos flagga
Panhuehuetl	Tambora
Maceió	Maceió
Īpān Panama	Panamas flagga
Īpān Belice	Belizes flagga
Tēucyōtl Imperial	Imperial County
Amapechtli	Kuvert
110 xihuitl	110-talet
Carlos Slim Helú	Carlos Slim Helú
Īpān Paraguay	Paraguays flagga
Cuānacacōzcacuāuhtli	Kondor
Arctic Monkeys	Arctic Monkeys
Īchīmal Caxtillān	Spaniens riksvapen
Advance Australia Fair	Advance Australia Fair
Yancuīc Caxtillān	Nya Spanien
Santa Cruz de la Sierra	Santa Cruz de la Sierra
Boca Juniors	Club Atlético Boca Juniors
Cuiabá	Cuiabá
Īchīmal Mēxihco	Mexikos statsvapen
Guimarães	Guimarães
Īpān Uruguay	Uruguays flagga
Diego Rivera	Diego Rivera
Dornbirn	Dornbirn
Chīmalxōchitl	Solros
Rio Branco	Rio Branco (stad)
Campinas	Campinas
Maracaibo	Maracaibo
Л	Л
Tlālalacatl	Bläsgås
120 xihuitl	120-talet
Porto Velho	Porto Velho
Īpān Nicānāhuac	Nicaraguas flagga
Bugatti Veyron	Bugatti Veyron
Teōtīhuahcān	Teotihuacán
Katana	Katana
Huanaco	Guanaco
Santiago Tlachco	Querétaro
Franz Ferdinand (tlacuīcaliztli)	Franz Ferdinand (musikgrupp)
Chalchiuhcuehcān	Veracruz
Tlenemāctli	Olibanum
Īpān Cōzcatlān	El Salvadors flagga
San José	San José
Ч	Ч
Ш	Ш
Н	Н
Ф	Ф
Vietnam Airlines	Vietnam Airlines
One-Eyed Jacks	Revansch
Villa Alemana	Villa Alemana
Chālchihuitl	Jade
Cemānāhuac tlāhuāntli ītech neīcxitapayolhuiliztli 2010	Världsmästerskapet i fotboll 2010
Burger King	Burger King
Cuīcani	Sångare
Chīchīlcītlalli īmētz	Mars naturliga satelliter
Tzitzimītl	Demon
170 xihuitl	170-talet
The Police	The Police
Huapalcepayahuiliztli	Snowboard
Īpān Cuauhtēmallān	Guatemalas flagga
О	О
Mōlli	Sås
Bels	Wels
Vinillahualli	Grammofonskiva
Cauhcaxitl	Armbandsur
Teōtl	Gudom
Cu	CU
Cahuāyohyacānaliztli	Hästsport
Crowborough	Crowborough
Peugeot 604	Peugeot 604
Atahualpa	Atahualpa
М	М
Edward Elgar	Edward Elgar
Xōchitēnācatl	Smaragdtukanett
Zacanōchtli	Opuntia megarrhiza
Quetzalcōātl	Quetzalcóatl
Ц	Ц
Х	Х
У	У
С	С
Christopher Lee	Christopher Lee
Philip Seymour Hoffman	Philip Seymour Hoffman
Peugeot 505	Peugeot 505
Boa Vista	Boa Vista, Roraima
Piciyetl	Virginiatobak
Popōcatepētl	Popocatépetl
Disneyland	Disneyland
HNK Hajduk Split	HNK Hajduk Split
Ronnie Vannucci Jr.	Ronnie Vannucci, Jr.
Enzo Ferrari	Enzo Ferrari
Wavre	Wavre
Р	Р
Cars	Bilar (film)
Jeanne Calment	Jeanne Calment
Benito Juárez	Benito Juárez
Cuammiztli	Jaguarundi
Щ	Щ
With the Beatles	With the Beatles
Т	Т
The Sims 2	The Sims 2
Elena Paparizou	Elena Paparizou
Juana Inés de la Cruz	Juana Inés de la Cruz
Bugs Bunny	Snurre Sprätt
Cochabamba	Cochabamba
Xamitl	Lersten (byggmaterial)
130 xihuitl	130-talet
Tīzatl	Krita (bergart)
Michpatlāni	Flygfiskar
In Teōtlahtōlneltocōni	Trosbekännelse
Mictlāntēuccītlalli īmētz	Plutos naturliga satelliter
Let It Be (cuīcatl)	Let It Be (sång)
Viña del Mar	Viña del Mar
Guarulhos	Guarulhos
Caxtiltōtōtl	Röd djungelhöna
The Sims	The Sims
Tzopilōtl	Nya världens gamar
Curlant	Kurland
Tremecen	Tlemcen
Yacapitzāhuac (tōtōtl)	Svarthalsad dopping
Tlacetīliztli (tlapōhualmatiliztli)	Union (matematik)
Serravalle	Serravalle
Chīchīltictēpetzaucxōchitl	Laelia autumnalis
Bressanone	Bressanone
Ю	Ю
Rafael Márquez	Rafael Márquez
Āhuachāmpan	Ahuachapán
Watson	Doktor Watson
Ocnamacoyān	Barlokal
Rusiamachiyōtlahtōltecpantiliztli	Ryska alfabetet
San Pedro de Atacama	San Pedro de Atacama
Tōltēcatl	Tolteker
Teōtlālmazātl	Gaffelantilop
Cuīcāmoxtli	Partitur
Caxitl	Låda
Ocēlōmichin	Tigerhaj
SEAT	Seat
Snow Patrol	Snow Patrol
Yamaha	Yamaha Corporation
Pixies	Pixies
140 xihuitl	140-talet
Rigoberta Menchú	Rigoberta Menchú
Pyeongchang	Pyeongchang
The Kinks	The Kinks
Я	Я
Sorocaba	Sorocaba
León, Guanajuato	León de los Aldama
Pītic	Hermosillo
Antonio José de Sucre	Antonio José de Sucre
Tlacetilīlli Huēyāltepētl in Tlahco Ixachitlān	Centralamerikanska federationen
Sintra	Sintra
Christopher Plummer	Christopher Plummer
Vicente Fox	Vicente Fox
Un Chien Andalou	Den andalusiska hunden
Matthew Bellamy	Matthew Bellamy
Tepozcaxitl tepozmalacatl	Sedan
Island Records	Island Records
Love Actually	Love Actually
Fier, Albania	Fier
Xihuitl (tlanelhuayōtl)	Ört
Felipe VI	Felipe VI av Spanien
Chiara d'Assisi	Klara av Assisi
Mangaka	Mangaka
Zacaitzcuintli	Skogshund
Clavimecatl	Klavikord
Mecacōātl	Leptophis mexicanus
150 xihuitl	150-talet
Tlācatōtōtl	Större nandu
Liberdade (São Paulo)	Liberdade
Pancho Villa	Pancho Villa
Xōchimiztli	Margay
Cōzcacuāuhtli	Kungsgam
Āxcān cāhuitl	Nutid
Iquitos	Iquitos
Live Aid	Live Aid
Tōlmichin	Sphyraena
Cuappachtli	Ockra
Tzopilōcuāuhtli	Kalifornisk kondor
Tlacuachin	Storörad opossum
Cantinflas	Cantinflas
Chīmalhuahcān	Chimalhuacán
Tēucyōtl Yuba	Yuba County
Henrik Mkhitarian	Henrich Mchitarjan
Shumerlya	Sjumerlja
Mēxihcali	Mexicali
Michcoztli	Torsk
Universidad de Concepción	Universidad de Concepción
Āltepēnānyōtl	Metropolregion
Morelia	Morelia
180 xihuitl	180-talet
Juan Rulfo	Juan Rulfo
Notting Hill (īxiptlayōlli)	Notting Hill (film)
Mēxihcatlācatiyāncuīcatiliztli	Himno Nacional Mexicano
Aguascalientes, Aguascalientes	Aguascalientes
Loreto (tlālxeliuhcāyōtl)	Loreto (region)
Rishon LeZion	Rishon LeZion
Chiquihuitl	Korg
Amazonas (Peru)	Amazonas (region)
Tecpacuihcuilli	Jaspis
Francisco de Quevedo	Francisco de Quevedo
The Flintstones	Familjen Flinta
Jedward	Jedward
Chīlli	Spanskpepparsläktet
Ic cē mētztli īpan 2008	Januari 2008
Dido Armstrong	Dido Armstrong
Ascari	Ascari
Zihuatanejo	Zihuatanejo
Reggaeton	Reggaeton
Black Holes and Revelations	Black Holes and Revelations
Cuauhnāhuac	Cuernavaca
Tlaxcalli	Tortilla
San Luis Potosí, San Luis Potosí	San Luis Potosí (stad)
World Music	Världsmusik
Cuzco (tlālxeliuhcāyōtl)	Cusco (region)
Arequipa (tlālxeliuhcāyōtl)	Arequipa (region)
Caxamarca (tlālxeliuhcāyōtl)	Cajamarca (region)
Ancax	Ancash
Puno (tlālxeliuhcāyōtl)	Puno (region)
Ayacucho (tlālxeliuhcāyōtl)	Ayacucho (region)
Caxamarca	Cajamarca
Tlālxeliuhcāyōtl La Libertad (Peru)	La Libertad
Tōztli	Blågul ara
Aspen	Aspen, Colorado
Vargas	Vargas (delstat)
190 xihuitl	190-talet
Nøtterøy	Nøtterøy kommun
Tacna (tlālxeliuhcāyōtl)	Tacna (region)
Ucayali	Ucayali (region)
Tōchtlān Gutiérrez	Tuxtla Gutiérrez
Ācuetzpalin	Spetskrokodil
Chīlpantzinco Bravo	Chilpancingo de los Bravo
Yohualocēlōtl	Panter
Mēxihco ītlacualiz	Mexikanska köket
Āhuacamōlli	Guacamole
A Rush of Blood to the Head	A Rush of Blood to the Head
Tepīc	Tepic
Junín	Junín (region)
Showbiz	Showbiz
Peugeot 206	Peugeot 206
Cōzauhqui	Guld (färg)
León, Nicānāhuac	León, Nicaragua
Moquegua (tlālxeliuhcāyōtl)	Moquegua (region)
Piura (tlālxeliuhcāyōtl)	Piura (region)
Ica (tlālxeliuhcāyōtl)	Ica (region)
Cuetlaxōchitl	Julstjärna (krukväxt)
Bat Yam	Bat Yam
Santa Marta (Colombia)	Santa Marta
Ford Focus II	Ford Focus
Tōllohcān Lerdo	Toluca de Lerdo
Tumbes (tlālxeliuhcāyōtl)	Tumbes (region)
Tlālxeliuhcāyōtl Lambayeque	Lambayeque
Julia Stiles	Julia Stiles
Ambato	Ambato
Cualnezcāltepēc	Villahermosa
Glastonbury, Somerset	Glastonbury
Tesla Roadster	Tesla Roadster
Madre de Dios (tlālxeliuhcāyōtl)	Madre de Dios (region)
Pedro de Alvarado	Pedro de Alvarado
Absolution	Absolution (musikalbum)
Origin of Symmetry	Origin of Symmetry
2007 Peru tlālolīniliztli	Jordbävningen i Peru 2007
Pasco	Pasco
Cōlhuahcān Rosales	Culiacán
San Martín (tlālxeliuhcāyōtl)	San Martín (region)
Lima (tlālxeliuhcāyōtl)	Lima (region)
Roger Ebert	Roger Ebert
Quetzalpāpalōtl	Monark (fjäril)
Mēxihco ītlahtōllō	Mexikos historia
Huehcāuh Cuauhtēmallān	Antigua Guatemala
Wadowice	Wadowice
210 xihuitl	210-talet
Coupé	Coupé
Paul Walker	Paul Walker
Troxillo, Perú	Trujillo, Peru
La Paz, Tlani California Huitztlāmpa	La Paz, Baja California Sur
Adolfo Suárez	Adolfo Suárez
Mēxihcatl Tēahcomanaliztli	Mexikanska revolutionen
Procol Harum	Procol Harum
220 xihuitl	220-talet
Leticia, Colombia	Leticia
Peugeot 205	Peugeot 205
Huanuco (tlālxeliuhcāyōtl)	Huánuco (region)
Hot Fuss	Hot Fuss
Peugeot 307	Peugeot 307
A-side īhuān B-side	A-sida och B-sida
Abancay	Abancay
Oztoatl	Gråräv
Askøy	Askøy kommun
Rock tlacuīcaliztli	Musikgrupp
230 xihuitl	230-talet
JVC	JVC
Yōlchicāuhtlahtōl	Accent (typologi)
Honda Civic	Honda Civic
Volkswagen Passat	Volkswagen Passat
Lamborghini Murciélago	Lamborghini Murciélago
Hatchback	Halvkombi
Francisco I. Madero	Francisco Madero
Cúcuta	Cúcuta
240 xihuitl	240-talet
Pucallpa	Pucallpa
Bocas del Toro (huēyāltepētl)	Bocas del Toro (provins)
Tlācatōcāitl	Invånarnamn
Álvaro Obregón	Álvaro Obregón
Gulen	Gulens kommun
250 xihuitl	250-talet
Huēyāltepētl Formosa	Formosa
Hidalgo (tlahtōlmelāhuacātlāliztli)	Hidalgo
Tlahtohcāyōtl Palestina	Palestina (stat)
260 xihuitl	260-talet
Huītzilōpōchtli	Huitzilopochtli
Onohuayān Valparaíso	Región de Valparaíso
Nāuhcalpan Juárez	Naucalpan de Juárez
Universidad Complutense de Madrid	Universidad Complutense de Madrid
270 xihuitl	270-talet
Popol Vuh	Popol Vuh
The Killers	The Killers
280 xihuitl	280-talet
Xālāpan Enríquez	Xalapa
Ramla	Ramle
290 xihuitl	290-talet
Universidad Nacional Autónoma de México	Universidad Nacional Autónoma de México
César Vallejo	César Vallejo
Īxiptlayōllācatl	Skådespelarkonst
Ibagué	Ibagué
Renault Mégane	Renault Mégane
Peugeot 207	Peugeot 207
Āyōtl	Sköldpaddor
A Study in Scarlet	En studie i rött
Nezahualiztli ipan cuacuahuitl Africa xiuhpan 2011	Svälten i Östafrika 2011
Granada	Granada
Piura	Piura
30 Seconds to Mars (LP)	30 Seconds to Mars (musikalbum)
Tl	TL
310 xihuitl	310-talet
320 xihuitl	320-talet
Santa Fe	Santa Fe
330 xihuitl	330-talet
340 xihuitl	340-talet
Āpātzco	Apaxco
San Miguel	San Miguel
Santa Ana	Santa Ana
Nariño	Nariño
Tz	TZ (olika betydelser)
400 xihuitl	400-talet (decennium)
Paricutín	Paricutín
Tlālcoyōtl	Nordamerikansk grävling
Universidad de Chile	Universidad de Chile
Cacalōmichin	Diplodus vulgaris
Tlachicuazti 2007	Juni 2007
410 xihuitl	410-talet
Cundinamarca	Cundinamarca
Puno	Puno
Coyametl	Navelsvin
Tlāloc	Tlaloc
420 xihuitl	420-talet
Beni	Beni
Mochīntīn tepozmalacatl tlātlāliani	Lista över bilmärken
Tlachicōnti 2006	Juli 2006
Tlachicōnti 2007	Juli 2007
Tlaōnti 2007	Februari 2007
430 xihuitl	430-talet
Tlālxeliuhcāyōtl Cochabamba	Cochabamba (departement)
Emina Jahović	Emina Jahović
Tlālxeliuhcāyōtl Tarixa	Tarija (departement)
The 4400	The 4400
440 xihuitl	440-talet
Tolima	Tolima
Tlayēti 2007	Mars 2007
Tlachicuēiti 2007	Augusti 2007
Tlamahtlācti 2008	Oktober 2008
450 xihuitl	450-talet
Tlālxeliuhcāyōtl Santa Cruz	Santa Cruz (departement)
Chuquisaca	Chuquisaca
Ahtlapāleh	Ängel
Cuixin	Buteo
Manizales	Manizales
Tlamahtlāccēti 2007	November 2007
Amy Smart	Amy Smart
Pando	Pando
Tlamahtlāccēti 2006	November 2006
Tlamācuīlti 2008	Maj 2008
460 xihuitl	460-talet
Īpān Vasconia	Ikurriña
Tlanāuhti 2007	April 2007
Tlamācuīlti 2007	Maj 2007
Chavela Vargas	Chavela Vargas
470 xihuitl	470-talet
Tlanāuhti 2008	April 2008
Ic cē mētztli īpan 2010	Januari 2010
Tlamahtlācti 2007	Oktober 2007
Tunja	Tunja
Tlamahtlāccēti 2008	November 2008
480 xihuitl	480-talet
Space rock	Space rock
Lucía Etxebarria	Lucía Extebarria
Maria del Mar Bonet	Maria del Mar Bonet
Tlachicuazti 2006	Juni 2006
Ic cē mētztli īpan 2009	Januari 2009
490 xihuitl	490-talet
Tlālxeliuhcāyōtl Potosí	Potosí (departement)
Cītlaltepētl	Pico de Orizaba
Ferrari F430	Ferrari F430
Mérida	Mérida (olika betydelser)
Ehcatōtōtl	Kamskrake
San Vicente	San Vicente
510 xihuitl	510-talet
Tlamahtlācōnti 2008	December 2008
Tlachicuēiti 2008	Augusti 2008
520 xihuitl	520-talet
Tlachiucnāuhti 2008	September 2008
530 xihuitl	530-talet
Luis Barragán Morfin	Luis Barragán
540 xihuitl	540-talet
Tlachicōnti 2008	Juli 2008
Ic cē mētztli īpan 2011	Januari 2011
550 xihuitl	550-talet
Alotl	Röd ara
Bucaramanga	Bucaramanga
560 xihuitl	560-talet
Rosa de Lima	Rosa av Lima
570 xihuitl	570-talet
Pete Seeger	Pete Seeger
Romagna	Romagna
580 xihuitl	580-talet
San José Chināntequilla	San José Chinantequilla
590 xihuitl	590-talet
Lewes, Sussex Tlāpcopa	Lewes
Renault 4	Renault 4
Volkswagen Polo	Volkswagen Polo
610 xihuitl	610-talet
620 xihuitl	620-talet
Álamos, Sonora	Álamos
630 xihuitl	630-talet
Halloween	Halloween
Árbol del Tule	Árbol del Tule
640 xihuitl	640-talet
Āltepētl Taos	Pueblo de Taos
650 xihuitl	650-talet
660 xihuitl	660-talet
This Is War	This Is War
670 xihuitl	670-talet
Chīmalpopoca	Chimalpopoca
690 xihuitl	690-talet
Totopochtli	Totopos
Katy Jurado	Katy Jurado
Tlāhuihpochchōtl	Churel
Tlālxeliuhcāyōtl Manāhuac	Managua (departement)
Chiclayo	Chiclayo
70 xihuitl	70-talet
710 xihuitl	710-talet
720 xihuitl	720-talet
Alejandro Jodorowsky	Alejandro Jodorowsky
730 xihuitl	730-talet
740 xihuitl	740-talet
Omitl	Ben (skelett)
750 xihuitl	750-talet
José María Arguedas	José María Arguedas
760 xihuitl	760-talet
770 xihuitl	770-talet
780 xihuitl	780-talet
Nissan Fairlady Z33	Nissan 350Z
790 xihuitl	790-talet
Enzo Ferrari (tepozmalacatl)	Ferrari Enzo Ferrari
Universidad Nacional Mayor de San Marcos	Universidad Nacional Mayor de San Marcos
Tlayēti 2008	Mars 2008
Tlachicuazti 2008	Juni 2008
Tlamahtlācōnti 2007	December 2007
Guarujá	Guarujá
80 xihuitl	80-talet
810 xihuitl	810-talet
The Fray	The Fray
Tēucyōtl Glenn	Glenn County
Tēucyōtl Colusa	Colusa County
Tēucyōtl Calaveras	Calaveras County
820 xihuitl	820-talet
Tēucyōtl Fresno	Fresno County
Peyōtl	Peyote
830 xihuitl	830-talet
Mitsubishi Lancer	Mitsubishi Lancer
Tlanāuhti 2006	April 2006
840 xihuitl	840-talet
850 xihuitl	850-talet
Tacna	Tacna
Tampico	Tampico
San Pedro Zōllān	San Pedro Sula
Momomalacatl	Sportbil
Tezoquitl	Puts
Ford Mondeo	Ford Mondeo
Xuxa	Xuxa
900 xihuitl	900-talet (decennium)
Conēyōtl	Barndom
90 xihuitl	90-talet
910 xihuitl	910-talet
Nāuhpōhualmahtlāctli omōme	92 (tal)
Chan Chan	Chan Chan
Panic At The Disco	Panic! at the Disco
Cristopīxqueh yāōyōtl	Cristero-upproret
Nāuhpōhualcaxtōloncē	96 (tal)
Ōmpōhualomēyi	43 (tal)
Inic Cē Mēxihcatl Emperadoryōtl	Första mexikanska kejsardömet
Moyobamba	Moyobamba
Mazda 6 Atenza II	Mazda6
Ximena Navarrete	Ximena Navarrete
Linda Bengtzing	Linda Bengtzing
Tapayaxin	Paddleguaner
The Vines	The Vines
Miguel de la Madrid	Miguel de la Madrid
Costa-Gavras	Costa-Gavras
Lázaro Cárdenas	Lázaro Cárdenas
Enrique Peña Nieto	Enrique Peña Nieto
Cuāuhtēmoc	Cuauhtémoc
Ernesto Zedillo	Ernesto Zedillo
Greyson Chance	Greyson Chance
Victoriano Huerta	Victoriano Huerta
A Beautiful Lie	A Beautiful Lie
A Whiter Shade of Pale	A Whiter Shade of Pale
Quimichpatlāni	Egentlig vampyr
James Gandolfini	James Gandolfini
Miccāilhuitl	De dödas dag
Renault Clio	Renault Clio
Paysandú	Paysandú
Brandon Flowers	Brandon Flowers
Zacametl	Agave lechuguilla
Huitzocuitlapilli	Ormkaktus
Nōcheznohpalli	Kochenillkaktus
Mexcalmetl	Tequilaagave
Tenohpalli	Cylindropuntia imbricata
Cōztomatl	Physalis coztomatl
Tzaucxōchitl	Bletia
Chīltomatl	Havannapeppar
Teocotl	Pinus teocote
Xāltomatl	Jaltomator
Ātzapocuahuitl	Pouteria campechiana
Juan Manuel Vargas	Juan Manuel Vargas
Guadalupe Victoria	Guadalupe Victoria
Pachtli	Spansk mossa
Tzaponōchnohpalli	Stenocereus queretaroensis
N!xau	N!xau
Venustiano Carranza	Venustiano Carranza
Hal Holbrook	Hal Holbrook
Donald Pleasence	Donald Pleasence
Ousmane Sembène	Sembène Ousmane
Plutarco Elías Calles	Plutarco Elías Calles
José López Portillo	José López Portillo
Miguel Alemán	Miguel Alemán Valdés
Vicente Guerrero	Vicente Guerrero
Pedro Lascuráin	Pedro Lascuráin Paredes
Manuel Ávila Camacho	Manuel Ávila Camacho
Cuitlāhuac	Cuitláhuac
Carlos Salinas de Gortari	Carlos Salinas
Gustavo Díaz Ordaz	Gustavo Díaz Ordaz
Francesco di Paola	Franciskus av Paola
Alex Turner	Alex Turner
David Alfaro Siqueiros	David Alfaro Siqueiros
Jón Þór Birgisson	Jón Þór Birgisson
Tupaq Amaru II	Túpac Amaru II
Jan Švankmajer	Jan Švankmajer
Luis Echeverría	Luis Echeverría
Itzcōātl	Izcoatl
Chayohtli	Sechium edule
Ic cē mētztli īpan 2006	Januari 2006
Xālxococuahuitl	Guavasläktet
Richard Matheson	Richard Matheson
Adolfo Ruiz Cortines	Adolfo Ruiz Cortines
Peugeot 406	Peugeot 406
Tlayēti 2006	Mars 2006
Tlaōnti 2006	Februari 2006
Āltepētl Victoria	Ciudad Victoria
José Clemente Orozco	José Clemente Orozco
El ángel exterminador	Mordängeln
Shannon Leto	Shannon Leto
Tlachicōnti 2005	Juli 2005
Cozumel	Cozumel
Quetzaltenānco (āltepēcalpōlli)	Quetzaltenango
Tlamahtlācti 2005	Oktober 2005
Inka Garcilaso de la Vega	Inca Garcilaso de la Vega
Cuitlacoztli	Citrin
Popayán	Popayán
Salto, Uruguay	Salto, Uruguay
Ācamāpīchtli	Acamapichtli
Adolfo López Mateos	Adolfo López Mateos
Juan Diego Cuāuhtlahtoātzin	Juan Diego Cuauhtlatoatzin
Ā	Ā
Tīzoc	Tízoc
Porsche Cayenne	Porsche Cayenne
Ē	Ē
Across The Universe	Across the Universe
Ī	Ī
Ĺ	Ĺ
Āxāyacatl	Axayacatl
Āhuitzotl (Tenōchtitlan tlahtoāni)	Auítzotl
Apurimac	Apurimac
Richard Schiff	Richard Schiff
Mariano Azuela	Mariano Azuela
Juan Ruiz de Alarcón	Juan Ruiz de Alarcón
Valentín Gómez Farías	Valentín Gómez Farías
Jiří Trnka	Jiří Trnka
Pedro de Betancur	Pedro de Betancur
DeLorean DMC-12	DeLorean DMC-12
Inic Ōme Mēxihcatl Emperadoryōtl	Andra mexikanska kejsardömet
Chicago (tlacuīcaliztli)	Chicago (musikgrupp)
Castelo Branco	Castelo Branco
Plug In Baby	Plug In Baby
Molotl (tōtōtl)	Husrosenfink
Brennero	Brenner
Richard Kiel	Richard Kiel
Sony Ericsson	Sony Mobile
Chittagong	Chittagong
Opel Corsa D	Opel Corsa
José María Morelos	José María Morelos
Oyametl	Abies religiosa
Nicolás Bravo	Nicolás Bravo
Víctor Raúl Haya de la Torre	Víctor Raúl Haya de la Torre
Huītzilihhuitl	Huitzilíhuitl
Gusttavo Lima	Gusttavo Lima
Bob Barker	Bob Barker
Aeroméxico	Aeroméxico
Partido Verde Ecologista de México	Partido Verde Ecologista de México
Arecibo tlahtōltzintli	Arecibomeddelandet
Ō	Ō
Nauhyacatl	Lansorm
Ferrari 599 GTB	Ferrari 599 GTB Fiorano
Tlīltzapocuahuitl	Diospyros digyna
Nazarín	Nazarín
Tohtli	Amerikansk sparvhök
Ŕ	Ŕ
Torreón	Torreón
Friedrich Ferdinand von Beust	Friedrich Ferdinand von Beust
Tecpin	Loppor
Tzīncōzcatl	Analkulor
Quechōlli	Rosenskedstork
Nacamatl	Kartong
Brothers & Sisters	Brothers & Sisters
Mēxihcatl teōtl	Aztekisk mytologi
Michael J. Fox	Michael J. Fox
Uruapan	Uruapan
Cōzolli	Vagga
Camohpāltic	Violett
Hopes and Fears	Hopes and Fears
Tlaōnti 2004	Februari 2004
Cempōhualehuatl	Ulmus mexicana
Tomaizquitl	Smultronträdssläktet
Nazaret	Nasaret
Chilacayohtli	Cucurbita ficifolia
Peugeot 306	Peugeot 306
Cēmpōhualchicōme	27 (tal)
Cēmpōhualcaxtōlli	35 (tal)
Nāuhpōhualcaxtōlonnāhui	99 (tal)
Francisco (huēyi teōpixcātlahtoāni)	Franciskus (påve)
Āmatl	Amatl
Joaquín Guzmán Loera	Joaquín Guzmán Loera
Matt Helders	Matthew Helders
Soraya Jiménez	Soraya Jiménez
Emilio Fernández	Emilio Fernández
Alex Kapranos	Alexander Kapranos
Chetumal	Chetumal
Juan Álvarez	Juan Álvarez
Carazo	Carazo (departement)
Juventino Rosas	Juventino Rosas
Ferrari F40	Ferrari F40
Honda Accord VIII	Honda Accord
Tēcuāncōātl	Skallerormar
Porsche 986 Boxster	Porsche Boxster
Tlamahtlācōnti 2005	December 2005
Vânia Fernandes	Vânia Fernandes
Volkswagen Touran	Volkswagen Touran
Ātzompan	Monte Albán
María Félix	María Félix
Peugeot 407	Peugeot 407
Petén	Petén
Tlanāuhti 2005	April 2005
Alamogordo	Alamogordo
Huancayo	Huancayo
Pāpalōcuahuitl	Ulmus americana
Ocotzocuahuitl	Liquidambar styraciflua
Ācoyōtl	Amerikansk ormhalsfågel
Belle de jour	Belle de jour - dagfjärilen
Julio César Chávez	Julio César Chávez
Paramore	Paramore
Xōchipal	Rosenskäresläktet
Ehēcalquixohuayān Tan Son Nhat	Tan Son Nhat internationella flygplats
Depeche Mode	Depeche Mode
Yahualtzintli	Musikalbum
My Chemical Romance	My Chemical Romance
São Paulo Metro	São Paulos tunnelbana
Walmart	Walmart
The Cranberries	The Cranberries
Sigur Rós	Sigur Rós
Mr. Bean	Mr. Bean
Keane	Keane
The Cure	The Cure
Jared Leto	Jared Leto
Erasure	Erasure
Tarkan Tevetoğlu	Tarkan
Simple Plan	Simple Plan
Smells Like Teen Spirit	Smells Like Teen Spirit
San Bernardino, California	San Bernardino
Tēucyōtl San Miguel (Yancuīc Mēxihco)	San Miguel County, New Mexico
Tēucyōtl Valencia	Valencia County
Monterey, California	Monterey, Kalifornien
Salinas, California	Salinas, Kalifornien
Michel Teló	Michel Teló
The Verve	The Verve
Tēucyōtl Hidalgo (Yancuīc Mēxihco)	Hidalgo County, New Mexico
Tēucyōtl Luna	Luna County
Subcomandante Marcos	Subcomandante Marcos
Ahtlatl	Atlatl
James Avery	James Avery
Rainer Brüderle	Rainer Brüderle
Peugeot 308	Peugeot 308
Nissan Skyline GT-R R35	Nissan GT-R
The Time Machine (2002 īxiptlayōlli)	The Time Machine
The Sign of Four	De fyras tecken
Puntarenas (huēyāltepētl)	Puntarenas (provins)
Cartago (huēyāltepētl)	Cartago (provins)
Alajuela (huēyāltepētl)	Alajuela (provins)
Heredia (huēyāltepētl)	Heredia (provins)
Chris Pratt	Chris Pratt
Chīlchōtl	Jalapeño
Peugeot 607	Peugeot 607
Renault 5	Renault 5
Xomōtl	Blåvingad årta
Āltepētepozmalacatl	Stadsbil
Renault Laguna III	Renault Laguna
Renault 21	Renault 21
Ayacucho	Ayacucho
Huanuco	Huánuco
Huancavelica (tlālxeliuhcāyōtl)	Huancavelica (region)
Cuetzpalmichin	Bengäddor
Peugeot 202	Peugeot 202
Pozolli	Pozole
Xīcamatl	Pachyrhizus erosus
Chimbote	Chimbote
Jaguar XJ220	Jaguar XJ220
Kami	Kami
Andrés Quintana Roo	Andrés Quintana Roo
Huēyizacatlān	San Cristóbal de las Casas
Yellow (cuīcatl)	Yellow (sång)
Renault 18	Renault 18
Renault Scénic	Renault Scénic
Efem Zimbalist, Jr.	Efrem Zimbalist, Jr.
Kaká	Kaká
Concepción de La Vega	Concepción de La Vega
Puerto Maldonado	Puerto Maldonado
Dolores O'Riordan	Dolores O'Riordan
Cēmpōhualchiucnāhui	29 (tal)
Peugeot 304	Peugeot 304
Anime necentlālīliztli	Animekonvent
Fernando del Paso	Fernando del Paso
Ignacio Allende	Ignacio Allende
Xīpe-Totec	Xipe Totec
Franz Schönhuber	Franz Schönhuber
Joan Fuster	Joan Fuster
José Emilio Pacheco	José Emilio Pacheco
Renault 14	Renault 14
Cuauhcoxolihtli	Större hocko
Newhaven, Sussex Tlāpcopa	Newhaven, East Sussex
Āmanacocheh	Buffelhuvud
Renault 8	Renault 8
Acachatl	Penaeus monodon
Āxōlōmichin	Ictaluridae
Mātlālcuēyeh (tletepētl)	Matlalcueitl
Otlatl	Otatea
Cochotl	Vitpannad amazon
Maná	Maná
Renault 7	Renault 7
Hot Wheels	Hot Wheels
Osuna	Osuna
Santa María Cuatōlco	Huatulco
Tlālxeliuhcāyōtl León	León (departement)
Dominic Howard	Dominic Howard
Cēmpōhualchicuēyi	28 (tal)
Map of the Problematique	Map of the Problematique
Īxiptlayōlcāyōtl	Filmfotografi
Renault 12	Renault 12
Veraguas	Veraguas (provins)
Nāuhpōhualcaxtōlli	95 (tal)
Āltepētl Constitución	Ciudad Constitución
Cēmpōhualcaxtōlomēyi	38 (tal)
Guy Berryman	Guy Berryman
Itzcuāuhtli	Prakthökörn
Āehēcamalacotl Félix	Orkanen Felix
Tlanāuhti 2004	April 2004
Yohuallān Independencia	Iguala de la Independencia
BMW 3er-E36	BMW E36
Somebody Told Me	Somebody Told Me
Tlayēti 2004	Mars 2004
Āzcamōlli	Escamoles
Āpitzauhco	Apizaco
Ātlatlālacatl	Anserinae
Palos de la Frontera	Palos de la Frontera
Mīltomatl	Tomatillo
Licaonia	Lykaonien
Tlālxeliuhcāyōtl Atlántida	Atlántida
Carmel	Carmel-by-the-Sea
Huēiyac chicāuhtlahtōl	Streck (diakritiskt tecken)
Colón, Panama	Colón, Panama
Ōmpōhualmācuīlli	45 (tal)
Chichtli	Kråsuggla
San Rafael, California	San Rafael, Kalifornien
Ehēcatōtolin	Större tuppgök
Neiva	Neiva
Cuīcatiani	Musiker
Epazōtl	Citronmålla
Atetepitztli	Noshornsbaggar
Limón (huēyāltepētl)	Limón (provins)
Jimmy Eat World	Jimmy Eat World
Īpān Yancuīc Mēxihco	New Mexicos flagga
Xōchimīlco	Xochimilco
Huitzitzilmichin	Näbbgädda
Nissan Skyline GT-R R34	Nissan Skyline
Marías Tlālhuāctli	Islas Marías
Santa María, California	Santa Maria, Kalifornien
Citroën C4	Citroën C4
Tlālxeliuhcāyōtl Chināntēcapan	Chinandega (departement)
Dodge Viper SRT-10 ZB	Dodge Viper
Cuāuhtemōc (īxiptlahyōtiliztli)	Cuauhtémoc (distrikt)
Mātlālpāpalōtl	Morpho
Atapalcatl	Amerikansk kopparand
San José (huēyāltepētl)	San José (provins)
Tapachtli	Spondylus
Arthur Seyß-Inquart	Arthur Seyss-Inquart
Quetzalcuetzpalin	Hjälmbasilisk
Ocēlōpāpalōtl	Heliconius
Ensenada, Tlani California	Ensenada
Mamixtli	Vattenkran
Caratagena de Indias	Cartagena, Colombia
Los Cabos	Los Cabos
Coyōhuahcān	Coyoacán
Iztāccihuātl	Iztaccihuatl
Zacatōchin	Vulkankanin
Chichicōātl	Spilotes pullatus
San Miguel, Cōzcatlān	San Miguel, El Salvador
Tlamācuīlti 2005	Maj 2005
Tlachicuazti 2005	Juni 2005
Nāuhpōhualcaxtōlomōme	97 (tal)
Xināchtēcatl	Nevado de Toluca
Cerro de Pasco	Cerro de Pasco
Drew Barrymore	Drew Barrymore
Las Vegas, Yancuīc Mēxihco	Las Vegas, New Mexico
Machu Picchu	Machu Picchu
Francesco d'Assisi	Franciskus av Assisi
Renault Dauphine	Renault Dauphine
Ācachichictli	Mörk svandopping
Flores, Petén	Flores (Guatemala)
Cōcohtli	Inkaduva
Āltepētl Obregón	Ciudad Obregón
Partido Revolucionario Institucional	Institutionella revolutionära partiet
Ic cē mētztli īpan 2005	Januari 2005
Chicalotl	Gul taggvallmo
Nāuhpōhualmahtlāctli onnāhui	94 (tal)
Darién	Darién (provins)
Kanon und Gigue in D-Dur für drei Violinen und Basso Continuo	Kanon i D
Tlaxcallān Xīcohtēncatl	Tlaxcala (stad)
Cuauhnacaztli (huēyāltepētl)	Guanacaste (provins)
Nāuhpōhualmahtlāctli oncē	91 (tal)
Cuauhtēmallān (Tlālxeliuhcāyōtl)	Guatemala (departement)
Āehēcamalacotl Dean	Orkanen Dean
Juliaca	Juliaca
Volkswagen Jetta	Volkswagen Jetta
Xālcanauhtli	Amerikansk bläsand
De facto	De facto
Ichanehquiliz tlacatiyan	Lista över länder efter folkmängd
Cēmpōhualoncē	21 (tal)
Cēmpōhualomōme	22 (tal)
Ōmpōhualoncē	41 (tal)
Cēmpōhualmahtlāctli onnāhui	34 (tal)
Cēmpōhualmahtlāctli omēyi	33 (tal)
Ōmpōhualchicōme	47 (tal)
Cēmpōhualmahtlāctli oncē	31 (tal)
Cēmpōhualmahtlāctli omōme	32 (tal)
Ōmpōhualonnāhui	44 (tal)
Ōmpōhualchicuacē	46 (tal)
Ōmpōhualchiucnāhui	49 (tal)
Ōmpōhualchicuēyi	48 (tal)
Cēmpōhualcaxtōlomōme	37 (tal)
Cēmpōhualcaxtōlonnāhui	39 (tal)
Cēmpōhualcaxtōloncē	36 (tal)
Chris Martin	Chris Martin
Nāuhpōhualcaxtōlomēyi	98 (tal)
Jenni Rivera	Jenni Rivera
Lista de Tēpouhtitlāzcuetzpalin	Lista över dinosaurier
Ichcatl	Bomullssläktet
Sam’s Town	Sam's Town
Renault Twingo	Renault Twingo
Cōzahtli	Långsvansad vessla
Citroën C3	Citroën C3
Mexcalli	Mescal
Quetzalcōātl (yōlcatl)	Bothriechis aurifer
Renault 19	Renault 19
Tlālxeliuhcāyōtl Rivas	Rivas (departement)
Īxmanquitlālli	Flatland (roman)
Ic cē mētztli īpan 2004	Januari 2004
Ask	Ask, Hordaland
BMW 3er-E21	BMW E21
Bugatti EB110	Bugatti EB110
Jô Soares	Jô Soares
José Guadalupe Posada	José Guadalupe Posada
Āltepētl Mēxihco Metro	Mexico Citys tunnelbana
Kėdainiai	Kėdainiai
Cave	Cave (sång)
Tlātlāuhqui	Vermilion
Battle, Sussex Tlāpcopa	Battle, East Sussex
Chiriquí	Chiriquí (provins)
Santa Ana, Cōzcatlān	Santa Ana, El Salvador
Cōzcatlān, Cōlimān	Manzanillo
Francis Healy	Francis Healy
Iztapalāpan	Iztapalapa
Alpine A110	Alpine A110
Patox	Anka
Āteponaztli	Amerikansk rördrom
Panoz	Panoz
Āltepēcalpōlli	Italiens kommuner
Tequitl (netlamachtilli)	Tribut
Ferrari F50	Ferrari F50
Bender Bending Rodríguez	Bender (tecknad figur)
Huilōtl	Spetsstjärtad duva
Chināmitl	Chinampas
Tlaōnti 2005	Februari 2005
Ford GT	Ford GT
Tōnalmachiyōtl	Aztekkalendern
Calexico, California	Calexico
Volkswagen Sharan	Volkswagen Sharan
San Miguel de Allende	San Miguel de Allende
Crimea	Autonoma republiken Krim
BMW 3er-E46	BMW E46
Āpipipitzcatl	Präriemås
Tezcatlīpoca	Tezcatlipoca
Tozan	Kindpåsråttor
Chachapoyas	Chachapoyas
Audi A4	Audi A4
Audi R8	Audi R8
Cempōhualxōchitl	Stort sammetsblomster
Cuauhxīmalpan	Cuajimalpa de Morelos
Āxōlōcōātl	Bipes biporus
Okinawa, Xapon	Okinawa prefektur
Partido de la Revolución Democrática	Partido de la Revolución Democrática
Kukulkán	Kukulcán
Bragança	Bragança
Ixtehuilotl	Lins
Ehēcalquixohuayān ītlālpancalactihuechiliz Da Nang	Da Nang internationella flygplats
Viva Zapata!	Viva Zapata!
Tlachicōnti 2004	Juli 2004
Muscle Museum	Muscle Museum
Huaraz	Huaraz
Mēxihcatl tlahcuilōliztli	Aztekisk skrift
Mazāxococuahuitl	Spondias mombin
Tacaxtli	Stubbe
Cinocuilin	Helicoverpa zea
Shintō	Shinto
Ōmpōhualomōme	42 (tal)
Tepitōn tepozmalacatl	Poloklassen
Irapuato	Irapuato
Electronica	Electronica
Jonny Buckland	Jonny Buckland
Will Champion	Will Champion
Bernd Lucke	Bernd Lucke
Peugeot 405	Peugeot 405
Peugeot 605	Peugeot 605
Coclé	Coclé (provins)
Nāhuatlācah	Nahua
Tumbes	Tumbes
Cōātlīcue	Coatlicue
Centzontlahtōleh	Nordlig härmtrast
Franz Ferdinand (LP)	Franz Ferdinand (musikalbum)
Cuāchichiquilzōlin	Kalifornisk tofsvaktel
Panasonic	Panasonic
Bono	Bono
Medford, Oregon	Medford, Oregon
Your Song	Your Song
Caterham	Caterham
BMW 3er-E30	BMW E30
Cacomiztli	Centralamerikansk cacomixtler
Ica	Ica, Peru
LP	LP
Ford Ka	Ford Ka
Tehuahcān	Tehuacán
Pichilemu tlālolīniliztli īpan 2010	Jordbävningen i Pichilemu 2010
Tēcuāni tlācamāyeh	Mexikansk brunbjörn
Tlālnepantlah Baz	Tlalnepantla
Tequillān	Tequila (stad)
Peugeot 104	Peugeot 104
Renault Espace IV	Renault Espace
Mägo de Oz	Mägo de Oz
Tlayēti 2005	Mars 2005
Partido Acción Nacional	Nationella aktionspartiet (Mexiko)
Montería	Montería
Xincoyōtl	Phrynosomatidae
Copitl	Stor lysmask
Puerto Vallarta	Puerto Vallarta
Paquimeh, Chihuahhua	Casas Grandes
VietJet Air	VietJet Air
Tlālhuāctli Guadalupe	Guadalupeön
Iponia	Hippo Regius
Mitsubishi Eclipse	Mitsubishi Eclipse
Chaplin	Chaplin
Chīlpoctli	Chipotle
Bill Meléndez	Bill Meléndez
The Valley of Fear	Fasans dal
Tlamahtlācōnti 2004	December 2004
Ciudad de la Costa	Ciudad de la Costa
Norbert Steger	Norbert Steger
Tlamahtlācti 2004	Oktober 2004
Hubert Farnsworth	Professor Farnsworth
Calcactli	Tofflor
Tlālxeliuhcāyōtl Cholōltēcac	Choluteca (departement)
Ehēcalquixohuayān Ca Mau	Ca Mau flygplats
Córdoba	Córdoba
Tlahcotlālpan	Tlacotalpan
Copalli	Kopal
Lino xināchtli	Linfrö
Tlāltechalōtl	Spermophilus mexicanus
-ll-	LL
Renault 4CV	Renault 4CV
Tzīncahcalaquiāliz	Analplugg
Peugeot 404	Peugeot 404
Day & Age	Day & Age
Oeiras	Oeiras
Peugeot 504	Peugeot 504
Cuitlacochin (tōtōtl)	Bågnäbbad härmtrast
Jesús María (Aguascalientes īāltepēcalpōl)	Jesús María, Aguascalientes
Haxuri	Chasjuri
Porsche 996 Carrera	Porsche 996
Cuāuhtlah	Cuautla
Tlachicuazti 2004	Juni 2004
Mayatl	Cotinis mutabilis
Tenexmichin	Rödbraxen
L'Âge d'Or	Guldåldern
Wilamowice	Wilamowice
Zōyapanco	Soyapango
Orchestral Manoeuvres In The Dark	Orchestral Manoeuvres in the Dark
Guerrero Negro	Guerrero Negro
Dolores Hidalgo	Dolores Hidalgo
Iztāccuāuhtli	Vitvråk
Chināntēcapan	Chinandega
Juan Aldama	Juan Aldama
Guadalupe, Arizona	Guadalupe, Arizona
Guaymas	Guaymas
Clovis, Yancuīc Mēxihco	Clovis, New Mexico
Cuauhtechalōtl	Borstörad ekorre
Huilōnco	Córdoba, Veracruz
Playa del Carmen	Playa del Carmen
Sogamoso	Sogamoso
Nogales, Sonora	Nogales, Sonora
Monclova	Monclova
Āltepētl Carmen	Ciudad del Carmen
Ahuilizāpan	Orizaba
Āzcapōtzalco	Azcapotzalco
San Luis Río Colorado	San Luis Río Colorado
Huancavelica	Huancavelica
Moquegua	Moquegua
Ifrane	Ifrane
Huacho	Huacho
Tōchpan, Veracruz	Tuxpan
Durango, Colorado	Durango, Colorado
Ostia	Ostia Antica
Río Rico	Rio Rico, Arizona
Rosarito	Playas de Rosarito
Loreto, Tlani California Huitztlāmpa	Loreto, Mexiko
Tecate	Tecate
Cabo San Lucas	Cabo San Lucas
Otavalo	Otavalo
Vrahovice	Vrahovice
Nehuelyōllōtilonih Miccatzintin Ilhuitl	Alla själars dag
Sincelejo	Sincelejo
Tom Chaplin	Tom Chaplin
Teōcalli	Teocalli
Xihuiachyolli	Växtcell
Tlālxeliuhcāyōtl Oruro	Oruro (departement)
San Juan Chamollan	San Juan Chamula
Tlamācuīlti 2004	Maj 2004
Chiyan	Chia
Ācxoyātōtōtl	Hårspett
Porsche 993 Carrera	Porsche 993
Tlālhuāctli San Benedicto	San Benedicto
Power ballad	Ballad (populärmusik)
Zōlin	Montezumavaktel
Āltepētl Guzman	Ciudad Guzmán
Tlālhuāctli Clarión	Clarión
Zōyatl	Washingtonia robusta
Cacalōxōchitl	Frangipani
Closer	Closer
Mendoza āmoxtli	Codex Mendoza
Tzompanco (āltepēcalpōlli)	Zumpango (kommun)
Ehēcatl (teōtl)	Ehecatl
Cuextēcah	Huasteker
Māxtlatl	Höftskynke
Iztapallohcān	Ixtapaluca
Peugeot 403	Peugeot 403
Under the Iron Sea	Under the Iron Sea
Renault Avantime	Renault Avantime
Renault 11	Renault 9
With Or Without You	With or Without You
Renault Modus	Renault Modus
Otomih	Otomi
Ācoyoctli	Dagvattenbrunn
Peugeot 309	Peugeot 309
Tzahtzapalin	Gerreidae
Peugeot 203	Peugeot 203
BMW 3er-E90	BMW E90
Tamalli	Tamales
José María Bocanegra	José María Bocanegra
The Dead Zone (tētōcāīxiptlayōlli)	Död zon
Make Poverty History	Make Poverty History
Δ	Delta (olika betydelser)
Mācēhualli	Ödmjukhet
Tlamahtlācōnti 2006	December 2006
Tlaxēxelōliztli (tlapōhualmatiliztli)	Division (matematik)
Tzanatl	Mexikobåtstjärt
Ehēcalquixohuayān	Flygplats
Ra (teōtl)	Ra (gud)
Santiago	Santiago
Mixcōācuāuhtli	Större svartvråk
Zacatecah	Zacateco
Tlīlcuāuhtli	Svart eremitörn
Tzinizcan	Bergstrogon
Michael Ansara	Michael Ansara
Mariano Matamoros	Mariano Matamoros
60 xihuitl	60-talet
50 xihuitl	50-talet
40 xihuitl	40-talet
30 xihuitl	30-talet
Tezontzapocuahuitl	Pouteria sapota
Tlatzcan	Cupressus lusitanica
Tlalxiquipilli	Cantharis
Itzāmahuah	Laelia speciosa
Cuauhtitlan Izcalli	Cuautitlán Izcalli
Āltepētlālli	Ejido
Tēnācatl	Tukaner
Renault 6	Renault 6
Porsche 997 Carrera	Porsche 997
Peugeot 305	Peugeot 305
Tlālhuāctli Socorro	Socorroön
Saleen	Saleen
Peugeot 204	Peugeot 204
Feliciano Ama	José Feliciano Ama
Neneuhcāyōtl:Teutontlālpan	Kategori:Tyskland
Neneuhcāyōtl:Italia	Kategori:Italien
Neneuhcāyōtl:Tlacetilīlli Tlahtohcāyōtl	Kategori:USA
Neneuhcāyōtl:Rusia	Kategori:Ryssland
Neneuhcāyōtl:Canada	Kategori:Kanada
Neneuhcāyōtl:Tlacetilīlli Huēyitlahtohcāyōtl	Kategori:Storbritannien
Neneuhcāyōtl:Caxtillān	Kategori:Spanien
Neneuhcāyōtl:China	Kategori:Kina
Neneuhcāyōtl:Xapon	Kategori:Japan
Neneuhcāyōtl:Australia	Kategori:Australien
Neneuhcāyōtl:Mēxihco	Kategori:Mexiko
Neneuhcāyōtl:India	Kategori:Indien
Neneuhcāyōtl:Saudarabia	Kategori:Saudiarabien
Neneuhcāyōtl:Israel	Kategori:Israel
Neneuhcāyōtl:In Vaticano	Kategori:Vatikanstaten
Neneuhcāyōtl:Turquia	Kategori:Turkiet
Neneuhcāyōtl:Africa Huitztlāmpa	Kategori:Sydafrika
Neneuhcāyōtl:Egipto	Kategori:Egypten
Neneuhcāyōtl:Iran	Kategori:Iran
Neneuhcāyōtl:Yancuīc Zetlālpan	Kategori:Nya Zeeland
Neneuhcāyōtl:Argentina	Kategori:Argentina
0 xihuitl	00-talet
20 xihuitl	20-talet
Volkswagen Jetta III	Volkswagen Vento
Ātōyāxocotl	Spondias purpurea
Newcastle upon Tyne	Newcastle upon Tyne
Porsche 964 Carrera	Porsche 964
Huitzcuahuitl	Påfågelsträd
Quicapotlācah	Kickapoo
Āhuēhuētl	Taxodium mucronatum
Cuitlacochin (nanacatl)	Ustilago maydis
1120 xihuitl	1120-talet
680 xihuitl	680-talet
Franz Dinghofer	Franz Dinghofer
Temāzcalli	Temascal
Armando Manzanero	Armando Manzanero
Neneuhcāyōtl:Afganistan	Kategori:Afghanistan
Neneuhcāyōtl:Argelia	Kategori:Algeriet
Neneuhcāyōtl:Austria	Kategori:Österrike
Neneuhcāyōtl:Bangladex	Kategori:Bangladesh
Neneuhcāyōtl:Cuba	Kategori:Kuba
Neneuhcāyōtl:Etiopia	Kategori:Etiopien
Neneuhcāyōtl:Indonesia	Kategori:Indonesien
Neneuhcāyōtl:Irac	Kategori:Irak
Neneuhcāyōtl:Tlanitlālpan	Kategori:Nederländerna
Neneuhcāyōtl:Nigeria	Kategori:Nigeria
Neneuhcāyōtl:Polonia	Kategori:Polen
Neneuhcāyōtl:Portugal	Kategori:Portugal
Neneuhcāyōtl:Singapur	Kategori:Singapore
Neneuhcāyōtl:Corea Huitztlāmpa	Kategori:Sydkorea
Neneuhcāyōtl:Sudan	Kategori:Sudan
Neneuhcāyōtl:Suiza	Kategori:Schweiz
Neneuhcāyōtl:Tanzania	Kategori:Tanzania
Neneuhcāyōtl:Taitlālpan	Kategori:Thailand
Neneuhcāyōtl:Ucrania	Kategori:Ukraina
Neneuhcāyōtl:Vietnam	Kategori:Vietnam
Neneuhcāyōtl:Tōtōtl	Kategori:Fåglar
Neneuhcāyōtl:Nemiltōpīllōtl	Kategori:Bakterier
Neneuhcāyōtl:Tlanelhuayōmatiliztli	Kategori:Växter
Neneuhcāyōtl:Iuhcāyōtl	Kategori:Fysik
Neneuhcāyōtl:Yōlizmatiliztli	Kategori:Biologi
Neneuhcāyōtl:Huēhuehcāyōmatiliztli	Kategori:Historia
Neneuhcāyōtl:Cemānāhuacāyōtl	Kategori:Geografi
Neneuhcāyōtl:Teōmatiliztli	Kategori:Religion
Neneuhcāyōtl:Tlatilizmatiliztli	Kategori:Vetenskap
Neneuhcāyōtl:Tlālticpactli	Kategori:Jorden
La Paz	La Paz (olika betydelser)
Teōnanacatl	Psilocybe mexicana
Alpine A610	Alpine A610
Capōltomatl	Ballongblomma
Xōchicihuātl	Quinceañera
Iczotl	Yucca aloifolia
Acontli	Vinglas
Tlani California tlālolīniliztli īpan 2010	Jordbävningen i Baja California 2010
Tlālhuāctli Roca Parida	Roca Partida
Renault Frégate	Renault Frégate
Grand Prix	Grand Prix
Āyauhcuahuitl	Pinus ayacahuite
Mulegé (āltepēcalpōllōtl)	Mulegé (kommun)
Tlanahuatilizpiyalli	Kartotek
Ilamatzapocuahuitl	Annona macroprophyllata
Ācuīcuīyalōtl	Stensvala
Cōzcacōātl	Micrurus tener
Cōātzontecomaxōchitl	Stanhopea tigrina
Chiyāhualōtl	Oliv
Uno (cuīcatl)	Uno (sång)
Ocēlōxōchitl	Påfågelsliljesläktet
Santa Rosalía, Tlani California Huitztlāmpa	Santa Rosalía, Baja California Sur
Ocotl	Pinus montezumae
B Engineering Edonis	Edonis
Sunburn	Sunburn
Dr. Zoidberg	Zoidberg
Tlahtōlli īpan Mēxihco	Språk i Mexiko
Ic cē mētztli īpan 2007	Januari 2007
Jesús María	Jesús María
Neneuhcāyōtl:Ōmicqueh xiuhpan 2012	Kategori:Avlidna 2012
Etzapocuahuitl	Taggannona
Tabatinga, Amazonas	Tabatinga
Ramón Castilla	Ramón Castilla
Temazātl	Mazama americana
Cacapatzin	Passiflora foetida
Techalōtl	Sciurus aureogaster
Knights of Cydonia	Knights of Cydonia
Párvusz	Párvusz
Evanescence	Evanescence
Hot hatch	GTi-klassen
Tōnallān, Xālīxco	Tonalá
1985 Mēxihco tlālolīniliztli	Jordbävningen i Mexico City 1985
Metepēc (Tlahtohcāyōtl Mēxihco īāltepēcalpōl)	Metepec
Huēyi Caxtillān xōnacatl	Purjolök
Everybody’s Changing	Everybody's Changing
Iztāchichimēcapan	San Juan del Río
Miguel Hidalgo (īxiptlahyōtiliztli)	Miguel Hidalgo (distrikt)
Cuauhtitlan (Tlahtohcāyōtl Mēxihco īāltepēcalpōl)	Cuautitlán
Metlatl	Metate
Parras de la Fuente	Parras
Los Santos	Los Santos
Tlamācuīlti 2006	Maj 2006
Alpine A310	Alpine A310
Dazzle Ships	Dazzle Ships
Francisco Xavier Mina	Francisco Xavier Mina
Zōlcōātl	Agkistrodon bilineatus
Canāuhxōchitl	Zantedeschia aethiopica
Tlalconetl	Sniglar
Papalomoyotl	Lutzomyia
Pecados y milagros	Pecados y Milagros
Tecamac	Tecámac
When You Were Young	When You Were Young
Los Reyes Ācaquilpan	Los Reyes Acaquilpan
Nicolás Romero (āltepēcalpōlli)	Villa Nicolás Romero
Chihcōloāpan	Chicoloapan de Juárez
Chālco Díaz Covarrubias	Chalco de Díaz Covarrubias
Lagos de Moreno	Lagos de Moreno
Tōllāntzinco Bravo	Tulancingo
Nissan Fairlady Z S130	Nissan 280ZX
Neneuhcāyōtl:Olimpicayoh neāhuiltiliztli	Kategori:Olympiska spelen
Neneuhcāyōtl:Cristianismo	Kategori:Kristendom
Neneuhcāyōtl:Islam	Kategori:Islam
Neneuhcāyōtl:Judaísmo	Kategori:Judendom
Chris Wolstenholme	Christopher Wolstenholme
Time Is Running Out	Time Is Running Out (sång)
Amy Wong	Amy Wong
Invincible	Invincible (Muse-låt)
The Scientist	The Scientist
Supermassive Black Hole	Supermassive Black Hole
Starlight	Starlight
Sing for Absolution	Sing for Absolution
Mr. Brightside	Mr. Brightside
Tlamahtlācti 2006	Oktober 2006
Tōllān Allende	Tula de Allende
Noé Hernández	Noé Hernández
Nick O’Malley	Nick O'Malley
Iztapan Iztātl (āltepēcalpōlli)	Ixtapan de la Sal
Xiuhtic	Kornblå
Gustavo A. Madero (īxiptlahyōtiliztli)	Gustavo A. Madero (distrikt)
Nicolai Kielstrup	Nicolai Kielstrup
Do You Want To	Do You Want To
XVI Nemīmīnaliztli Mochi Ixachitlān	Panamerikanska spelen 2011
Michtlahzōlli	Chirostoma
All These Things That I’ve Done	All These Things That I've Done
San José del Cabo	San José del Cabo
Pianotli rock	Pianorock
Tlapapatiliztli yāōyōtl	Reformkriget
Cuāuhtli	Örnar
Lacandonquiyauhcuautlah	Lacandóndjungeln
Wolfgang Schüssel	Wolfgang Schüssel
Renault 3	Renault 3
Jamie Cook	Jamie Cook
Cōānenepilli	Passiflora jorullensis
Xohuilin	Menticirrhus americanus
Huitzquillohcān	Huixquilucan
Tlachiucnāuhti 2007	September 2007
Tlatzqui	Sengångare
Clovis	Klodvig
Ātōlli	Atole
Dave Keuning	Dave Keuning
Cochitzapocuahuitl	Casimiroa edulis
Mark Stoermer	Mark Stoermer
Cuauhtzapocuahuitl	Annona glabra
Benito Juárez (īxiptlahyōtiliztli)	Benito Juárez (distrikt)
Smile Like You Mean It	Smile Like You Mean It
Cuammochitl	Pithecellobium dulce
Chacas	Chacas
Itzpāpalōtl	Rothschildia orizaba
Yancuīc Galicia	Nueva Galicia
Ollin Tōnatiuh	Tonatiuh
Benedicta Boccoli	Benedicta Boccoli
Tzinācantlān	Zinacantán
Īxīptlayōlizyacānqui	Filmregissör
Nissan Fairlady Z S30	Nissan S30
Tōltitlan	Tultitlán
Paul Thomson	Paul Thomson
Iyauhtli	Glanstagetes
Cōzamālōmichin	Peprilus
Pichicōātl	Thamnophis rufipunctatus
Tlācametl	Agave atrovirens
Cacahuanāntli	Gliricidia sepium
Ehcapahtli	Senna occidentalis
Renault 10	Renault 10
Conrad Bain	Conrad Bain
Gustavo A. Madero	Gustavo Adolfo Madero
Mātlālitztic	Commelina erecta
Tlālocuilin	Daggmaskar
Āzcacuahuitl	Cecropia obtusifolia
Neneuhcāyōtl:Machiyōtl	Kategori:Stubbar
Neneuhcāyōtl:Nehnencācītlalli	Kategori:Planeter
Neneuhcāyōtl:Categoría	Kategori:Kategorier
Neneuhcāyōtl:Xihuitl	Kategori:Årtal
Neneuhcāyōtl:Cemantoc tlālli	Kategori:Världsdelar
Chīlaquīlli	Chilaquiles
Exotl	Haricots verts
Āmacuahuitl	Ficus insipida
Nohpaltepēc	Nopaltepec
Ford Fiesta	Ford Fiesta
10 xihuitl	10-talet
Broken/Tōnatiuh īchān	Mall:Solsystemet
Over My Head (Cable Car)	Over My Head (Cable Car)
Harry Potter	Harry Potter (figur)
Calīxcuātl:Cuīcayōtl	Portal:Musik
Calīxcuātl:Caxtillān	Portal:Spanien
Camiltic	Purpur
Calīxcuātl:Cemānāhuacāyōtl	Portal:Geografi
Tlazolmāmā	Ceraeochrysa claveri
The Dark Of The Matinée	The Dark of the Matinée
Yacapitzāhuac (michin)	Girardinichthys viviparus
Walk Away	Walk Away
São Paulo Metro - Pāntli 1	Linje 1 av São Paulos tunnelbana
Friðrik Ómar	Friðrik Ómar
Neil Primrose	Neil Primrose (musiker)
Bob Hardy	Robert Hardy (musiker)
Volkswagen Eurovan T5	Volkswagen Caravelle
Calīxatl:Teutontlālpan	Portal:Tyskland
Mangocuahuitl	Mango
Nemachiyōtīlli:Tl	Mall:Mall
Nemachiyōtīlli:Userbox	Mall:Användarbox
Ācamāya	Macrobrachium carcinus
Cualli tepozmalacatl	Mid-size car
Nemachiyōtīlli:Calīxatl:Āxcāncāyōtl	Portal:Huvudsida/Aktuella händelser
Neneuhcāyōtl:Tlācatiyān	Kategori:Världens länder
Huiquipedia:Tētlamahmacanih	Wikipedia:Administratörer
Neneuhcāyōtl:Cazactlālpan	Kategori:Kazakstan
Neneuhcāyōtl:Tīciyōtl	Kategori:Medicin
Neneuhcāyōtl:Cemitquimatiliztli	Kategori:Politik
Neneuhcāyōtl:Tōltēcayōtl	Kategori:Konst
Egipto	Egypten
Nemachiyōtīlli:Bot	Mall:Bot
Canada	Kanada
Neneuhcāyōtl:Hungria	Kategori:Ungern
Neneuhcāyōtl:Belgica	Kategori:Belgien
Neneuhcāyōtl:Chipre	Kategori:Cypern
Neneuhcāyōtl:Chequia	Kategori:Tjeckien
Neneuhcāyōtl:Dinamarca	Kategori:Danmark
Neneuhcāyōtl:Estonia	Kategori:Estland
Neneuhcāyōtl:Fintlālpan	Kategori:Finland
Neneuhcāyōtl:Grecia	Kategori:Grekland
Neneuhcāyōtl:Letonia	Kategori:Lettland
Neneuhcāyōtl:Iztlālpan	Kategori:Island
Neneuhcāyōtl:Luxemburgo	Kategori:Luxemburg
Neneuhcāyōtl:Lituania	Kategori:Litauen
Neneuhcāyōtl:Malta	Kategori:Malta
Neneuhcāyōtl:Suecia	Kategori:Sverige
Neneuhcāyōtl:Eslovaquia	Kategori:Slovakien
Neneuhcāyōtl:Eslovenia	Kategori:Slovenien
Ācocīlin	Acocil
Tetzcohco Mora	Texcoco de Mora
Neneuhcāyōtl:Berlin	Kategori:Berlin
Neneuhcāyōtl:Europan	Kategori:Europa
Nemachiyōtīlli:Documentation	Mall:Dokumentation
Neneuhcāyōtl:Tlatequitiltililli ic tlahtōlli	Kategori:Användare efter språk
Micpāpalōtl	Ascalapha odorata
Nemachiyōtīlli:Softredirect	Mall:Mjuk omdirigering
Nemachiyōtīlli:Destruir	Mall:Radera
Ezxococuahuitl	Granatäpplen
Neneuhcāyōtl:Tlahtōlli	Kategori:Språk
Tlazohmatiliztlācatl	Filosof
Neneuhcāyōtl:Huiquipedia	Kategori:Wikipedia
Huiquipedia:General disclaimer	Wikipedia:Allmänt förbehåll
Topozan	Buddleja americana
Huiquipedia:MediaWiki custom messages	Wikipedia:Meddelandemall
Huiquipedia:Manual de estilo	Wikipedia:Stilguide
Nemachiyōtīlli:Navbox	Mall:Navbox
Nemachiyōtīlli:Tlahuiltequiliztli	Mall:Genväg
Āhuexōtl	Salix bonplandiana
Quetzalhuexōtl	Salix lasiolepis
Ayohtli	Pumpasläktet
Eleanor Put Your Boots On	Eleanor Put Your Boots On
Nemachiyōtīlli:!	Mall:!
Nemachiyōtīlli:Tnavbar	Mall:Navbar
Nemachiyōtīlli:Col-break	Mall:Col-break
Nemachiyōtīlli:Col-begin	Mall:Col-begin
Nemachiyōtīlli:Col-end	Mall:Col-end
Neneuhcāyōtl:Africa	Kategori:Afrika
Neneuhcāyōtl:Tlachicōnti	Kategori:Juli
Neneuhcāyōtl:Tlachicuazti	Kategori:Juni
Nemachiyōtīlli:Babel	Mall:Babel
Nemachiyōtīlli:Commons	Mall:Commons
Nemachiyōtīlli:Link GA	Mall:Link GA
Nemachiyōtīlli:AFG	Mall:AFG
Nemachiyōtīlli:Tzīmpēhualiztli	Mall:Stub
Nemachiyōtīlli:Tlatequitiltilīlli af-1	Mall:Användare af-1
Nemachiyōtīlli:Tlatequitiltilīlli ast-1	Mall:Användare ast-1
Nemachiyōtīlli:Tlatequitiltilīlli eo-1	Mall:Användare eo-1
Nemachiyōtīlli:Tlatequitiltilīlli ca-1	Mall:Användare ca-1
Nemachiyōtīlli:Tlatequitiltilīlli ca-4	Mall:Användare ca-4
Nemachiyōtīlli:Tlatequitiltilīlli eo-3	Mall:Användare eo-3
Nemachiyōtīlli:Tlatequitiltilīlli de	Mall:Användare de
Nemachiyōtīlli:Tlatequitiltilīlli de-1	Mall:Användare de-1
Nemachiyōtīlli:Tlatequitiltililli eu-4	Mall:Användare eu-4
Nemachiyōtīlli:Tlatequitiltilīlli es	Mall:Användare es
Nemachiyōtīlli:Tlatequitiltilīlli de-3	Mall:Användare de-3
Nemachiyōtīlli:Tlatequitiltilīlli en-3	Mall:Användare en-3
Nemachiyōtīlli:Tlatequitiltilīlli en-1	Mall:Användare en-1
Nemachiyōtīlli:Tlatequitiltilīlli en-2	Mall:Användare en-2
Nemachiyōtīlli:Tlatequitiltilīlli eo-2	Mall:Användare eo-2
Nemachiyōtīlli:Tlatequitiltilīlli en-4	Mall:Användare en-4
Nemachiyōtīlli:Tlatequitiltilīlli en-0	Mall:Användare en-0
Nemachiyōtīlli:Tlatequitiltilīlli en	Mall:Användare en
Nemachiyōtīlli:Tlatequitiltilīlli de-2	Mall:Användare de-2
Nemachiyōtīlli:Tlatequitiltilīlli es-1	Mall:Användare es-1
Nemachiyōtīlli:Tlatequitiltilīlli fi-1	Mall:Användare fi-1
Nemachiyōtīlli:Tlatequitiltilīlli fr-1	Mall:Användare fr-1
Nemachiyōtīlli:Tlatequitiltilīlli it-3	Mall:Användare it-3
Nemachiyōtīlli:Tlatequitiltilīlli tr	Mall:Användare tr
Nemachiyōtīlli:Tlatequitiltilīlli ja-1	Mall:Användare ja-1
Nemachiyōtīlli:Tlatequitiltilīlli it-1	Mall:Användare it-1
Nemachiyōtīlli:Tlatequitiltilīlli fr	Mall:Användare fr
Cualtzin tepozmalacatl	Lyxbil
Cuzco	Cusco
Cōztictepētzaucxōchitl	Govenia superba
Neneuhcāyōtl:Tlaōnti	Kategori:Februari
Neneuhcāyōtl:Moldova	Kategori:Moldavien
Nemachiyōtīlli:HRV	Mall:HRV
Neneuhcāyōtl:Azerbaiyan	Kategori:Azerbajdzjan
Neneuhcāyōtl:Asia	Kategori:Asien
Neneuhcāyōtl:Chile	Kategori:Chile
Neneuhcāyōtl:Mācuīlpōhualxihuitl XXI	Kategori:2000-talet
Neneuhcāyōtl:Lesoto	Kategori:Lesotho
Neneuhcāyōtl:Huiquipedia:Plantillas de mantenimiento	Kategori:Åtgärdsmallar
Neneuhcāyōtl:Tlatequitiltilīlli uk	Kategori:Användare uk
Neneuhcāyōtl:Ixachitlān Huitztlāmpa	Kategori:Sydamerika
Neneuhcāyōtl:Caxtillah īhuān León	Kategori:Kastilien och Leon
Neneuhcāyōtl:Tlatequitiltilīlli uk-N	Kategori:Användare uk-N
Nemachiyōtīlli:Esoteric	Mall:Komplicerad kod
Neneuhcāyōtl:Malasia	Kategori:Malaysia
Neneuhcāyōtl:Tlacualli	Kategori:Mat
Nemachiyōtīlli:Mod	Mall:Mod
Nemachiyōtīlli:SIL	Mall:Språk/kodlista
Nemachiyōtīlli:Tlatequitiltilīlli it	Mall:Användare it
Nemachiyōtīlli:Tlatequitiltilīlli uk	Mall:Användare uk
Nemachiyōtīlli:Tlatequitiltilīlli es-2	Mall:Användare es-2
Neneuhcāyōtl:Mētztli	Kategori:Månen
Nemachiyōtīlli:USA	Mall:USA
Neneuhcāyōtl:Tlahtōlmatiliztli	Kategori:Lingvistik
Nemachiyōtīlli:ITA	Mall:ITA
Nemachiyōtīlli:GEO	Mall:GEO
Nemachiyōtīlli:MEX	Mall:MEX
Neneuhcāyōtl:Tlatequitiltilīlli fr-1	Kategori:Användare fr-1
Nemachiyōtīlli:Image label	Mall:Image label
Nemachiyōtīlli:MAR	Mall:MAR
Nemachiyōtīlli:MAD	Mall:MAD
Nemachiyōtīlli:Ixiptlaltic tliltetl	Mall:Geografiskt läge
Nemachiyōtīlli:KGZ	Mall:KGZ
Nemachiyōtīlli:ISR	Mall:ISR
Nemachiyōtīlli:STP	Mall:STP
Nemachiyōtīlli:VEN	Mall:VEN
Nemachiyōtīlli:UKR	Mall:UKR
Nemachiyōtīlli:TUR	Mall:TUR
Nemachiyōtīlli:DJI	Mall:DJI
Nemachiyōtīlli:Tlatequitiltilīlli es-0	Mall:Användare es-0
Nemachiyōtīlli:Featured article	Mall:Utmärkt
Neneuhcāyōtl:Ōtlācatqueh xiuhpan 1875	Kategori:Födda 1875
Neneuhcāyōtl:Ghana	Kategori:Ghana
Neneuhcāyōtl:Paris	Kategori:Paris
Neneuhcāyōtl:Tlatequitiltilīlli en-4	Kategori:Användare en-4
Neneuhcāyōtl:Togo	Kategori:Togo
Neneuhcāyōtl:Tlatequitiltilīlli en	Kategori:Användare en
Neneuhcāyōtl:Tlatequitiltilīlli zh	Kategori:Användare zh
Neneuhcāyōtl:Croacia	Kategori:Kroatien
Neneuhcāyōtl:Tlatequitiltilīlli en-2	Kategori:Användare en-2
Nemachiyōtīlli:Tlatequitiltilīlli eo	Mall:Användare eo
Neneuhcāyōtl:Machiyōtlahtōltecpantiliztli	Kategori:Alfabet
Nemachiyōtīlli:Legend	Mall:Legend
Neneuhcāyōtl:Neneuhcāyōtl īpampa tlācatiyān	Kategori:Kategorier efter land
Nemachiyōtīlli:Tlàltikpakmatilòtl	Mall:Landsdata
Neneuhcāyōtl:Āltepētl īpan Turquia	Kategori:Orter i Turkiet
Nemachiyōtīlli:GeoTemplate	Mall:GeoTemplate
Nemachiyōtīlli:Coor URL	Mall:Coor URL
Nemachiyōtīlli:Tlatequitiltilīlli nl-1	Mall:Användare nl-1
Nemachiyōtīlli:Min	Mall:Lägsta
Nemachiyōtīlli:Wikispecies	Mall:Wikispecies
Neneuhcāyōtl:Rosaceae	Kategori:Rosaceae
Nemachiyōtīlli:Tlatequitiltilīlli ru	Mall:Användare ru
Neneuhcāyōtl:Mācuīlpōhualxihuitl XX	Kategori:1900-talet
Nemachiyōtīlli:Occetlatequitil4	Mall:Hänvisning
Neneuhcāyōtl:Chinatibettlahtōlli	Kategori:Sinotibetanska språk
Nemachiyōtīlli:USATlahtohcātēīxiptla	Mall:USA:s presidenter
Neneuhcāyōtl:Wikipedia:Plantillas Babel	Kategori:Babelmallar
Nemachiyōtīlli:LangWithName	Mall:LangWithName
Neneuhcāyōtl:Āltepētl īpan Marruecos	Kategori:Orter i Marocko
Nemachiyōtīlli:Mācēhualcalpōlli	Mall:Folkgrupp
Nemachiyōtīlli:CPV	Mall:CPV
Nemachiyōtīlli:Tlatequitiltilīlli eo-4	Mall:Användare eo-4
Neneuhcāyōtl:Ōtlācatqueh xiuhpan 1879	Kategori:Födda 1879
Neneuhcāyōtl:1955 tlācatiliztli	Kategori:Födda 1955
Neneuhcāyōtl:1963 tlācatiliztli	Kategori:Födda 1963
Neneuhcāyōtl:Ōtlācatqueh xiuhpan 1812	Kategori:Födda 1812
Neneuhcāyōtl:Ōtlācatqueh xiuhpan 1829	Kategori:Födda 1829
Neneuhcāyōtl:Ōtlācatqueh xiuhpan 1998	Kategori:Födda 1998
Neneuhcāyōtl:Ōtlācatqueh xiuhpan 1834	Kategori:Födda 1834
Neneuhcāyōtl:Ōmicqueh xiuhpan 1417	Kategori:Avlidna 1417
Neneuhcāyōtl:Malpighiales	Kategori:Malpighiales
Neneuhcāyōtl:Mācuīlpōhualxihuitl XIX	Kategori:1800-talet
Neneuhcāyōtl:Tlahcuilōni	Kategori:Författare
Neneuhcāyōtl:Tlacēnti	Kategori:Januari
Nemachiyōtīlli:GTM	Mall:GUA
Nemachiyōtīlli:MYS	Mall:MAS
Nemachiyōtīlli:PLW	Mall:PLW
Nemachiyōtīlli:TJK	Mall:TJK
Nemachiyōtīlli:Image label end	Mall:Image label end
Nemachiyōtīlli:Tlanitlâkuilòlistli	Mall:Dokumentationssida
Nemachiyōtīlli:GHA	Mall:GHA
Nemachiyōtīlli:DMA	Mall:DMA
Nemachiyōtīlli:ZAF	Mall:RSA
Nemachiyōtīlli:Āxcāyōtl-Tlācatiyān	Mall:Toppdomäner
Nemachiyōtīlli:URY	Mall:URU
Nemachiyōtīlli:CUB	Mall:CUB
Nemachiyōtīlli:CMR	Mall:CMR
Nemachiyōtīlli:CODt	Mall:COD
Nemachiyōtīlli:CAN	Mall:CAN
Nemachiyōtīlli:Tlachipàwalö	Mall:Rensa
Nemachiyōtīlli:FJI	Mall:FIJ
Nemachiyōtīlli:SAU	Mall:SAU
Nemachiyōtīlli:BEN	Mall:BEN
Nemachiyōtīlli:YEM	Mall:YEM
Xiuhquilipitzāhuac (tlapālli)	Indigo (färg)
Nemachiyōtīlli:Image label small	Mall:Image label small
Neneuhcāyōtl:Āltepētl īpan Colombia	Kategori:Orter i Colombia
Neneuhcāyōtl:Brassicaceae	Kategori:Brassicaceae
Nemachiyōtīlli:Tlatequitiltilīlli fr-3	Mall:Användare fr-3
Neneuhcāyōtl:Caxtillān ītepēhuān	Kategori:Berg i Spanien
Neneuhcāyōtl:Tunez	Kategori:Tunisien
José Olaya	José Olaya
Nemachiyōtīlli:JPN	Mall:JPN
Nemachiyōtīlli:PAN	Mall:PAN
Nemachiyōtīlli:SOM	Mall:SOM
Nemachiyōtīlli:VAT	Mall:VAT
Nemachiyōtīlli:SWZ	Mall:SWZ
Nemachiyōtīlli:Tlatequitiltilīlli nds-1	Mall:Användare nds-1
Neneuhcāyōtl:Āltepētl īpan Xapon	Kategori:Orter i Japan
Neneuhcāyōtl:Cactaceae	Kategori:Cactaceae
Nemachiyōtīlli:ISL	Mall:ISL
Nemachiyōtīlli:MUS	Mall:MRI
Nemachiyōtīlli:COL	Mall:COL
Nemachiyōtīlli:GNB	Mall:GNB
Nemachiyōtīlli:ERI	Mall:ERI
Nemachiyōtīlli:MRT	Mall:MTN
Nemachiyōtīlli:GAB	Mall:GAB
Nemachiyōtīlli:IRN	Mall:IRN
Nemachiyōtīlli:MLI	Mall:MLI
Nemachiyōtīlli:JOR	Mall:JOR
Nemachiyōtīlli:NAM	Mall:NAM
Nemachiyōtīlli:MHL	Mall:MHL
Nemachiyōtīlli:DOM	Mall:DOM
Nemachiyōtīlli:CAF	Mall:CAF
Nemachiyōtīlli:MKD	Mall:MKD
Nemachiyōtīlli:COM	Mall:COM
Nemachiyōtīlli:KAZ	Mall:KAZ
Nemachiyōtīlli:COG	Mall:COG
Nemachiyōtīlli:SMR	Mall:SMR
Nemachiyōtīlli:PER	Mall:PER
Nemachiyōtīlli:SUR	Mall:SUR
Nemachiyōtīlli:GUY	Mall:GUY
Nemachiyōtīlli:ETH	Mall:ETH
Nemachiyōtīlli:NGA	Mall:NGA
Nemachiyōtīlli:PRK	Mall:PRK
Nemachiyōtīlli:FSM	Mall:FSM
Nemachiyōtīlli:KIR	Mall:KIR
Nemachiyōtīlli:NIC	Mall:NIC
Nemachiyōtīlli:PNG	Mall:PNG
Nemachiyōtīlli:LBR	Mall:LBR
Nemachiyōtīlli:TKM	Mall:TKM
Nemachiyōtīlli:NRU	Mall:NRU
Nemachiyōtīlli:THA	Mall:THA
Nemachiyōtīlli:BFA	Mall:BFA
Nemachiyōtīlli:PRY	Mall:PRY
Nemachiyōtīlli:ECU	Mall:ECU
Nemachiyōtīlli:MLV	Mall:MDV
Nemachiyōtīlli:TLS	Mall:TLS
Nemachiyōtīlli:LCA	Mall:LCA
Nemachiyōtīlli:SLE	Mall:SLE
Nemachiyōtīlli:Chicōntonalli	Mall:Veckodagar
Neneuhcāyōtl:Necuiltōnolācalquīxōhuayān	Kategori:Puerto Rico
Neneuhcāyōtl:Tlatequitiltilīlli ja-N	Kategori:Användare ja-N
Neneuhcāyōtl:Tzitzimicītlalli	Kategori:Saturnus
Neneuhcāyōtl:Payīnalcītlalli	Kategori:Merkurius
Neneuhcāyōtl:Āltepētl īpan Tlacetilīlli Tlahtohcāyōtl	Kategori:Orter i USA
Neneuhcāyōtl:Inglatlālpan tlacuīcaliztli	Kategori:Engelska musikgrupper
Neneuhcāyōtl:Malus	Kategori:Äpplen
Neneuhcāyōtl:Ōtlācatqueh xiuhpan 1903	Kategori:Födda 1903
Neneuhcāyōtl:Ōtlācatqueh xiuhpan 1925	Kategori:Födda 1925
Neneuhcāyōtl:Ōtlācatqueh xiuhpan 1936	Kategori:Födda 1936
Neneuhcāyōtl:Ōtlācatqueh xiuhpan 1916	Kategori:Födda 1916
Neneuhcāyōtl:Ōtlācatqueh xiuhpan 1910	Kategori:Födda 1910
Neneuhcāyōtl:Ōtlācatqueh xiuhpan 1939	Kategori:Födda 1939
Nemachiyōtīlli:CHE	Mall:CHE
Neneuhcāyōtl:Poaceae	Kategori:Poaceae
Nemachiyōtīlli:Browsebar	Mall:Browsebar
Nemachiyōtīlli:Roman	Mall:Romerska siffror
Cuapiquiloni	Keps
Nemachiyōtīlli:Tlahtōlmelāhuacātlāliztli	Mall:Förgrening
Neneuhcāyōtl:Suazitlālpan	Kategori:Swaziland
Neneuhcāyōtl:Wikipedia:Fichas	Kategori:Faktamallar
Neneuhcāyōtl:Ōmicqueh xiuhpan 2013	Kategori:Avlidna 2013
Neneuhcāyōtl:1938 tlācatiliztli	Kategori:Födda 1938
Nemachiyōtīlli:LAO	Mall:LAO
Nemachiyōtīlli:PRT	Mall:POR
Nemachiyōtīlli:AUS	Mall:AUS
Nemachiyōtīlli:LVA	Mall:LAT
Nemachiyōtīlli:AZE	Mall:AZE
Nemachiyōtīlli:DZA	Mall:ALG
Neneuhcāyōtl:Teconxinachtli	Kategori:Angiospermae
Nemachiyōtīlli:KHM	Mall:KHM
Nemachiyōtīlli:MNE	Mall:MNE
Nemachiyōtīlli:NLD	Mall:NLD
Nemachiyōtīlli:GBR	Mall:GBR
Nemachiyōtīlli:TUV	Mall:TUV
Nemachiyōtīlli:VNM	Mall:VNM
Nemachiyōtīlli:LIE	Mall:LIE
Nemachiyōtīlli:MDA	Mall:MDA
Neneuhcāyōtl:Āltepētl īpan Panama	Kategori:Orter i Panama
Nemachiyōtīlli:SEN	Mall:SEN
Nemachiyōtīlli:NZL	Mall:NZL
Neneuhcāyōtl:Calmanaliztli	Kategori:Arkitektur
Nemachiyōtīlli:KOR	Mall:KOR
Neneuhcāyōtl:Aztēcah	Kategori:Aztekerna
Nemachiyōtīlli:Tlatequitiltilīlli sv-2	Mall:Användare sv-2
Nemachiyōtīlli:Tlatequitiltilīlli it-2	Mall:Användare it-2
Neneuhcāyōtl:Xālīxcah	Kategori:Personer från Jalisco
Nemachiyōtīlli:Lang-fr	Mall:Lang-fr
Nemachiyōtīlli:LBN	Mall:LIB
Nemachiyōtīlli:FRA	Mall:FRA
Nemachiyōtīlli:Tlācatl	Mall:Infobox biografi
Neneuhcāyōtl:Mongolia	Kategori:Mongoliet
Nemachiyōtīlli:Tlatequitiltilīlli Francitēcatl	Mall:Användare Frankrike
Neneuhcāyōtl:Āltepētl īpan Andorra	Kategori:Orter i Andorra
Neneuhcāyōtl:Ōtlācatqueh īpan mācuīlpōhualxihuitl XX	Kategori:Födda 1900-talet
Neneuhcāyōtl:Ōtlācatqueh īpan mācuīlpōhualxihuitl XIX	Kategori:Födda 1800-talet
Neneuhcāyōtl:Ōtlācatqueh īpan mācuīlpōhualxihuitl XXI	Kategori:Födda 2000-talet
Neneuhcāyōtl:Ōtlācatqueh īpan mācuīlpōhualxihuitl XVIII	Kategori:Födda 1700-talet
Neneuhcāyōtl:Ōtlācatqueh īpan mācuīlpōhualxihuitl XVII	Kategori:Födda 1600-talet
Neneuhcāyōtl:Ōtlācatqueh īpan mācuīlpōhualxihuitl XVI	Kategori:Födda 1500-talet
Neneuhcāyōtl:Ōtlācatqueh īpan mācuīlpōhualxihuitl XV	Kategori:Födda 1400-talet
Neneuhcāyōtl:Āltepētl īpan Uruguay	Kategori:Orter i Uruguay
Neneuhcāyōtl:Granada (tlācatiyān)	Kategori:Grenada
Neneuhcāyōtl:Calabria	Kategori:Kalabrien
Neneuhcāyōtl:Galicia	Kategori:Galicien
Neneuhcāyōtl:Groentlālpan	Kategori:Grönland
Neneuhcāyōtl:Lamiales	Kategori:Lamiales
Neneuhcāyōtl:Tlācatlahtohcāyōtl Macedonia	Kategori:Makedonien
Neneuhcāyōtl:Tlatequitiltilīlli sco	Kategori:Användare sco
Neneuhcāyōtl:Tlatequitiltilīlli sl	Kategori:Användare sl
Neneuhcāyōtl:Tlatequitiltilīlli eo	Kategori:Användare eo
Neneuhcāyōtl:Tlatequitiltilīlli et	Kategori:Användare et
Neneuhcāyōtl:Tlatequitiltilīlli fr	Kategori:Användare fr
Neneuhcāyōtl:Tlatequitiltilīlli gl	Kategori:Användare gl
Neneuhcāyōtl:Tlatequitiltilīlli ia	Kategori:Användare ia
Neneuhcāyōtl:Tlatequitiltilīlli ja	Kategori:Användare ja
Neneuhcāyōtl:Tlatequitiltilīlli la	Kategori:Användare la
Neneuhcāyōtl:Tlatequitiltilīlli li	Kategori:Användare li
Neneuhcāyōtl:Tlatequitiltilīlli lt	Kategori:Användare lt
Neneuhcāyōtl:Tlatequitiltilīlli nn	Kategori:Användare nn
Neneuhcāyōtl:Tlatequitiltilīlli pt	Kategori:Användare pt
Neneuhcāyōtl:Tlatequitiltilīlli ro	Kategori:Användare ro
Neneuhcāyōtl:Tlatequitiltilīlli sv	Kategori:Användare sv
Neneuhcāyōtl:Tlatequitiltilīlli fr-3	Kategori:Användare fr-3
Neneuhcāyōtl:Tlatequitiltilīlli it-3	Kategori:Användare it-3
Neneuhcāyōtl:Tlatequitiltilīlli ja-3	Kategori:Användare ja-3
Neneuhcāyōtl:Tlatequitiltilīlli tr-3	Kategori:Användare tr-3
Neneuhcāyōtl:Tlatequitiltilīlli ar-3	Kategori:Användare ar-3
Neneuhcāyōtl:Tlatequitiltilīlli an-1	Kategori:Användare an-1
Neneuhcāyōtl:Tlatequitiltilīlli da-1	Kategori:Användare da-1
Neneuhcāyōtl:Tlatequitiltilīlli sco-1	Kategori:Användare sco-1
Neneuhcāyōtl:Tlatequitiltilīlli et-1	Kategori:Användare et-1
Neneuhcāyōtl:Tlatequitiltilīlli fi-1	Kategori:Användare fi-1
Neneuhcāyōtl:Tlatequitiltilīlli nl-1	Kategori:Användare nl-1
Neneuhcāyōtl:Tlatequitiltilīlli tr-1	Kategori:Användare tr-1
Neneuhcāyōtl:Tlatequitiltilīlli ar-1	Kategori:Användare ar-1
Neneuhcāyōtl:Tlatequitiltilīlli fr-4	Kategori:Användare fr-4
Neneuhcāyōtl:Tlatequitiltilīlli it-4	Kategori:Användare it-4
Neneuhcāyōtl:Tlatequitiltilīlli da-2	Kategori:Användare da-2
Neneuhcāyōtl:Tlatequitiltilīlli fr-2	Kategori:Användare fr-2
Neneuhcāyōtl:Tlatequitiltilīlli ia-2	Kategori:Användare ia-2
Neneuhcāyōtl:Tlatequitiltilīlli it-2	Kategori:Användare it-2
Neneuhcāyōtl:Tlatequitiltilīlli ja-2	Kategori:Användare ja-2
Neneuhcāyōtl:Tlatequitiltilīlli la-2	Kategori:Användare la-2
Neneuhcāyōtl:Tlatequitiltilīlli pl-2	Kategori:Användare pl-2
Neneuhcāyōtl:Tlatequitiltilīlli sv-2	Kategori:Användare sv-2
Neneuhcāyōtl:Tlatequitiltilīlli ar-2	Kategori:Användare ar-2
Neneuhcāyōtl:Tlatequitiltilīlli ast-N	Kategori:Användare ast-N
Neneuhcāyōtl:Tlatequitiltilīlli sl-N	Kategori:Användare sl-N
Neneuhcāyōtl:Tlatequitiltilīlli fr-N	Kategori:Användare fr-N
Neneuhcāyōtl:Tlatequitiltilīlli gl-N	Kategori:Användare gl-N
Neneuhcāyōtl:Tlatequitiltilīlli is-N	Kategori:Användare is-N
Neneuhcāyōtl:Tlatequitiltilīlli it-N	Kategori:Användare it-N
Neneuhcāyōtl:Tlatequitiltilīlli lt-N	Kategori:Användare lt-N
Neneuhcāyōtl:Tlatequitiltilīlli nl-N	Kategori:Användare nl-N
Neneuhcāyōtl:Tlatequitiltilīlli no-N	Kategori:Användare no-N
Neneuhcāyōtl:Tlatequitiltilīlli ru-N	Kategori:Användare ru-N
Neneuhcāyōtl:Tlatequitiltilīlli ar-N	Kategori:Användare ar-N
Neneuhcāyōtl:Āltepētl īpan Bolivia	Kategori:Orter i Bolivia
Neneuhcāyōtl:Tlatequitiltilīlli eu-3	Kategori:Användare eu-3
Neneuhcāyōtl:Tlatequitiltilīlli eu-N	Kategori:Användare eu-N
Neneuhcāyōtl:Tlatequitiltilīlli af	Kategori:Användare af
Neneuhcāyōtl:Tlatequitiltilīlli af-1	Kategori:Användare af-1
Neneuhcāyōtl:Tlatequitiltilīlli an	Kategori:Användare an
Neneuhcāyōtl:Tlatequitiltilīlli ar	Kategori:Användare ar
Neneuhcāyōtl:Tlatequitiltilīlli ast	Kategori:Användare ast
Neneuhcāyōtl:Tlatequitiltilīlli ast-1	Kategori:Användare ast-1
Neneuhcāyōtl:Tlatequitiltilīlli ast-3	Kategori:Användare ast-3
Neneuhcāyōtl:Tlatequitiltilīlli ca	Kategori:Användare ca
Neneuhcāyōtl:Tlatequitiltilīlli ca-1	Kategori:Användare ca-1
Neneuhcāyōtl:Tlatequitiltilīlli ca-2	Kategori:Användare ca-2
Neneuhcāyōtl:Tlatequitiltilīlli ca-3	Kategori:Användare ca-3
Neneuhcāyōtl:Tlatequitiltilīlli ca-4	Kategori:Användare ca-4
Neneuhcāyōtl:Tlatequitiltilīlli ca-N	Kategori:Användare ca-N
Neneuhcāyōtl:Tlatequitiltilīlli cs	Kategori:Användare cs
Neneuhcāyōtl:Tlatequitiltilīlli da	Kategori:Användare da
Neneuhcāyōtl:Tlatequitiltilīlli da-3	Kategori:Användare da-3
Neneuhcāyōtl:Tlatequitiltilīlli de	Kategori:Användare de
Neneuhcāyōtl:Tlatequitiltilīlli de-2	Kategori:Användare de-2
Neneuhcāyōtl:Tlatequitiltilīlli de-3	Kategori:Användare de-3
Neneuhcāyōtl:Tlatequitiltilīlli de-4	Kategori:Användare de-4
Neneuhcāyōtl:Tlatequitiltilīlli de-N	Kategori:Användare de-N
Neneuhcāyōtl:Tlatequitiltilīlli el	Kategori:Användare el
Neneuhcāyōtl:Tlatequitiltilīlli el-1	Kategori:Användare el-1
Neneuhcāyōtl:Tlatequitiltilīlli el-2	Kategori:Användare el-2
Neneuhcāyōtl:Tlatequitiltilīlli el-3	Kategori:Användare el-3
Neneuhcāyōtl:Tlatequitiltilīlli el-N	Kategori:Användare el-N
Neneuhcāyōtl:Tlatequitiltilīlli en-0	Kategori:Användare en-0
Neneuhcāyōtl:Tlatequitiltilīlli en-3	Kategori:Användare en-3
Neneuhcāyōtl:Tlatequitiltilīlli en-N	Kategori:Användare en-N
Neneuhcāyōtl:Tlatequitiltilīlli eo-1	Kategori:Användare eo-1
Neneuhcāyōtl:Tlatequitiltilīlli eo-2	Kategori:Användare eo-2
Neneuhcāyōtl:Tlatequitiltilīlli eo-3	Kategori:Användare eo-3
Neneuhcāyōtl:Tlatequitiltilīlli eo-4	Kategori:Användare eo-4
Neneuhcāyōtl:Tlatequitiltilīlli eo-N	Kategori:Användare eo-N
Neneuhcāyōtl:Tlatequitiltilīlli es	Kategori:Användare es
Neneuhcāyōtl:Tlatequitiltilīlli es-1	Kategori:Användare es-1
Neneuhcāyōtl:Tlatequitiltilīlli es-2	Kategori:Användare es-2
Neneuhcāyōtl:Tlatequitiltilīlli es-3	Kategori:Användare es-3
Neneuhcāyōtl:Tlatequitiltilīlli es-4	Kategori:Användare es-4
Neneuhcāyōtl:Tlatequitiltilīlli es-N	Kategori:Användare es-N
Neneuhcāyōtl:Santo Tomé īhuān Tlahtohcāpilli	Kategori:São Tomé och Príncipe
Neneuhcāyōtl:Tlatequitiltilīlli eu	Kategori:Användare eu
Neneuhcāyōtl:Tlatequitiltilīlli eu-1	Kategori:Användare eu-1
Neneuhcāyōtl:Tlatequitiltilīlli eu-2	Kategori:Användare eu-2
Neneuhcāyōtl:Tlatequitiltilīlli eu-4	Kategori:Användare eu-4
Neneuhcāyōtl:Tlatequitiltilīlli fi	Kategori:Användare fi
Neneuhcāyōtl:Tlatequitiltilīlli fi-2	Kategori:Användare fi-2
Neneuhcāyōtl:Tlatequitiltilīlli fi-3	Kategori:Användare fi-3
Neneuhcāyōtl:Tlatequitiltilīlli fi-4	Kategori:Användare fi-4
Neneuhcāyōtl:Tlatequitiltilīlli fi-N	Kategori:Användare fi-N
Neneuhcāyōtl:Tlatequitiltilīlli io	Kategori:Användare io
Neneuhcāyōtl:Tlatequitiltilīlli io-3	Kategori:Användare io-3
Neneuhcāyōtl:Tlatequitiltilīlli is	Kategori:Användare is
Neneuhcāyōtl:Tlatequitiltilīlli is-1	Kategori:Användare is-1
Neneuhcāyōtl:Tlatequitiltilīlli is-2	Kategori:Användare is-2
Neneuhcāyōtl:Tlatequitiltilīlli is-3	Kategori:Användare is-3
Neneuhcāyōtl:Āltepētl īpan Chiyapan	Kategori:Orter i Chiapas
Neneuhcāyōtl:Tlahtohcāyōtl Mēxihco	Kategori:Delstaten Mexiko
Neneuhcāyōtl:Āltepētl īpan Tlahtohcāyōtl Mēxihco	Kategori:Orter i Mexiko (delstat)
Neneuhcāyōtl:Tlatequitiltilīlli pt-3	Kategori:Användare pt-3
Neneuhcāyōtl:Tlatequitiltilīlli pt-1	Kategori:Användare pt-1
Neneuhcāyōtl:Huehuehmēxihcayōtl	Kategori:Gudar i aztekisk mytologi
Neneuhcāyōtl:Āltepētl īpan Argelia	Kategori:Städer i Algeriet
Neneuhcāyōtl:Tlatequitiltilīlli it	Kategori:Användare it
Neneuhcāyōtl:Tlatequitiltilīlli it-1	Kategori:Användare it-1
Neneuhcāyōtl:Tlatequitiltilīlli ja-1	Kategori:Användare ja-1
Neneuhcāyōtl:Malvaceae	Kategori:Malvaceae
Neneuhcāyōtl:Tlatequitiltilīlli ko	Kategori:Användare ko
Neneuhcāyōtl:Tlatequitiltilīlli ko-3	Kategori:Användare ko-3
Neneuhcāyōtl:Tlatequitiltilīlli ksh	Kategori:Användare ksh
Neneuhcāyōtl:Tlatequitiltilīlli ksh-N	Kategori:Användare ksh-N
Neneuhcāyōtl:Tlatequitiltilīlli la-1	Kategori:Användare la-1
Neneuhcāyōtl:Tlatequitiltilīlli lb	Kategori:Användare lb
Nemachiyōtīlli:Tomīn	Mall:Valuta
Neneuhcāyōtl:Ōmicqueh xiuhpan 1585	Kategori:Avlidna 1585
Neneuhcāyōtl:Ōmicqueh xiuhpan 1521	Kategori:Avlidna 1521
Neneuhcāyōtl:Ōmicqueh xiuhpan 1536	Kategori:Avlidna 1536
Neneuhcāyōtl:Āltepētl īpan Grecia	Kategori:Orter i Grekland
Neneuhcāyōtl:Fabales	Kategori:Fabales
Neneuhcāyōtl:Āltepētl īpan Chile	Kategori:Chiles kommuner
Nemachiyōtīlli:BRA	Mall:BRA
Neneuhcāyōtl:Catolicismo Romano	Kategori:Romersk-katolska kyrkan
Neneuhcāyōtl:Tlamahtlāccēti	Kategori:November
Neneuhcāyōtl:Westlife	Kategori:Westlife
Neneuhcāyōtl:Iglesia Anglicana	Kategori:Episkopalism
Neneuhcāyōtl:Ōmicqueh xiuhpan 1793	Kategori:Avlidna 1793
Neneuhcāyōtl:Ōmicqueh xiuhpan 1931	Kategori:Avlidna 1931
Neneuhcāyōtl:Ōmicqueh xiuhpan 1827	Kategori:Avlidna 1827
Neneuhcāyōtl:Tlatequitiltilīlli ru-1	Kategori:Användare ru-1
Huiquipedia:Babel	Wikipedia:Babel
Nemachiyōtīlli:Tlatequitiltilīlli sv-1	Mall:Användare sv-1
Neneuhcāyōtl:Caryophyllaceae	Kategori:Caryophyllaceae
Neneuhcāyōtl:Tlayēti	Kategori:Mars (månad)
Neneuhcāyōtl:Tlachiucnāuhti	Kategori:September
Nemachiyōtīlli:TUN	Mall:TUN
Neneuhcāyōtl:Tlamahtlācti	Kategori:Oktober
Neneuhcāyōtl:Āltepētl īpan Cōzcatlān	Kategori:Orter i El Salvador
Neneuhcāyōtl:Latinmachiyōtlahtōltecpantiliztli	Kategori:Latinska alfabetet
Neneuhcāyōtl:Ōtlācatqueh xiuhpan 1906	Kategori:Födda 1906
Neneuhcāyōtl:Āltepētl īpan Polonia	Kategori:Städer i Polen
Neneuhcāyōtl:Tlamahtlācōnti	Kategori:December
Neneuhcāyōtl:Tlachicuēiti	Kategori:Augusti
Neneuhcāyōtl:Tlamācuīlti	Kategori:Maj
Nemachiyōtīlli:Tlatequitiltilīlli Mēxihco	Mall:Användare Mexiko
Neneuhcāyōtl:Fabaceae	Kategori:Fabaceae
Neneuhcāyōtl:Mirconesia	Kategori:Mikronesiens federerade stater
Neneuhcāyōtl:Solanaceae	Kategori:Solanaceae
Neneuhcāyōtl:Inglatlālpan	Kategori:England
Neneuhcāyōtl:Machiyōtlahcuilōlli	Kategori:Typografi
Neneuhcāyōtl:Tlanāuhti	Kategori:April
Neneuhcāyōtl:Ōmicqueh xiuhpan 2009	Kategori:Avlidna 2009
Neneuhcāyōtl:Rutaceae	Kategori:Rutaceae
Nemachiyōtīlli:Lang-it	Mall:Lang-it
Neneuhcāyōtl:Tlatequitiltilīlli nds	Kategori:Användare nds
Neneuhcāyōtl:Tlatequitiltilīlli nds-1	Kategori:Användare nds-1
Nemachiyōtīlli:LUX	Mall:LUX
Neneuhcāyōtl:Tōnatiuh īchān	Kategori:Solsystemet
Neneuhcāyōtl:Dominicanatlācatlahtohcāyōtl	Kategori:Dominikanska republiken
Neneuhcāyōtl:Agavaceae	Kategori:Agavaceae
Neneuhcāyōtl:Lythraceae	Kategori:Fackelblomsväxter
Neneuhcāyōtl:Ebenaceae	Kategori:Ebenaceae
Neneuhcāyōtl:Ōmicqueh xiuhpan 1321	Kategori:Avlidna 1321
Neneuhcāyōtl:Arecaceae	Kategori:Arecaceae
Neneuhcāyōtl:Ōtlācatqueh xiuhpan 1983	Kategori:Födda 1983
Nemachiyōtīlli:TON	Mall:TGA
Neneuhcāyōtl:Ōmicqueh xiuhpan 1992	Kategori:Avlidna 1992
Neneuhcāyōtl:Ōtlācatqueh xiuhpan 1992	Kategori:Födda 1992
Neneuhcāyōtl:Ōmicqueh xiuhpan 1980	Kategori:Avlidna 1980
Neneuhcāyōtl:Ōmicqueh xiuhpan 2008	Kategori:Avlidna 2008
Neneuhcāyōtl:Ōmicqueh xiuhpan 1986	Kategori:Avlidna 1986
Neneuhcāyōtl:Ōmicqueh xiuhpan 1966	Kategori:Avlidna 1966
Neneuhcāyōtl:Ōtlācatqueh xiuhpan 1984	Kategori:Födda 1984
Neneuhcāyōtl:Ōmicqueh xiuhpan 1959	Kategori:Avlidna 1959
Neneuhcāyōtl:Ōtlācatqueh xiuhpan 1990	Kategori:Födda 1990
Neneuhcāyōtl:Ōmicqueh xiuhpan 1949	Kategori:Avlidna 1949
Neneuhcāyōtl:Ōtlācatqueh xiuhpan 1974	Kategori:Födda 1974
Neneuhcāyōtl:Ōmicqueh xiuhpan 1947	Kategori:Avlidna 1947
Neneuhcāyōtl:Ōmicqueh xiuhpan 2007	Kategori:Avlidna 2007
Neneuhcāyōtl:1965 tlācatiliztli	Kategori:Födda 1965
Neneuhcāyōtl:1940 tlācatiliztli	Kategori:Födda 1940
Neneuhcāyōtl:Ōtlācatqueh xiuhpan 1898	Kategori:Födda 1898
Neneuhcāyōtl:Ōtlācatqueh xiuhpan 1863	Kategori:Födda 1863
Neneuhcāyōtl:Ōtlācatqueh xiuhpan 1867	Kategori:Födda 1867
Neneuhcāyōtl:Ōtlācatqueh xiuhpan 1871	Kategori:Födda 1871
Neneuhcāyōtl:Ōtlācatqueh xiuhpan 1977	Kategori:Födda 1977
Neneuhcāyōtl:1899 tlācatiliztli	Kategori:Födda 1899
Neneuhcāyōtl:1931 tlācatiliztli	Kategori:Födda 1931
Neneuhcāyōtl:1915 tlācatiliztli	Kategori:Födda 1915
Neneuhcāyōtl:1929 tlācatiliztli	Kategori:Födda 1929
Neneuhcāyōtl:Orchidaceae	Kategori:Orkidéer
Neneuhcāyōtl:Iridaceae	Kategori:Irisväxter
Neneuhcāyōtl:Magnoliaceae	Kategori:Magnoliaceae
Neneuhcāyōtl:Asteraceae	Kategori:Asteraceae
Neneuhcāyōtl:Anacardiaceae	Kategori:Anacardiaceae
Neneuhcāyōtl:Asparagales	Kategori:Asparagales
Neneuhcāyōtl:Lauraceae	Kategori:Lauraceae
Neneuhcāyōtl:Laurales	Kategori:Laurales
Neneuhcāyōtl:Salicaceae	Kategori:Videväxter
Neneuhcāyōtl:1954 tlācatiliztli	Kategori:Födda 1954
Neneuhcāyōtl:1990s tlacuīcaliztli	Kategori:Födda 1990-talet
Neneuhcāyōtl:1980s tlacuīcaliztli	Kategori:Födda 1980-talet
Neneuhcāyōtl:Belarus	Kategori:Vitryssland
Neneuhcāyōtl:1960 tlācatiliztli	Kategori:Födda 1960
Neneuhcāyōtl:Altepetl ipan Mexico	Kategori:Mexico City
Neneuhcāyōtl:Ōmicqueh xiuhpan 1993	Kategori:Avlidna 1993
Neneuhcāyōtl:Ōmicqueh xiuhpan 1998	Kategori:Avlidna 1998
Neneuhcāyōtl:Āltepētl īpan São Paulo	Kategori:Orter i São Paulo (delstat)
Neneuhcāyōtl:1951 tlācatiliztli	Kategori:Födda 1951
Neneuhcāyōtl:Ōmicqueh xiuhpan 1883	Kategori:Avlidna 1883
Neneuhcāyōtl:Ōtlācatqueh xiuhpan 1265	Kategori:Födda 1265
Neucpahtli	Sockerlag
Neneuhcāyōtl:Ōtlācatqueh xiuhpan 1397	Kategori:Födda 1397
Neneuhcāyōtl:Ōtlācatqueh xiuhpan 1398	Kategori:Födda 1398
Nemachiyōtīlli:Tlatequitiltilīlli cs	Mall:Användare cs
Nemachiyōtīlli:Tlatequitiltilīlli ru-2	Mall:Användare ru-2
Neneuhcāyōtl:Chīchīlcītlalli	Kategori:Mars
Neneuhcāyōtl:Catōlicoquīxtianayōtl	Kategori:Katolicism
Neneuhcāyōtl:Ōmicqueh xiuhpan 1440	Kategori:Avlidna 1440
Neneuhcāyōtl:Ōmicqueh xiuhpan 1469	Kategori:Avlidna 1469
Neneuhcāyōtl:Ōtlācatqueh xiuhpan 1474	Kategori:Födda 1474
Neneuhcāyōtl:Ōtlācatqueh xiuhpan 1479	Kategori:Födda 1479
Neneuhcāyōtl:Tlatequitiltilīlli pt-2	Kategori:Användare pt-2
Neneuhcāyōtl:Tlatequitiltilīlli pt-N	Kategori:Användare pt-N
Neneuhcāyōtl:Tlatequitiltilīlli qu	Kategori:Användare qu
Neneuhcāyōtl:Ōmicqueh xiuhpan 1486	Kategori:Avlidna 1486
Neneuhcāyōtl:Tlatequitiltilīlli ro-N	Kategori:Användare ro-N
Neneuhcāyōtl:Tlatequitiltilīlli ru	Kategori:Användare ru
Neneuhcāyōtl:Tlatequitiltilīlli ru-2	Kategori:Användare ru-2
Neneuhcāyōtl:Tlatequitiltilīlli ru-3	Kategori:Användare ru-3
Neneuhcāyōtl:Ōmicqueh xiuhpan 1502	Kategori:Avlidna 1502
Neneuhcāyōtl:Ōmicqueh xiuhpan 1520	Kategori:Avlidna 1520
Neneuhcāyōtl:Ōmicqueh xiuhpan 1526	Kategori:Avlidna 1526
Neneuhcāyōtl:Ōmicqueh xiuhpan 1529	Kategori:Avlidna 1529
Neneuhcāyōtl:Ōtlācatqueh xiuhpan 1532	Kategori:Födda 1532
Neneuhcāyōtl:Tlatequitiltilīlli sv-1	Kategori:Användare sv-1
Neneuhcāyōtl:Tlatequitiltilīlli sv-3	Kategori:Användare sv-3
Neneuhcāyōtl:Tlatequitiltilīlli sv-N	Kategori:Användare sv-N
Neneuhcāyōtl:Ōmicqueh xiuhpan 1548	Kategori:Avlidna 1548
Neneuhcāyōtl:Ōmicqueh xiuhpan 1554	Kategori:Avlidna 1554
Neneuhcāyōtl:Ōmicqueh xiuhpan 1562	Kategori:Avlidna 1562
Neneuhcāyōtl:Ōmicqueh xiuhpan 1565	Kategori:Avlidna 1565
Neneuhcāyōtl:Ōtlācatqueh xiuhpan 1566	Kategori:Födda 1566
Neneuhcāyōtl:Ōmicqueh xiuhpan 1571	Kategori:Avlidna 1571
Neneuhcāyōtl:Ōtlācatqueh xiuhpan 1572	Kategori:Födda 1572
Neneuhcāyōtl:Tlatequitiltilīlli tr	Kategori:Användare tr
Neneuhcāyōtl:Tlatequitiltilīlli tr-4	Kategori:Användare tr-4
Neneuhcāyōtl:Tlatequitiltilīlli tr-N	Kategori:Användare tr-N
Neneuhcāyōtl:Ōmicqueh xiuhpan 1639	Kategori:Avlidna 1639
Nemachiyōtīlli:En	Mall:En ikon
Neneuhcāyōtl:Ōtlācatqueh xiuhpan 1713	Kategori:Födda 1713
Neneuhcāyōtl:Cuīcatiani	Kategori:Musiker
Nemachiyōtīlli:Lang	Mall:Lang
Neneuhcāyōtl:Ōmicqueh xiuhpan 1969	Kategori:Avlidna 1969
Neneuhcāyōtl:Ōtlācatqueh xiuhpan 1881	Kategori:Födda 1881
Neneuhcāyōtl:Āltepētl īpan Francia	Kategori:Frankrikes kommuner
Neneuhcāyōtl:1944 tlācatiliztli	Kategori:Födda 1944
Neneuhcāyōtl:1932 tlācatiliztli	Kategori:Födda 1932
Neneuhcāyōtl:1934 tlācatiliztli	Kategori:Födda 1934
Neneuhcāyōtl:1935 tlācatiliztli	Kategori:Födda 1935
Neneuhcāyōtl:1941 tlācatiliztli	Kategori:Födda 1941
Neneuhcāyōtl:Ōtlācatqueh īpan mācuīlpōhualxihuitl XIII	Kategori:Födda 1200-talet
Neneuhcāyōtl:Ōtlācatqueh īpan mācuīlpōhualxihuitl XIV	Kategori:Födda 1300-talet
Nemachiyōtīlli:IRL	Mall:IRL
Neneuhcāyōtl:Ōtlācatqueh xiuhpan 1667	Kategori:Födda 1667
Neneuhcāyōtl:Ōtlācatqueh xiuhpan 1729	Kategori:Födda 1729
Neneuhcāyōtl:Ōtlācatqueh xiuhpan 1730	Kategori:Födda 1730
Neneuhcāyōtl:Ōtlācatqueh xiuhpan 1731	Kategori:Födda 1731
Neneuhcāyōtl:1732 tlācatiliztli	Kategori:Födda 1732
Neneuhcāyōtl:Ōtlācatqueh xiuhpan 1756	Kategori:Födda 1756
Neneuhcāyōtl:Ōtlācatqueh xiuhpan 1768	Kategori:Födda 1768
Neneuhcāyōtl:Ōtlācatqueh xiuhpan 1776	Kategori:Födda 1776
Neneuhcāyōtl:Ōtlācatqueh xiuhpan 1792	Kategori:Födda 1792
Neneuhcāyōtl:Ōtlācatqueh xiuhpan 1806	Kategori:Födda 1806
Neneuhcāyōtl:Ōtlācatqueh xiuhpan 1818	Kategori:Födda 1818
Neneuhcāyōtl:Ōtlācatqueh xiuhpan 1820	Kategori:Födda 1820
Neneuhcāyōtl:Ōtlācatqueh xiuhpan 1828	Kategori:Födda 1828
Neneuhcāyōtl:Ōtlācatqueh xiuhpan 1830	Kategori:Födda 1830
Neneuhcāyōtl:Ōtlācatqueh xiuhpan 1835	Kategori:Födda 1835
Neneuhcāyōtl:Ōtlācatqueh xiuhpan 1845	Kategori:Födda 1845
Neneuhcāyōtl:Ōtlācatqueh xiuhpan 1848	Kategori:Födda 1848
Neneuhcāyōtl:Ōtlācatqueh xiuhpan 1852	Kategori:Födda 1852
Neneuhcāyōtl:Ōtlācatqueh xiuhpan 1859	Kategori:Födda 1859
Neneuhcāyōtl:Ōtlācatqueh xiuhpan 1872	Kategori:Födda 1872
Neneuhcāyōtl:Ōtlācatqueh xiuhpan 1873	Kategori:Födda 1873
Neneuhcāyōtl:Ōtlācatqueh xiuhpan 1874	Kategori:Födda 1874
Neneuhcāyōtl:Ōtlācatqueh xiuhpan 1876	Kategori:Födda 1876
Neneuhcāyōtl:Ōtlācatqueh xiuhpan 1877	Kategori:Födda 1877
Neneuhcāyōtl:Ōtlācatqueh xiuhpan 1880	Kategori:Födda 1880
Neneuhcāyōtl:Ōtlācatqueh xiuhpan 1882	Kategori:Födda 1882
Neneuhcāyōtl:Ōtlācatqueh xiuhpan 1883	Kategori:Födda 1883
Neneuhcāyōtl:Ōtlācatqueh xiuhpan 1886	Kategori:Födda 1886
Neneuhcāyōtl:Ōtlācatqueh xiuhpan 1890	Kategori:Födda 1890
Neneuhcāyōtl:Ōtlācatqueh xiuhpan 1891	Kategori:Födda 1891
Neneuhcāyōtl:Ōtlācatqueh xiuhpan 1892	Kategori:Födda 1892
Neneuhcāyōtl:Ōtlācatqueh xiuhpan 1893	Kategori:Födda 1893
Neneuhcāyōtl:Ōtlācatqueh xiuhpan 1894	Kategori:Födda 1894
Neneuhcāyōtl:Ōtlācatqueh xiuhpan 1895	Kategori:Födda 1895
Neneuhcāyōtl:Ōtlācatqueh xiuhpan 1896	Kategori:Födda 1896
Neneuhcāyōtl:Ōtlācatqueh xiuhpan 1897	Kategori:Födda 1897
Neneuhcāyōtl:Ōtlācatqueh xiuhpan 1900	Kategori:Födda 1900
Neneuhcāyōtl:Ōtlācatqueh xiuhpan 1901	Kategori:Födda 1901
Neneuhcāyōtl:Ōtlācatqueh xiuhpan 1902	Kategori:Födda 1902
Neneuhcāyōtl:Ōtlācatqueh xiuhpan 1904	Kategori:Födda 1904
Neneuhcāyōtl:Ōtlācatqueh xiuhpan 1905	Kategori:Födda 1905
Neneuhcāyōtl:Ōtlācatqueh xiuhpan 1907	Kategori:Födda 1907
Neneuhcāyōtl:Ōtlācatqueh xiuhpan 1908	Kategori:Födda 1908
Neneuhcāyōtl:1909 tlācatiliztli	Kategori:Födda 1909
Neneuhcāyōtl:1912 tlācatiliztli	Kategori:Födda 1912
Neneuhcāyōtl:1913 tlācatiliztli	Kategori:Födda 1913
Neneuhcāyōtl:1914 tlācatiliztli	Kategori:Födda 1914
Neneuhcāyōtl:1917 tlācatiliztli	Kategori:Födda 1917
Neneuhcāyōtl:1918 tlācatiliztli	Kategori:Födda 1918
Neneuhcāyōtl:1919 tlācatiliztli	Kategori:Födda 1919
Neneuhcāyōtl:1922 tlācatiliztli	Kategori:Födda 1922
Neneuhcāyōtl:1923 tlācatiliztli	Kategori:Födda 1923
Neneuhcāyōtl:1927 tlācatiliztli	Kategori:Födda 1927
Neneuhcāyōtl:1928 tlācatiliztli	Kategori:Födda 1928
Neneuhcāyōtl:1942 tlācatiliztli	Kategori:Födda 1942
Neneuhcāyōtl:1943 tlācatiliztli	Kategori:Födda 1943
Neneuhcāyōtl:1945 tlācatiliztli	Kategori:Födda 1945
Neneuhcāyōtl:1947 tlācatiliztli	Kategori:Födda 1947
Neneuhcāyōtl:1949 tlācatiliztli	Kategori:Födda 1949
Neneuhcāyōtl:1952 tlācatiliztli	Kategori:Födda 1952
Neneuhcāyōtl:1953 tlācatiliztli	Kategori:Födda 1953
Neneuhcāyōtl:1957 tlācatiliztli	Kategori:Födda 1957
Neneuhcāyōtl:1958 tlācatiliztli	Kategori:Födda 1958
Neneuhcāyōtl:1959 tlācatiliztli	Kategori:Födda 1959
Neneuhcāyōtl:1961 tlācatiliztli	Kategori:Födda 1961
Neneuhcāyōtl:1962 tlācatiliztli	Kategori:Födda 1962
Neneuhcāyōtl:1966 tlācatiliztli	Kategori:Födda 1966
Neneuhcāyōtl:1967 tlācatiliztli	Kategori:Födda 1967
Neneuhcāyōtl:1968 tlācatiliztli	Kategori:Födda 1968
Neneuhcāyōtl:1969 tlācatiliztli	Kategori:Födda 1969
Neneuhcāyōtl:Ōtlācatqueh xiuhpan 1971	Kategori:Födda 1971
Neneuhcāyōtl:Ōtlācatqueh xiuhpan 1972	Kategori:Födda 1972
Neneuhcāyōtl:Ōtlācatqueh xiuhpan 1973	Kategori:Födda 1973
Neneuhcāyōtl:Ōtlācatqueh xiuhpan 1975	Kategori:Födda 1975
Neneuhcāyōtl:Ōtlācatqueh xiuhpan 1976	Kategori:Födda 1976
Neneuhcāyōtl:Ōtlācatqueh xiuhpan 1978	Kategori:Födda 1978
Neneuhcāyōtl:Ōtlācatqueh xiuhpan 1979	Kategori:Födda 1979
Neneuhcāyōtl:Ōtlācatqueh xiuhpan 1980	Kategori:Födda 1980
Neneuhcāyōtl:Ōtlācatqueh xiuhpan 1981	Kategori:Födda 1981
Neneuhcāyōtl:Ōtlācatqueh xiuhpan 1982	Kategori:Födda 1982
Neneuhcāyōtl:Ōtlācatqueh xiuhpan 1985	Kategori:Födda 1985
Neneuhcāyōtl:Ōtlācatqueh xiuhpan 1986	Kategori:Födda 1986
Neneuhcāyōtl:Ōtlācatqueh xiuhpan 1987	Kategori:Födda 1987
Neneuhcāyōtl:Ōtlācatqueh xiuhpan 1988	Kategori:Födda 1988
Neneuhcāyōtl:Ōtlācatqueh xiuhpan 1989	Kategori:Födda 1989
Neneuhcāyōtl:Ōtlācatqueh xiuhpan 1991	Kategori:Födda 1991
Neneuhcāyōtl:Ōtlācatqueh xiuhpan 1993	Kategori:Födda 1993
Neneuhcāyōtl:Ōtlācatqueh xiuhpan 1994	Kategori:Födda 1994
Neneuhcāyōtl:Ōtlācatqueh xiuhpan 1995	Kategori:Födda 1995
Neneuhcāyōtl:Ōtlācatqueh xiuhpan 1996	Kategori:Födda 1996
Neneuhcāyōtl:Ōtlācatqueh xiuhpan 1997	Kategori:Födda 1997
Neneuhcāyōtl:Ōtlācatqueh xiuhpan 1999	Kategori:Födda 1999
Neneuhcāyōtl:Ōtlācatqueh xiuhpan 2000	Kategori:Födda 2000
Nemachiyōtīlli:AND	Mall:AND
Nemachiyōtīlli:ARG	Mall:ARG
Neneuhcāyōtl:Mācuīlpōhualxihuitl XI	Kategori:1000-talet
Neneuhcāyōtl:Mācuīlpōhualxihuitl XVII	Kategori:1600-talet
Nemachiyōtīlli:Tlatequitiltilīlli ca	Mall:Användare ca
Neneuhcāyōtl:1210s	Kategori:1210-talet
Nemachiyōtīlli:BDI	Mall:BDI
Neneuhcāyōtl:Italicotlahtōlli	Kategori:Italiska språk
Neneuhcāyōtl:Ōmicqueh xiuhpan 1395	Kategori:Avlidna 1395
Neneuhcāyōtl:Ōmicqueh xiuhpan 1427	Kategori:Avlidna 1427
Nemachiyōtīlli:Tlatequitiltilīlli sv-3	Mall:Användare sv-3
Nemachiyōtīlli:CIV	Mall:CIV
Nemachiyōtīlli:CRI	Mall:CRI
Nemachiyōtīlli:CYP	Mall:CYP
Neneuhcāyōtl:Ōmicqueh xiuhpan 1510	Kategori:Avlidna 1510
Neneuhcāyōtl:Ōmicqueh xiuhpan 1525	Kategori:Avlidna 1525
Neneuhcāyōtl:Ōmicqueh xiuhpan 1530	Kategori:Avlidna 1530
Neneuhcāyōtl:Ōmicqueh xiuhpan 1533	Kategori:Avlidna 1533
Neneuhcāyōtl:Tlacuīcaliztli Cemānāhuac	Kategori:Musikgrupper efter nationalitet
Neneuhcāyōtl:Teōmatiliztli īpan Mēxihco	Kategori:Religion i Mexico
Neneuhcāyōtl:Ōmicqueh xiuhpan 1629	Kategori:Avlidna 1629
Neneuhcāyōtl:Ōmicqueh xiuhpan 1715	Kategori:Avlidna 1715
Neneuhcāyōtl:Ōmicqueh xiuhpan 1745	Kategori:Avlidna 1745
Neneuhcāyōtl:Ōmicqueh xiuhpan 1755	Kategori:Avlidna 1755
Neneuhcāyōtl:Ōmicqueh xiuhpan 1761	Kategori:Avlidna 1761
Neneuhcāyōtl:Ōmicqueh xiuhpan 1784	Kategori:Avlidna 1784
Neneuhcāyōtl:Ōmicqueh xiuhpan 1788	Kategori:Avlidna 1788
Neneuhcāyōtl:Sardegna	Kategori:Sardinien
Neneuhcāyōtl:Rhein Mictlāmpa-Westfalen	Kategori:Nordrhein-Westfalen
Neneuhcāyōtl:Florida	Kategori:Florida
Neneuhcāyōtl:Lactuca	Kategori:Lactuca
Nemachiyōtīlli:EST	Mall:EST
Neneuhcāyōtl:Nevada	Kategori:Nevada
Neneuhcāyōtl:Yancuīc Mēxihco	Kategori:New Mexico
Neneuhcāyōtl:Arizona	Kategori:Arizona
Neneuhcāyōtl:California	Kategori:Kalifornien
Neneuhcāyōtl:Colorado	Kategori:Colorado
Neneuhcāyōtl:Texas	Kategori:Texas
Neneuhcāyōtl:Mēxihcah cemitqui olōlli	Kategori:Politiska partier i Mexiko
Nemachiyōtīlli:QAT	Mall:QAT
Nemachiyōtīlli:RUS	Mall:RUS
Nemachiyōtīlli:Olympicayoh	Mall:Olympiska spelen
Nemachiyōtīlli:AUT	Mall:AUT
Neneuhcāyōtl:Francitēcah tlahcuilōni	Kategori:Franska författare
Nemachiyōtīlli:CHL	Mall:CHL
Neneuhcāyōtl:Mīmiztin	Kategori:Kattdjur
Neneuhcāyōtl:Caxtiltēcah āmatlahcuilōnih	Kategori:Spanska författare
Neneuhcāyōtl:Machiyōmatiliztli	Kategori:Semiotik
Nemachiyōtīlli:SYR	Mall:SYR
Nemachiyōtīlli:CHN	Mall:CHN
Neneuhcāyōtl:Calmananimeh	Kategori:Arkitekter
Neneuhcāyōtl:Ōmicqueh xiuhpan 1928	Kategori:Avlidna 1928
Neneuhcāyōtl:Angola	Kategori:Angola
Neneuhcāyōtl:Benin	Kategori:Benin
Neneuhcāyōtl:Botzhuana	Kategori:Botswana
Neneuhcāyōtl:Burquina Faso	Kategori:Burkina Faso
Neneuhcāyōtl:Burundi	Kategori:Burundi
Neneuhcāyōtl:Tlanomihuēyātēnco	Kategori:Elfenbenskusten
Neneuhcāyōtl:Guinea Tlahcotlālticpac	Kategori:Ekvatorialguinea
Neneuhcāyōtl:Eritrea	Kategori:Eritrea
Neneuhcāyōtl:Gabon	Kategori:Gabon
Neneuhcāyōtl:Gambia	Kategori:Gambia
Neneuhcāyōtl:Guinea	Kategori:Guinea
Neneuhcāyōtl:Guinea Bissau	Kategori:Guinea-Bissau
Neneuhcāyōtl:Camerun	Kategori:Kamerun
Neneuhcāyōtl:Cabo Xoxoctic	Kategori:Kap Verde
Neneuhcāyōtl:Quenia	Kategori:Kenya
Neneuhcāyōtl:Comoras	Kategori:Komorerna
Neneuhcāyōtl:Liberia	Kategori:Liberia
Neneuhcāyōtl:Libia	Kategori:Libyen
Neneuhcāyōtl:Madagascar	Kategori:Madagaskar
Neneuhcāyōtl:Malahui	Kategori:Malawi
Neneuhcāyōtl:Mali	Kategori:Mali
Neneuhcāyōtl:Marruecos	Kategori:Marocko
Neneuhcāyōtl:Mauritania	Kategori:Mauretanien
Neneuhcāyōtl:Mauricio	Kategori:Mauritius
Neneuhcāyōtl:Mozambique	Kategori:Moçambique
Neneuhcāyōtl:Namibia	Kategori:Namibia
Neneuhcāyōtl:Niger	Kategori:Niger
Neneuhcāyōtl:Ruanda	Kategori:Rwanda
Neneuhcāyōtl:Ōmicqueh xiuhpan 1595	Kategori:Avlidna 1595
Neneuhcāyōtl:Ōmicqueh xiuhpan 1597	Kategori:Avlidna 1597
Nemachiyōtīlli:ENG	Mall:ENG
Neneuhcāyōtl:Ōmicqueh xiuhpan 2011	Kategori:Avlidna 2011
Nemachiyōtīlli:IRQ	Mall:IRQ
Neneuhcāyōtl:Ōmicqueh xiuhpan 1541	Kategori:Avlidna 1541
Neneuhcāyōtl:Baden-Württemberg	Kategori:Baden-Württemberg
Neneuhcāyōtl:Ōmicqueh xiuhpan 1811	Kategori:Avlidna 1811
Neneuhcāyōtl:Ōmicqueh xiuhpan 1818	Kategori:Avlidna 1818
Neneuhcāyōtl:Tlani California	Kategori:Baja California (delstat)
Neneuhcāyōtl:Burseraceae	Kategori:Burseraceae
Neneuhcāyōtl:Ōmicqueh xiuhpan 1849	Kategori:Avlidna 1849
Neneuhcāyōtl:Ōmicqueh xiuhpan 1862	Kategori:Avlidna 1862
Neneuhcāyōtl:Ōmicqueh xiuhpan 1870	Kategori:Avlidna 1870
Neneuhcāyōtl:Ōmicqueh xiuhpan 1873	Kategori:Avlidna 1873
Neneuhcāyōtl:Ōmicqueh xiuhpan 1879	Kategori:Avlidna 1879
Neneuhcāyōtl:Ōmicqueh xiuhpan 1887	Kategori:Avlidna 1887
Neneuhcāyōtl:Ōmicqueh xiuhpan 1893	Kategori:Avlidna 1893
Neneuhcāyōtl:Ōmicqueh xiuhpan 1895	Kategori:Avlidna 1895
Neneuhcāyōtl:Ōmicqueh xiuhpan 1898	Kategori:Avlidna 1898
Neneuhcāyōtl:Ōmicqueh xiuhpan 1913	Kategori:Avlidna 1913
Neneuhcāyōtl:Ōmicqueh xiuhpan 1919	Kategori:Avlidna 1919
Neneuhcāyōtl:Ōmicqueh xiuhpan 1936	Kategori:Avlidna 1936
Neneuhcāyōtl:Ōmicqueh xiuhpan 1940	Kategori:Avlidna 1940
Neneuhcāyōtl:Ōmicqueh xiuhpan 1948	Kategori:Avlidna 1948
Neneuhcāyōtl:Ōmicqueh xiuhpan 1952	Kategori:Avlidna 1952
Neneuhcāyōtl:Ōmicqueh xiuhpan 1955	Kategori:Avlidna 1955
Neneuhcāyōtl:Ōmicqueh xiuhpan 1958	Kategori:Avlidna 1958
Neneuhcāyōtl:Ōmicqueh xiuhpan 1964	Kategori:Avlidna 1964
Neneuhcāyōtl:Ōmicqueh xiuhpan 1965	Kategori:Avlidna 1965
Neneuhcāyōtl:Ōmicqueh xiuhpan 1971	Kategori:Avlidna 1971
Neneuhcāyōtl:Ōmicqueh xiuhpan 1973	Kategori:Avlidna 1973
Neneuhcāyōtl:Ōmicqueh xiuhpan 1983	Kategori:Avlidna 1983
Neneuhcāyōtl:Ōmicqueh xiuhpan 1984	Kategori:Avlidna 1984
Neneuhcāyōtl:Ōmicqueh xiuhpan 1989	Kategori:Avlidna 1989
Neneuhcāyōtl:Ōmicqueh xiuhpan 1990	Kategori:Avlidna 1990
Neneuhcāyōtl:Ōmicqueh xiuhpan 1995	Kategori:Avlidna 1995
Neneuhcāyōtl:Ōmicqueh xiuhpan 1996	Kategori:Avlidna 1996
Neneuhcāyōtl:Ōmicqueh xiuhpan 1997	Kategori:Avlidna 1997
Neneuhcāyōtl:Ōmicqueh xiuhpan 2000	Kategori:Avlidna 2000
Neneuhcāyōtl:Ōmicqueh xiuhpan 2001	Kategori:Avlidna 2001
Neneuhcāyōtl:Ōmicqueh xiuhpan 2002	Kategori:Avlidna 2002
Neneuhcāyōtl:Ōmicqueh xiuhpan 2004	Kategori:Avlidna 2004
Nemachiyōtīlli:Tlatequitiltilīlli ca-2	Mall:Användare ca-2
Nemachiyōtīlli:Tlatequitiltilīlli ca-3	Mall:Användare ca-3
Nemachiyōtīlli:Tlatequitiltilīlli la-2	Mall:Användare la-2
Nemachiyōtīlli:Tlatequitiltilīlli pt	Mall:Användare pt
Nemachiyōtīlli:Tlatequitiltilīlli ru-1	Mall:Användare ru-1
Neneuhcāyōtl:Zambia	Kategori:Zambia
Neneuhcāyōtl:Senegal	Kategori:Senegal
Neneuhcāyōtl:Mēxihco ītlahtōllō	Kategori:Mexikos historia
Neneuhcāyōtl:Gentianales	Kategori:Gentianales
Neneuhcāyōtl:Seychelles	Kategori:Seychellerna
Neneuhcāyōtl:Tepētlah Leona	Kategori:Sierra Leone
Neneuhcāyōtl:Zimbabhue	Kategori:Zimbabwe
Neneuhcāyōtl:Somalia	Kategori:Somalia
Neneuhcāyōtl:Sudan Huitztlāmpa	Kategori:Sydsudan
Neneuhcāyōtl:Chad	Kategori:Tchad
Neneuhcāyōtl:Uganda	Kategori:Uganda
Neneuhcāyōtl:Greciatlācah	Kategori:Greker
Neneuhcāyōtl:Brasillācah	Kategori:Brasilianer
Neneuhcāyōtl:Tlahtōlmatinimeh	Kategori:Lingvister
Neneuhcāyōtl:Filipinas	Kategori:Filippinerna
Neneuhcāyōtl:Tlatequitiltilīlli nl	Kategori:Användare nl
Neneuhcāyōtl:Tlatequitiltilīlli nn-3	Kategori:Användare nn-3
Neneuhcāyōtl:Tlatequitiltilīlli no-2	Kategori:Användare no-2
Neneuhcāyōtl:Tlatequitiltilīlli no	Kategori:Användare no
Neneuhcāyōtl:Tlatequitiltilīlli zh-1	Kategori:Användare zh-1
Neneuhcāyōtl:Tlatequitiltilīlli zh-4	Kategori:Användare zh-4
Neneuhcāyōtl:Tlatequitiltilīlli zh-2	Kategori:Användare zh-2
Neneuhcāyōtl:Ulmaceae	Kategori:Ulmaceae
Neneuhcāyōtl:Inglatēcah mecahuēhuētini	Kategori:Brittiska gitarrister
Neneuhcāyōtl:Escotlān tlacuīcaliztli	Kategori:Skotska musikgrupper
Neneuhcāyōtl:Tlanitlālpan tlacuīcaliztli	Kategori:Nederländska musikgrupper
Neneuhcāyōtl:Armenia	Kategori:Armenien
Neneuhcāyōtl:Bahrein	Kategori:Bahrain
Neneuhcāyōtl:Butan	Kategori:Bhutan
Neneuhcāyōtl:Tlahcuilōlli	Kategori:Skrivande
Neneuhcāyōtl:Siria	Kategori:Syrien
Neneuhcāyōtl:Tlācatilizilhuitl	Kategori:Jul
Neneuhcāyōtl:Mācuīlpōhualxihuitl XIV	Kategori:1300-talet
Neneuhcāyōtl:Mācuīlpōhualxihuitl XIII	Kategori:1200-talet
Neneuhcāyōtl:Mācuīlpōhualxihuitl XVI	Kategori:1500-talet
Neneuhcāyōtl:Mācuīlpōhualxihuitl IV	Kategori:300-talet
Neneuhcāyōtl:Mācuīlpōhualxihuitl XVIII	Kategori:1700-talet
Neneuhcāyōtl:Miquiztli	Kategori:Döden
Neneuhcāyōtl:Pianotini	Kategori:Pianister
Neneuhcāyōtl:The Rolling Stones	Kategori:The Rolling Stones
Neneuhcāyōtl:Tlapōhualli	Kategori:Heltal
Neneuhcāyōtl:Mēxihcah cemitqueh	Kategori:Mexikanska politiker
Neneuhcāyōtl:Saxonia	Kategori:Sachsen
Neneuhcāyōtl:Ōmicqueh xiuhpan 1988	Kategori:Avlidna 1988
Neneuhcāyōtl:Perutlācah	Kategori:Peruaner
Neneuhcāyōtl:Mēxihcah	Kategori:Mexikaner
Neneuhcāyōtl:Āltepētl īpan Irac	Kategori:Orter i Irak
Neneuhcāyōtl:Bavaria	Kategori:Bayern
Neneuhcāyōtl:Tzitzimicītlalli īmētz	Kategori:Saturnus månar
Neneuhcāyōtl:Huēyitzitzimicītlalli īmētz	Kategori:Jupiters månar
Neneuhcāyōtl:Ilhuicateōcītlalli	Kategori:Uranus
Neneuhcāyōtl:Huēyitzitzimicītlalli	Kategori:Jupiter
Neneuhcāyōtl:Indoeuropantlahtōlli	Kategori:Indoeuropeiska språk
Neneuhcāyōtl:Ōmicqueh xiuhpan 1809	Kategori:Avlidna 1809
Neneuhcāyōtl:Ōmicqueh xiuhpan 1981	Kategori:Avlidna 1981
Neneuhcāyōtl:Ōmicqueh xiuhpan 1999	Kategori:Avlidna 1999
Neneuhcāyōtl:Cualtzin tlahcuilōlli	Kategori:Wikipedia:Bra artiklar
Neneuhcāyōtl:Mācuīlpōhualxihuitl XV	Kategori:1400-talet
Neneuhcāyōtl:Ōmicqueh īpan mācuīlpōhualxihuitl XVI	Kategori:Avlidna 1500-talet
Neneuhcāyōtl:Ōmicqueh īpan mācuīlpōhualxihuitl XVII	Kategori:Avlidna 1600-talet
Neneuhcāyōtl:Ōmicqueh īpan mācuīlpōhualxihuitl XVIII	Kategori:Avlidna 1700-talet
Neneuhcāyōtl:Ōmicqueh īpan mācuīlpōhualxihuitl XIX	Kategori:Avlidna 1800-talet
Neneuhcāyōtl:Ōmicqueh īpan mācuīlpōhualxihuitl XX	Kategori:Avlidna 1900-talet
Neneuhcāyōtl:Ōmicqueh īpan mācuīlpōhualxihuitl XXI	Kategori:Avlidna 2000-talet
Neneuhcāyōtl:Corea Mictlāmpa	Kategori:Nordkorea
Neneuhcāyōtl:Georgia	Kategori:Georgien
Neneuhcāyōtl:Camboya	Kategori:Kambodja
Neneuhcāyōtl:Portugallācah	Kategori:Portugiser
Neneuhcāyōtl:Ōmicqueh xiuhpan 1848	Kategori:Avlidna 1848
Neneuhcāyōtl:Ōmicqueh xiuhpan 1868	Kategori:Avlidna 1868
Neneuhcāyōtl:Vanuatu	Kategori:Vanuatu
Neneuhcāyōtl:Tequiyōtl īpan Mēxihco	Kategori:Mexikos ekonomi
Neneuhcāyōtl:Jamaica	Kategori:Jamaica
Neneuhcāyōtl:Mēxihcah cuīcanih	Kategori:Mexikanska sångare
Neneuhcāyōtl:Āltepētl īpan Ghana	Kategori:Orter i Ghana
Neneuhcāyōtl:Catar	Kategori:Qatar
Neneuhcāyōtl:Quirguiztlālpan	Kategori:Kirgizistan
Neneuhcāyōtl:Cuhuait	Kategori:Kuwait
Neneuhcāyōtl:Lao	Kategori:Laos
Neneuhcāyōtl:Libano	Kategori:Libanon
Neneuhcāyōtl:Mianma	Kategori:Burma
Neneuhcāyōtl:Nepal	Kategori:Nepal
Neneuhcāyōtl:Omān	Kategori:Oman
Neneuhcāyōtl:Ōmicqueh īpan mācuīlpōhualxihuitl XV	Kategori:Avlidna 1400-talet
Neneuhcāyōtl:Sri Lanca	Kategori:Sri Lanka
Neneuhcāyōtl:Tayictlālpan	Kategori:Tadzjikistan
Neneuhcāyōtl:Timor Tlāpcopa	Kategori:Östtimor
Neneuhcāyōtl:Turcmentlālpan	Kategori:Turkmenistan
Neneuhcāyōtl:Uzbectlālpan	Kategori:Uzbekistan
Neneuhcāyōtl:Tlacetilīlli Arabiaemiryōtl	Kategori:Förenade Arabemiraten
Neneuhcāyōtl:Ōmicqueh īpan mācuīlpōhualxihuitl XIV	Kategori:Avlidna 1300-talet
Neneuhcāyōtl:Caxtiltēcah	Kategori:Spanjorer
Neneuhcāyōtl:Quribati	Kategori:Kiribati
Neneuhcāyōtl:San Marino	Kategori:San Marino
Neneuhcāyōtl:Iordania	Kategori:Jordanien
Neneuhcāyōtl:Samoa	Kategori:Samoa
Neneuhcāyōtl:Necuiltōnolhuēyātēnco	Kategori:Costa Rica
Neneuhcāyōtl:Trinidad īhuān Tobago	Kategori:Trinidad och Tobago
Neneuhcāyōtl:Surinam	Kategori:Surinam
Neneuhcāyōtl:Nicānāhuac	Kategori:Nicaragua
Neneuhcāyōtl:Bosnia īhuān Hertzegovina	Kategori:Bosnien och Hercegovina
Neneuhcāyōtl:Noruega	Kategori:Norge
Neneuhcāyōtl:Barbados	Kategori:Barbados
Neneuhcāyōtl:Panama	Kategori:Panama
Neneuhcāyōtl:Paraguay	Kategori:Paraguay
Neneuhcāyōtl:Fiyi	Kategori:Fiji
Neneuhcāyōtl:Papua Yancuīc Guinea	Kategori:Papua Nya Guinea
Neneuhcāyōtl:Marshall Tlālhuāctli	Kategori:Marshallöarna
Neneuhcāyōtl:Liechtenstein	Kategori:Liechtenstein
Neneuhcāyōtl:Salomón Tlālhuāctli	Kategori:Salomonöarna
Neneuhcāyōtl:Honduras	Kategori:Honduras
Neneuhcāyōtl:Uruguay	Kategori:Uruguay
Neneuhcāyōtl:Andorra	Kategori:Andorra
Neneuhcāyōtl:San Vicente īhuān in Granadinas	Kategori:Saint Vincent och Grenadinerna
Neneuhcāyōtl:Serbia	Kategori:Serbien
Neneuhcāyōtl:Belice	Kategori:Belize
Neneuhcāyōtl:Cōzcatlān	Kategori:El Salvador
Neneuhcāyōtl:Haiti	Kategori:Haiti
Neneuhcāyōtl:Ecuador	Kategori:Ecuador
Neneuhcāyōtl:Yemen	Kategori:Jemen
Neneuhcāyōtl:Peru	Kategori:Peru
Neneuhcāyōtl:Dominica	Kategori:Dominica
Neneuhcāyōtl:Bolivia	Kategori:Bolivia
Neneuhcāyōtl:Albania	Kategori:Albanien
Neneuhcāyōtl:Monaco	Kategori:Monaco
Neneuhcāyōtl:Mīmichtin	Kategori:Fiskar
Neneuhcāyōtl:Xōchihcualli	Kategori:Frukter
Neneuhcāyōtl:Cemitqui olōlli	Kategori:Politiska partier
Neneuhcāyōtl:Ōntzīntiliztica	Kategori:Trikolpater
Neneuhcāyōtl:Xapontlahtōlli	Kategori:Japanska
Neneuhcāyōtl:Latintlahtōlli	Kategori:Latin
Neneuhcāyōtl:Teutontlahtōlli	Kategori:Tyska
Neneuhcāyōtl:Mēxihco ītlahtōlhuān	Kategori:Språk i Mexiko
Neneuhcāyōtl:Rusiatlahtōlli	Kategori:Ryska
Neneuhcāyōtl:Mēxihco ītepēhuān	Kategori:Berg i Mexiko
Neneuhcāyōtl:My Chemical Romance	Kategori:My Chemical Romance
Neneuhcāyōtl:Guanajuato	Kategori:Guanajuato (delstat)
Neneuhcāyōtl:Mēxihco ītlahtohcāyōhuān	Kategori:Mexikos delstater
Neneuhcāyōtl:Sinaloa	Kategori:Sinaloa
Neneuhcāyōtl:Nayarit	Kategori:Nayarit
Neneuhcāyōtl:Tlani California Huitztlāmpa	Kategori:Baja California Sur
Neneuhcāyōtl:Puebla	Kategori:Puebla
Neneuhcāyōtl:Hidalgo	Kategori:Hidalgo (delstat)
Neneuhcāyōtl:Guerrero	Kategori:Guerrero
Neneuhcāyōtl:Xālīxco	Kategori:Jalisco
Neneuhcāyōtl:Hessen	Kategori:Hessen
Neneuhcāyōtl:Āltepētl īpan Venezuela	Kategori:Orter i Venezuela
Neneuhcāyōtl:Annonaceae	Kategori:Annonaceae
Neneuhcāyōtl:Apocynaceae	Kategori:Apocynaceae
Neneuhcāyōtl:Cucurbitaceae	Kategori:Cucurbitaceae
Neneuhcāyōtl:Āltepētl īpan Barbados	Kategori:Orter i Barbados
Nemachiyōtīlli:ESP	Mall:ESP
Neneuhcāyōtl:Yōlcatl	Kategori:Djur
Neneuhcāyōtl:Nauru	Kategori:Nauru
Neneuhcāyōtl:Palau	Kategori:Palau
Neneuhcāyōtl:Tonga	Kategori:Tonga
Neneuhcāyōtl:Tuvalu	Kategori:Tuvalu
Neneuhcāyōtl:Antigua īhuān Barbuda	Kategori:Antigua och Barbuda
Neneuhcāyōtl:Guyana	Kategori:Guyana
Neneuhcāyōtl:Colombia	Kategori:Colombia
Neneuhcāyōtl:Cosovo	Kategori:Kosovo
Neneuhcāyōtl:East Sussex	Kategori:East Sussex
Neneuhcāyōtl:Cemānāhuac āltepēnānyōtl	Kategori:Huvudstäder
Neneuhcāyōtl:Āltepētl īpan Paraguay	Kategori:Orter i Paraguay
Neneuhcāyōtl:Āltepētl īpan Eslovenia	Kategori:Sloveniens kommuner
Neneuhcāyōtl:Āltepētl īpan Rusia	Kategori:Orter i Ryssland
Neneuhcāyōtl:Āltepētl īpan Hungria	Kategori:Orter i Ungern
Neneuhcāyōtl:Āltepētl īpan Africa Huitztlāmpa	Kategori:Orter i Sydafrika
Neneuhcāyōtl:Āltepētl īpan Portugal	Kategori:Orter i Portugal
Neneuhcāyōtl:Caxtillah-La Mancha	Kategori:Kastilien-La Mancha
Neneuhcāyōtl:Asturia	Kategori:Asturien
Neneuhcāyōtl:Andalucia	Kategori:Andalusien
Neneuhcāyōtl:Apple Computer	Kategori:Apple Computer
Neneuhcāyōtl:Tlatequitiltilīlli pl	Kategori:Användare pl
Neneuhcāyōtl:Irtlālpan tlacuīcaliztli	Kategori:Irländska musikgrupper
Neneuhcāyōtl:Romatlahtōlli	Kategori:Romanska språk
Neneuhcāyōtl:1000s	Kategori:1000-talet (decennium)
Neneuhcāyōtl:Mictlāntēuccītlalli	Kategori:Pluto
Neneuhcāyōtl:Cītlalpōl	Kategori:Venus
Neneuhcāyōtl:Ixachitlān Mictlāmpa	Kategori:Nordamerika
Neneuhcāyōtl:Pāntli	Kategori:Flaggor
Neneuhcāyōtl:Mecahuēhuētini	Kategori:Gitarrister
Neneuhcāyōtl:Yutanāhuatlahtōlli	Kategori:Uto-aztekiska språk
Nemachiyōtīlli:Tlatequitiltililli af-0	Mall:Användare af-0
Neneuhcāyōtl:Āltepētl īpan Argentina	Kategori:Städer i Argentina
Neneuhcāyōtl:Āltepētl īpan China	Kategori:Orter i Kina
Neneuhcāyōtl:Cuauhtēmallān	Kategori:Guatemala
Neneuhcāyōtl:Tlīltepēc	Kategori:Montenegro
Neneuhcāyōtl:Caxtillāntlahtōlli	Kategori:Spanska
Neneuhcāyōtl:Michhuahcān	Kategori:Michoacán
Neneuhcāyōtl:Huehcāuh Tlācatiyān	Kategori:Historiska länder och riken
Neneuhcāyōtl:Sonora	Kategori:Sonora (delstat)
Xōchicamohtli	Morot
Neneuhcāyōtl:Araceae	Kategori:Araceae
The Prodigy	The Prodigy
Neneuhcāyōtl:Āltepētl īpan Mēxihco	Kategori:Orter i Mexiko
Neneuhcāyōtl:Queen	Kategori:Queen
Neneuhcāyōtl:Āltepētl īpan Cuauhtēmallān	Kategori:Orter i Guatemala
Neneuhcāyōtl:Āltepētl īpan Nicānāhuac	Kategori:Orter i Nicaragua
Neneuhcāyōtl:Āltepētl īpan Domingotlācatlahtohcāyōtl	Kategori:Orter i Dominikanska republiken
Neneuhcāyōtl:Āltepētl īpan Belgica	Kategori:Belgiens kommuner
Neneuhcāyōtl:Āltepētl īpan Belice	Kategori:Orter i Belize
Neneuhcāyōtl:Āltepētl īpan Caxtillān	Kategori:Orter i Spanien
Neneuhcāyōtl:Āltepētl īpan Australia	Kategori:Städer i Australien
Neneuhcāyōtl:Āltepētl īpan Ucrania	Kategori:Orter i Ukraina
Neneuhcāyōtl:Āltepētl īpan Italia	Kategori:Orter i Italien
Neneuhcāyōtl:Āltepētl īpan Costa Rica	Kategori:Orter i Dominica
Neneuhcāyōtl:Āltepētl īpan Peru	Kategori:Orter i Peru
Neneuhcāyōtl:Āltepētl īpan Gambia	Kategori:Orter i Gambia
Neneuhcāyōtl:Āltepētl īpan Angola	Kategori:Städer i Angola
Neneuhcāyōtl:Āltepētl īpan Honduras	Kategori:Orter i Honduras
Neneuhcāyōtl:Āltepētl īpan Cuba	Kategori:Orter på Kuba
Neneuhcāyōtl:Brassicales	Kategori:Brassicales
Nemachiyōtīlli:Tepozyōllōtl	Mall:Motorkonfigurationer
Neneuhcāyōtl:Āltepētl īpan Puebla	Kategori:Orter i Puebla (delstat)
Iztāctepētzaucxōchitl	Govenia liliacea
Neneuhcāyōtl:Nirvana	Kategori:Nirvana
Neneuhcāyōtl:Inglatēcah pianotini	Kategori:Engelska pianister
Neneuhcāyōtl:Catalania	Kategori:Katalonien
Nemachiyōtīlli:Timezones	Mall:Tidszoner
Neneuhcāyōtl:Typhaceae	Kategori:Kaveldunsväxter
Nemachiyōtīlli:UGA	Mall:UGA
Nemachiyōtīlli:UZB	Mall:UZB
Tlalzahuatl	Trombiculidae
Nemachiyōtīlli:Pantli2	Mall:Flagga
Nemachiyōtīlli:Lang-pl	Mall:Lang-pl
Love, Lust, Faith and Dreams	Love Lust Faith + Dreams
The Fallen	The Fallen
Trojany	Trojany
Māxtli	Kalsonger
Nemachiyōtīlli:Tlatequitiltilīlli an-1	Mall:Användare an-1
Neneuhcāyōtl:Āltepētl īpan Austria	Kategori:Orter i Österrike
Neneuhcāyōtl:Huiquipedia:Tlātlatequitiltilīltin Mēxihco	Kategori:Användare Mexiko
Nemachiyōtīlli:Tlatequitiltilīlli it-4	Mall:Användare it-4
Nemachiyōtīlli:SLV	Mall:SLV
Nemachiyōtīlli:RWA	Mall:RWA
Nemachiyōtīlli:MLT	Mall:MLT
Nemachiyōtīlli:Lang-es	Mall:Lang-es
Nemachiyōtīlli:KEN	Mall:KEN
Nemachiyōtīlli:JAM	Mall:JAM
Nemachiyōtīlli:HND	Mall:HND
Neneuhcāyōtl:Vitaceae	Kategori:Vinväxter
Neneuhcāyōtl:Alismatales	Kategori:Alismatales
Neneuhcāyōtl:Amaranthaceae	Kategori:Amaranthaceae
Neneuhcāyōtl:Huehuehāltepētl īpan Mēxihco	Kategori:Fornminnen i Mexiko
Neneuhcāyōtl:Apiaceae	Kategori:Apiaceae
Neneuhcāyōtl:Tlapōhuallōtl	Kategori:Aritmetik
Neneuhcāyōtl:Convolvulaceae	Kategori:Convolvulaceae
Neneuhcāyōtl:Rhamnaceae	Kategori:Rhamnaceae
Neneuhcāyōtl:Euphorbiaceae	Kategori:Euphorbiaceae
Neneuhcāyōtl:Urticaceae	Kategori:Urticaceae
Neneuhcāyōtl:Askøy	Kategori:Askøy kommun
Neneuhcāyōtl:Bromeliaceae	Kategori:Bromeliaceae
Neneuhcāyōtl:Pinaceae	Kategori:Pinaceae
Neneuhcāyōtl:Depeche Mode	Kategori:Depeche Mode
Neneuhcāyōtl:Tlapiyalmeh	Kategori:Husdjur
Neneuhcāyōtl:Commelinales	Kategori:Commelinales
Neneuhcāyōtl:Peru tlālollīniliztli	Kategori:Jordbävningar i Peru
Neneuhcāyōtl:Iglesia Ortodoxa	Kategori:Ortodox kristendom
Neneuhcāyōtl:Ericales	Kategori:Ericales
Neneuhcāyōtl:Extremadura	Kategori:Extremadura
Neneuhcāyōtl:Cupressaceae	Kategori:Cupressaceae
Neneuhcāyōtl:Fagaceae	Kategori:Fagaceae
Nemachiyōtīlli:Lang-sv	Mall:Lang-sv
Neneuhcāyōtl:Germaniatlahtōlli	Kategori:Germanska språk
Neneuhcāyōtl:Greciamachiyōtlahtōltecpantiliztli	Kategori:Grekiska alfabetet
Neneuhcāyōtl:Gregorio xiuhpōhualli	Kategori:Gregorianska kalendern
Neneuhcāyōtl:Hordaland	Kategori:Hordaland fylke
Neneuhcāyōtl:Irtlālpan	Kategori:Ön Irland
Neneuhcāyōtl:Tēmelāhuanimeh Jehová	Kategori:Jehovas vittnen
Neneuhcāyōtl:Lamiaceae	Kategori:Lamiaceae
Neneuhcāyōtl:Tlahtōlāmoxtlahcuilōnimeh	Kategori:Lexikografer
Neneuhcāyōtl:Linaceae	Kategori:Linaceae
Neneuhcāyōtl:Lombardia	Kategori:Lombardiet
Neneuhcāyōtl:Radiohead	Kategori:Radiohead
Neneuhcāyōtl:Mēxihco tlacuīcaliztli	Kategori:Mexikanska musikgrupper
Neneuhcāyōtl:Mongollahtōlli	Kategori:Mongoliska
Neneuhcāyōtl:Tlāloccītlalli īmētz	Kategori:Neptunus månar
Neneuhcāyōtl:Muse	Kategori:Muse
Neneuhcāyōtl:Myrtaceae	Kategori:Myrtaceae
Neneuhcāyōtl:San Cristóbal īhuān Nevis	Kategori:Saint Kitts och Nevis
Neneuhcāyōtl:Santa Lucía	Kategori:Saint Lucia
Neneuhcāyōtl:Semitatlahtōlli	Kategori:Semitiska språk
Neneuhcāyōtl:Sigur Rós	Kategori:Sigur Rós
Neneuhcāyōtl:Eslavotlahtōlli	Kategori:Slaviska språk
Neneuhcāyōtl:Sogn og Fjordane	Kategori:Sogn og Fjordane fylke
Neneuhcāyōtl:Āltepētl īpan Campeche	Kategori:Orter i Campeche (delstat)
Neneuhcāyōtl:Āltepētl īpan Durango	Kategori:Orter i Durango (delstat)
Neneuhcāyōtl:Āltepētl īpan Guerrero	Kategori:Orter i Guerrero
Nemachiyōtīlli:BEL	Mall:BEL
Neneuhcāyōtl:Yucatān īāltepēcalpōllōhuān	Kategori:Orter i Yucatán (delstat)
Neneuhcāyōtl:U2	Kategori:U2
Neneuhcāyōtl:Commelinaceae	Kategori:Commelinaceae
Neneuhcāyōtl:Liliaceae	Kategori:Liljeväxter
Neneuhcāyōtl:The Beatles	Kategori:The Beatles
Neneuhcāyōtl:Tlatequitiltilīlli ast-4	Kategori:Användare ast-4
Neneuhcāyōtl:São Paulo	Kategori:São Paulo
Neneuhcāyōtl:Texas ītēucyōhuān	Kategori:Countyn i Texas
Neneuhcāyōtl:Bahamas	Kategori:Bahamas
Coahtli	Eysenhardtia polystachya
Neneuhcāyōtl:The Cure	Kategori:The Cure
Neneuhcāyōtl:The Killers	Kategori:The Killers
Neneuhcāyōtl:Tlapālli	Kategori:Färg
Neneuhcāyōtl:Suahilitlahtōlli	Kategori:Swahili
Neneuhcāyōtl:Algicatlahtōlli	Kategori:Algiska språk
Neneuhcāyōtl:Altingiaceae	Kategori:Altingiaceae
Neneuhcāyōtl:Aragón	Kategori:Aragonien
Neneuhcāyōtl:Musaceae	Kategori:Musaceae
Neneuhcāyōtl:Betulaceae	Kategori:Betulaceae
Neneuhcāyōtl:Brunei	Kategori:Brunei
Neneuhcāyōtl:California ītēucyōhuān	Kategori:Countyn i Kalifornien
Neneuhcāyōtl:Felidae	Kategori:Felidae
Nemachiyōtīlli:Image label begin	Mall:Image label begin
Neneuhcāyōtl:Caryophyllales	Kategori:Caryophyllales
Neneuhcāyōtl:Centzīntiliztica	Kategori:Monocotyledonae
Neneuhcāyōtl:Chīchīlcītlalli īmētz	Kategori:Mars månar
Neneuhcāyōtl:Moraceae	Kategori:Mullbärsväxter
Neneuhcāyōtl:Mēxihco īāltepēcalpōlhuān	Kategori:Mexikos kommuner
Neneuhcāyōtl:Tlahtohcāyōtl Mēxihco īāltepēcalpōlhuān	Kategori:Kommuner i Mexiko (delstat)
Neneuhcāyōtl:Papaveraceae	Kategori:Papaveraceae
Neneuhcāyōtl:Nadenetlahtōlli	Kategori:Na-dene
Neneuhcāyōtl:Bantutlahtōlli	Kategori:Niger-Kongospråk
Neneuhcāyōtl:Bixaceae	Kategori:Bixaceae
Neneuhcāyōtl:Ilhuicateōcītlalli īmētz	Kategori:Uranus månar
Neneuhcāyōtl:São Paulo Metro	Kategori:São Paulos tunnelbana
Neneuhcāyōtl:Āltepētl īpan Aguascalientes	Kategori:Orter i Aguascalientes (delstat)
Neneuhcāyōtl:Āltepētl īpan Chihuahhua	Kategori:Orter i Chihuahua (delstat)
Neneuhcāyōtl:Āltepētl īpan Hidalgo	Kategori:Orter i Hidalgo (delstat)
Neneuhcāyōtl:Āltepētl īpan Quintana Roo	Kategori:Orter i Quintana Roo
Neneuhcāyōtl:Āltepētl īpan Sonora	Kategori:Orter i Sonora (delstat)
Neneuhcāyōtl:Passifloraceae	Kategori:Passionsblommeväxter
Neneuhcāyōtl:Āltēpetl īpan Noruega	Kategori:Orter i Norge
Neneuhcāyōtl:Mēxihcah Tlahtohcātēīxiptla	Kategori:Mexikos presidenter
Nemachiyōtīlli:Tlahtōllibabel	Mall:Babels
Nemachiyōtīlli:HUN	Mall:HUN
Neneuhcāyōtl:Tlatequitiltilīlli ru-0	Kategori:Användare ru-0
Neneuhcāyōtl:Tlatequitiltilīlli es-0	Kategori:Användare es-0
Neneuhcāyōtl:Tlatequitiltilīlli af-0	Kategori:Användare af-0
Nemachiyōtīlli:Otroscal	Mall:Andra tideräkningar
Neneuhcāyōtl:Michhuahqueh	Kategori:Personer från Michoacán
Neneuhcāyōtl:Tlatequitiltilīlli en-1	Kategori:Användare en-1
Neneuhcāyōtl:Ōtlācatqueh xiuhpan 1930	Kategori:Födda 1930
Neneuhcāyōtl:1946 tlācatiliztli	Kategori:Födda 1946
Neneuhcāyōtl:Tlatequitiltilīlli de-1	Kategori:Användare de-1
Neneuhcāyōtl:1920 tlācatiliztli	Kategori:Födda 1920
Neneuhcāyōtl:Ōtlācatqueh xiuhpan 1956	Kategori:Födda 1956
Neneuhcāyōtl:1933 tlācatiliztli	Kategori:Födda 1933
Neneuhcāyōtl:1911 tlācatiliztli	Kategori:Födda 1911
Neneuhcāyōtl:Ōtlācatqueh xiuhpan 1937	Kategori:Födda 1937
Neneuhcāyōtl:1948 tlācatiliztli	Kategori:Födda 1948
Neneuhcāyōtl:Tlatequitiltilīlli da-N	Kategori:Användare da-N
Neneuhcāyōtl:Ōmicqueh xiuhpan 1978	Kategori:Avlidna 1978
Neneuhcāyōtl:1921 tlācatiliztli	Kategori:Födda 1921
Neneuhcāyōtl:1924 tlācatiliztli	Kategori:Födda 1924
Neneuhcāyōtl:Ōtlācatqueh xiuhpan 1926	Kategori:Födda 1926
Neneuhcāyōtl:1950 tlācatiliztli	Kategori:Födda 1950
Neneuhcāyōtl:1950s tlacuīcaliztli	Kategori:Födda 1950-talet
Neneuhcāyōtl:1960s tlacuīcaliztli	Kategori:Födda 1960-talet
Neneuhcāyōtl:1964 tlācatiliztli	Kategori:Födda 1964
Neneuhcāyōtl:1970s tlacuīcaliztli	Kategori:Födda 1970-talet
Neneuhcāyōtl:Āltepētl īpan Teutontlālpan	Kategori:Städer i Tyskland
Neneuhcāyōtl:Ōmicqueh xiuhpan 1979	Kategori:Avlidna 1979
Neneuhcāyōtl:Ōmicqueh xiuhpan 2010	Kategori:Avlidna 2010
Nemachiyōtīlli:Muse	Mall:Muse
Venustiano Carranza (īxiptlahyōtiliztli)	Venustiano Carranza (distrikt)
Nemachiyōtīlli:Tlatequitiltilīlli ru-3	Mall:Användare ru-3
Nemachiyōtīlli:Tlatequitiltilīlli sco-1	Mall:Användare sco-1
Huarijiotlahtōlli	Huarijio
Nemachiyōtīlli:Franz Ferdinand	Mall:Franz Ferdinand (musikgrupp)
Acaltetepon	Kajmaner
Nemachiyōtīlli:DFdel	Mall:Mexico Citys stadsdelar
Schwaben	Schwaben
Pāpalōtl	Dagfjärilar
Nissan Fairlady Z32	Nissan 300ZX
Nemachiyōtīlli:GeoTemplate/Lang	Mall:GeoTemplate/Lang
-21	21 f.Kr.
City of Angels	City of Angels
Tecuitlatl	Spirulina
Álvaro Obregón (īxiptlahyōtiliztli)	Álvaro Obregón (distrikt)
Ehēcatepēc Morelos	Ecatepec de Morelos
Coreca	Coreca
Mizquitl	Prosopis juliflora
Teōnacazcuahuitl	Cymbopetalum penduliflorum
Tlālcacalōxōchitl	Plumeria inodora
Nōncuahquīzqui:CambiosRecientes	Special:Senaste ändringar
Yōllohxōchicuahuitl	Magnolia mexicana
Neneuhcāyōtl:Tlatequitiltilīlli ja-4	Kategori:Användare ja-4
Neneuhcāyōtl:Alliaceae	Kategori:Alliaceae
Ebola cocoliztli īpan tlācah īpan 2014	Ebolautbrottet i Västafrika 2014
Īpān Puerto Rico	Puerto Ricos flagga
Tlācatlahtocāyōtl Āltepēhuahcāyōtl Donetsk	Folkrepubliken Donetsk
