Naakaii Łizhiní Bikéyah	Afrika
Binaʼadaałtzózí Dinéʼiʼ Bikéyah	Japan
Bitsiighaʼ Łichííʼí Bikéyah	Irland
Hángewii	Ungern
Dibé Diníí Bikéyah	Spanien
Wááshindoon Bikéyah Ałhidadiidzooígíí	USA
Bélgii Bikéyah	Belgien
Látsębooʼ	Luxemburg
Yágháhookáán	Universum
Nahasdzáán	Jorden
Nahoditsʼǫʼłání	Finland
Déinish Dineʼé Bikéyah	Danmark
Póolish Dineʼé Bikéyah	Polen
Łitʼoowę́ęya	Litauen
Ídelii	Italien
Swis Bikéyah	Schweiz
Óóswiya	Österrike
Gwíík Dineʼé Bikéyah	Grekland
Tʼóok Bikéyah	Turkiet
Béésh Bichʼahníí Bikéyah	Europa
(*@@@u0026asia")	Asien
Shádiʼááhjí kéyah yistinígíí	Antarktis
Kéyah Wóyahgo Siʼánígíí	Nederländerna
Béésh bee akʼeʼelchíhí tʼáá bí nitsékeesígíí	Dator
Hastiin alą́ąjįʼ dahsidáhígíí Barack Obama	Barack Obama
Táłtłʼááh Chʼosh Bitooh (Kéyah Dah Siʼánígíí)	Uruguay
Bilasáana	Äpple
Méhigo	Mexiko
Akééháshį́į́h Hahoodzo	Kalifornien
Máaz	Mars (planet)
Kénya	Kenya
Iithiyópya	Etiopien
Gáana	Ghana
Náshdóítsoh bitsiijįʼ daditłʼooígíí	Lejon
Dáághahii Dinéʼiʼ Bikéyah	Frankrike
Łééchąąʼí	Hund
Tótaʼ Dinéʼiʼ Bikéyah	Storbritannien
Mósí	Katt
Dáághahii bizaad	Franska
Łóóʼ	Fiskar
Bwazííl	Brasilien
Biʼééʼ Łichííʼí Bikéyah	Ryssland
Łóóʼtsoh dóó Tééh hóyáanii	Valar
Élábéemah Hahoodzo	Alabama
Béésh Bichʼahii Bikéyah	Tyskland
Bééshbichʼahii bizaad	Tyska
Tin Bikéyah	Island
Ééstii Bikéyah	Estland
Séetin	Saturnus
Didzéchííʼ	Körsbär
Chidí naatʼaʼí	Flygplan
Hastiin alą́ąjįʼ dahsidáhígíí George W. Bush	George W. Bush
Létbiiya	Lettland
Yóókwein	Ukraina
Chek Bikéyah	Tjeckien
Słóbaʼ Bikéyah	Slovakien
Słobíín Bikéyah	Slovenien
Wooméiniya	Rumänien
Bálgaa Bikéyah	Bulgarien
Dziłigaii Bikéyah	Albanien
Haʼaʼaahjí Hakʼaz Dineʼé Bikéyah	Grönland
Kwóóʼad Bikéyah	Kroatien
Bosna dóó Hetsog Bikéyah	Bosnien och Hercegovina
Azééwii Bikéyah	Azerbajdzjan
Andówa	Andorra
Béésh Łichíiʼii Bikéyah	Cypern
Jóojah (Kéyah)	Georgien
Kʼazah Bikéyah	Kazakstan
Dziłizhin Bikéyah	Montenegro
Bádikin Sídii	Vatikanstaten
San Mawínoo Bikéyah	San Marino
Kyóoba	Kuba
Hashkʼaan Bikéyah	Barbados
Indoníízha	Indonesien
Tʼóok bizaad	Turkiska
Kéyah Naakai Łizhinii Bikéyah Shádiʼááhjí Siʼánígíí	Sydafrika
Aljííya	Algeriet
Ózbeʼ Bikéyah	Uzbekistan
Tó	Vatten
Níłchʼi naalkidí	Television
Chíilii	Chile
Doodaatsaahii (Jíísas)	Jesus
Mókiwii	Merkurius
Ákáʼátʼįįł (béésh ntsékeesígíí álʼíní)	Apple Inc.
Biinis	Venus
Jíbitoo	Jupiter
Yoowéinis	Uranus
Néʼtoon	Neptunus
Sį́ʼgaboo	Singapore
Tłóotoo	Pluto
Łííhtensain	Liechtenstein
Dágháilchįįh	Adolf Hitler
Naaltsoos biniiʼ	Facebook
Naaki góneʼ yéigo daʼahijoogą́ą́ʼ	Andra världskriget
Ałhíʼayiiltááh	Matematik
Aooméénii Bikéyah	Armenien
Ooljééʼ	Månen
Nahatʼeʼiitsoh Bikéyah	Australien
Béésh Łigaii Bikéyah	Argentina
Kolíya Bikéyah Náhookǫsjí Siʼánígíí	Nordkorea
Naayééʼ	Dinosaurier
Bilasáana bitseeʼ nineezígíí	Päronsläktet
Naturalis Historia of Pliny the Elder	Naturalis Historia
Encyclopædia Britannica	Encyclopædia Britannica
Tó yaʼnidaʼaazgééd	Akvedukt
Chʼil łitsooí díkʼǫ́zhígíí	Citron
Hashkʼaan (łitsooígíí)	Banan
Sǫʼ	Stjärna
Jóhonaaʼéí	Solen
Háájiʼjin	Väte
Níłchʼi Ászólí	Helium
Haʼaʼaahjí Tíímow	Östtimor
Séwes	Ceres (dvärgplanet)
Haʼooméya	Haumea (dvärgplanet)
Maakiimaakii	Makemake (dvärgplanet)
Ééwis	Eris (dvärgplanet)
Káábin	Kol
Níłchʼi Yáʼátʼéehii	Syre
Hadoh dóó hakʼaz neiłkidígíí	Termometer
Níłchʼi Łitsxooí	Neon
Chihuahua Hahoodzo	Chihuahua (delstat)
Soodin	Natrium
Béésh Łikoní	Magnesium
Béésh Ászólí	Aluminium
Tó Wónaanídę́ę́ʼ Bitsįʼ Yishtłizhii Bikéyah	Indien
Tʼoobááloo	Tuvalu
Béésh (Fe)	Järn
Tʼónga	Tonga
Łeetsoii	Svavel
Samóa	Samoa
Sólomon Tó Bináhaazyínígíí	Salomonöarna
Banoʼáátʼoo	Vanuatu
Páápowa Bigíní Ániidí	Papua Nya Guinea
Níłchʼi Dootłʼizhí	Argon
Eʼeʼaahjí Tónteel bikáaʼgi Kéyah Yázhí dah Ndaaʼeełgo Ałhidadiidzooígíí	Mikronesiens federerade stater
Káálsiiyin	Kalcium
Dilyį́hí	Bly
Kílíbas	Kiribati
Chʼah Diʼilii Bikéyah	Mongoliet
Fííjii	Fiji
Béésh doo Ńdiniichxíihii	Titan
Táłkááʼ Bighan Dineʼé Bikéyah	Venezuela
Méíin Hahoodzo	Maine
Łį́į́ʼ	Häst
Naaldeehii	Djur
Sówinam	Surinam
Kéyah Nahasdzáán Ałníiʼgi Siʼánígíí	Ecuador
Kolámbiya	Colombia
Béésh Łibáhí	Kobolt
Bolíbiya	Bolivia
Béésh Łichíiʼii	Koppar
Niihémpshoo Hahoodzo	New Hampshire
Chʼosh doo yitʼíinii dláádí dóó Ábishjaaʼ	Svampar
Jaméíkʼa	Jamaica
Méésíchóoshish Hahoodzo	Massachusetts
Kanédikiʼ Hahoodzo	Connecticut
Naaʼahóóhai	Tamhöna
Antíígwa dóó Hashkʼaan Bikéyah Yázhí	Antigua och Barbuda
Kéyah Ałkéé Nitį́įgo Dah Ndaaʼeełí	Hawaii
Damóo Bikéyah	Dominica
Domingo Bikéyah	Dominikanska republiken
Bisóodi	Gris
Héítii	Haiti
Iiwą́ą́	Iran
Iiwááʼ	Irak
Hakʼaz Dineʼé Bikéyah Hahoodzo	Alaska
Ízrel Bikéyah	Israel
Shádiʼááhjí Ásáí Bikéyah	Jemen
Jóoʼdan	Jordanien
Gah Bikeeʼ Taahíʼahí	Florida
Kíígiz Bikéyah	Kirgizistan
Hoozdo Hahoodzo	Arizona
Kóóweiʼ	Kuwait
Lááʼos	Laos
Łíbanoo	Libanon
Óogin Hahoodzo	Oregon
Naakaii Dootłʼizhí Bikéyah Yázhí (Tó Bináhaazyínígíí)	Maldiverna
Kéyah dah siʼánígíí	Amerika
Áshįįh Biiʼtó Hahoodzo	Utah
Béégashii	Nötkreatur
Maléízha	Malaysia
Dziłgaiitsoh Honeezkʼazii Bikéyah	Nepal
Omą́ą́	Oman
Eʼeʼaahjí Naakaii Dootłʼizhí Bikéyah	Pakistan
Kʼatár	Qatar
Ásáí Bikéyah Saʼoodí	Saudiarabien
Swii Lankʼa	Sri Lanka
Sííwiya	Syrien
Tʼajiʼ Bikéyah	Tadzjikistan
Tʼáí Bikéyah	Thailand
Kǫʼ naʼałbąąsii diné bee nágéhéʼ	Tåg
Tʼóokmen Bikéyah	Turkmenistan
Ásáí Bikéyah Yázhí Ałhidadiidzooígíí	Förenade Arabemiraten
Biʼednam	Vietnam
Kolíya Bikéyah Shádiʼááhjí Siʼánígíí	Sydkorea
Óola	Guld
Naʼałkaahí	Vetenskapsman
Bangla Bikéyah	Bangladesh
Angóola	Angola
Iiʼniʼ Tłʼiishtsoh Bikéyah	Bhutan
Bwoonéí	Brunei
Tʼanzanííya	Tanzania
Béésh Tózháanii	Kvicksilver
Kéyah Dańlíinii	Filippinerna
Naakaii Łizhinii Bikéyah Beʼałnííʼ	Centralafrikanska republiken
Hastiin Albert Einstein	Albert Einstein
Tʼóogo	Togo
Hooghan Tsé Bee Ádaalyaaí Bikéyah	Zimbabwe
Shádiʼááhjí Soodą́ą	Sydsudan
Tswana Dineʼé Bikéyah	Botswana
Wóndii Dineʼé Bikéyah	Burundi
Ooljééʼ Bikéyah Yázhí	Komorerna
Kéyah Káango Náhookǫsjí Siʼánígíí	Kongo-Brazzaville
Kéyah Káango Shádiʼááhjí Siʼánígíí	Kongo-Kinshasa
Jibótii	Djibouti
Gíní Nahasdzáán Ałníiʼgi Siʼánígíí	Ekvatorialguinea
Gabǫ́ǫ́ (Kéyah)	Gabon
Géémbiya	Gambia
Gíní	Guinea
Gíní Bisó	Guinea-Bissau
Chį́į́h Yee Adilohii Bideeʼ Tónteel Bibąąh	Elfenbenskusten
Táłtłʼááh Chʼosh Daadánígíí Bitooh (Łizhinii Bikéyahdi)	Kamerun
Tónteel Bibąąh Dootłʼizhí	Kap Verde
Sotho Dineʼé Bikéyah	Lesotho
Łíbya	Libyen
Madaʼgéésgáá	Madagaskar
Malááwii	Malawi
Moowitéínya	Mauretanien
Moroko	Marocko
Namííbya	Namibia
Yogénda	Uganda
Wánda Dineʼé Bikéyah	Rwanda
Seishel	Seychellerna
Náshdóítsoh Bitsiijįʼ Daditłʼooʼígíí Bidził	Sierra Leone
Soomáálii Bikéyah	Somalia
Soodą́ą	Sudan
Swáazi Dineʼé Bikéyah	Swaziland
Nahasdzáán Bikáaʼgi Kéyah Naaznilgo Ałhidadiidzooígíí	Förenta nationerna
Nidaashchʼąąʼígíí	Färg
Béésh Łigaii	Silver
Béésh Dildǫʼí	Tenn
Łéétsoh	Uran
Hastiin alą́ąjįʼ dahsidáhígíí Bill Clinton	Bill Clinton
Míshigin Hahoodzo	Michigan
Tó Nitsaa Nílį́bąąh Hahoodzo	Illinois
Náhookǫsjí Dzígaii	North Dakota
Ałnííʼjí Dzígaii	South Dakota
Ayání Naakaii Hahoodzo	Montana
Tóʼííbézhí	Wyoming
Nímasii Kʼidadilyéhé	Idaho
Ahééhałtį́į́h Hahoodzo	Washington (delstat)
Naʼazhǫǫsh Hahoodzo	Nevada
Kayíbíyinsíí (tónteel)	Karibiska havet
Dibé Nitsaa Hahoodzo	Colorado
Naakaii bizaad	Spanska
Naʼashjéʼii	Spindlar
Chʼosh bijáád tseebíhígíí	Spindeldjur
Chʼosh bideeʼ ádaadinígíí	Palpkäkar
Chʼosh bijáád dahólónígíí	Leddjur
Béeso	Pengar
Bijíniyah Hahoodzo	Virginia
Eʼeʼaahjí Bijiniyah Hahoodzo	West Virginia
Kin Yótʼááh Deezʼá Hahoodzo	New York (delstat)
Wóód Áalin Hahoodzo	Rhode Island
Chʼosh bijáád hastání	Insekter
Méelin Hahoodzo	Maryland
Déláwee Hahoodzo	Delaware
Oohááyoo Hahoodzo	Ohio
Pénsówéíniyah Hahoodzo	Pennsylvania
Niijéízii Hahoodzo	New Jersey
Índíʼyéenah Hahoodzo	Indiana
Chidí	Bil
Jóojah Hahoodzo	Georgia
Akałii Bikéyah	Texas
Náhookǫsjí Kééláanah Hahoodzo	North Carolina
Shádiʼááhjí Kééláanah Hahoodzo	South Carolina
Méhigoʼ sídii	Mexico City
Bilasáana diwozhí	Ananas
Mísísípii Hahoodzo	Mississippi
Ténésii Hahoodzo	Tennessee
Yootó Hahoodzo	New Mexico
Mínisóodah Hahoodzo	Minnesota
Wiskaansin Hahoodzo	Wisconsin
Haʼaʼaahjí Dzígaii	Iowa
Nabeeskah Hahoodzo	Nebraska
Shádiʼááhjí Dzígaii	Kansas
Tó Dzígaii Nílį́	Missouri
Tónteel Chʼínílį́	Louisiana
Kentákii Hahoodzo	Kentucky
Dził Biiʼ Dzígaii	Arkansas
Halgai Hóteel Hahoodzo	Oklahoma
Ho Chi Min Sídii	Ho Chi Minh-staden
Bilagáana bizaad	Engelska
Náhookǫsjí Hakʼaz Dineʼé Bikéyah	Nunavut
1901 – 1950	1902
Tłʼiish	Ormar
1951 – 2000	1979
Pope Benedict XVI	Benedictus XVI
Maʼii Ashkii	Geronimo
Tsin naaʼeeł táłtłʼááh naagháhígíí	Ubåt
Tahoniigááh	Influensa
Tłʼízí	Tamget
Kǫʼ	Eld
Tʼááłáhági átʼéego:Templates	Kategori:Mallar
Dloziłchííʼ	Ekorre
Tʼááłáhági átʼéego:Bideeʼtsʼinígíí	Kategori:Bovidae
Tʼááłáhági átʼéego:Ndaaʼnaʼii	Kategori:Squamata
Tiníléítsoh	Komodovaran
Chʼosh bijáád neeznánígíí	Tiofotade kräftdjur
Aymara bizaad	Aymara (språk)
Łeeyiʼ chʼoshtsoh binááʼ hólónígíí	Maskgroddjur
Tʼááłáhági átʼéego:Dééł dóó Tóidoozohii	Kategori:Tran- och rallfåglar
Médíwííyin Sii	Medelhavet
Jóojah (Ałtsʼáʼáztiin)	Georgia (olika betydelser)
Alóós	Ris
Tsídii	Fåglar
Kéłánii bikágí yilzhólígíí	Klomaskar
Kéchwa bizaad	Quechua
Ínsadoobíídiiya	Uppslagsverk
Íiyisíí Naaltsoos	Portal:Huvudsida
Dziłgaiitsoh Honeezkʼazii	Himalaya
Tʼááłáhági átʼéego:Candidates for speedy deletion	Kategori:Snabbraderingar
Chʼil ahwééh	Te
Adijiłii	Igelkottar
Kéyah Sahééwa Eʼeʼaahjí Siʼánígíí	Västsahara
1801 – 1850	1815
Łį́į́ʼ Bideeʼłáaʼii	Enhörning
Hastiin Hernán Cortés	Hernán Cortés
Tsʼíʼii daʼaneezí	Stickmyggor
Dibé	Tamfår
Łóóʼ hashkéhé	Hajar
Ghą́ą́ʼaskʼidii	Kameler
Bidił Daazdoígíí dóó Daʼałtʼoʼígíí	Däggdjur
Mágí dóó Mágí Ndahalinígíí	Primater
(*wálá-)	Myror
Jiłtʼoʼí	Rabarber
Sęęschʼil	Blomkål
Ayęęzhii yiltʼąąʼí	Aubergine
Naalʼeełí	Egentliga andfåglar
Yas	Snö
Jádí dághaaʼígíí	Gnuer
1851 – 1900	1865
Biʼééʼ Łichííʼí bizaad	Ryska
1751 – 1800	1784
Bááh	Bröd
Bee Hazʼą́ą Ił Chʼétʼaah	FN:s deklaration om de mänskliga rättigheterna
Kéyah haʼdéísná	Jordbävning
Tó nitéél nitságoʼ atságáá	Tsunami
Níyoltsoh	Tromb
Saad bee alʼį́į́hni	Skrift
Tʼááłáhági átʼéego:Dáághahii	Kategori:Frankrike
Mąʼii łitsooí	Rödräv
Naaltéʼ	Slaveri
Ahwééh	Kaffe
Abeʼ	Mjölk
Dził	Berg
Doo Nidahałtingóó	Öken
Cryptographic	Kryptografi
Guadalajara	Guadalajara, Mexiko
Tsídii naʼałkʼaiʼí	Pingviner
Kolíya Dineʼé bizaad	Koreanska
Gah	Kaniner
Tó niteel	Ocean
Hodíłchʼil Níłtsánígíí	Regnskog
HiTSʼezh	Ipod
Hazéí	Ekorrar
Hazéí naatʼáʼii	Flygekorrar
Ééʼ néíshoodí	Romersk-katolska kyrkan
Kwį́į́n Elizabeth II	Elizabeth II
Hastiin alą́ąjįʼ dahsidáhígíí Ronald Reagan	Ronald Reagan
Hastiin Emperor Yongle	Yongle-kejsaren
Naʼashjéʼiitsoh	Vargspindlar
Naaldlooshii dadichʼízhii	Kräldjur
Tsin Deigházhígíí	Gnagare
Hasbídí	Duvor
Tééh hóyáanii	Tumlare
Biyáázh Tsʼǫʼasánígíí (Táyiʼ dóó Niʼkáágóó Ndaakaaígíí)	Groddjur
Géeso	Ost
Chʼil naʼatłʼoʼii (chʼiyáán)	Druva
Tsísʼná bitłʼizh	Honung
Atsįʼ	Kött
Naʼashjéʼii tsiizisí	Dallerspindlar
Nímasii	Potatis
Áshįįh łikan	Socker
Haʼałtsédii	Nöt
Wááshindoon bisiláołtsooí	USA:s väpnade styrkor
Naʼiiniʼ bá Hooghantsoh	World Trade Center
Áshįįh	Salt
Wááshindoondi bee hazʼáanii ádeiłʼíní	USA:s kongress
Tsin naaʼeeł	Skepp
Nidaʼąnyéézh	Konstbevattning
Naadą́ą́ʼ	Majs
Naʼashchʼąąʼ	Målarkonst
Wótáahgoo ałnaaʼáłtʼahiʼ	Astronaut
Azhish	Dans
Naʼashjéʼii nahachaʼígíí	Hoppspindlar
Kéyah Daʼnaaznilígíí	Lista över självständiga stater
Shash	Björnar
Hastiin alą́ąjįʼ dahsidáhígíí John Adams	John Adams
Hastiin alą́ąjįʼ dahsidáhígíí Thomas Jefferson	Thomas Jefferson
Hastiin alą́ąjįʼ dahsidáhígíí Andrew Jackson	Andrew Jackson
Ńdíshchííʼ	Tallsläktet
Tłʼoh naadą́ą́ʼ	Vetesläktet
Naałniih yichʼą́ą́h naabaahígíí bąąh dahooʼaahgo	Aids
Abeʼ bee neezmasí	Crêpes
Jéíʼádįįh	Tuberkulos
Łóódtsoh	Smittkoppor
Zelda bahaneʼ	The Legend of Zelda (spelserie)
Naakáí dinéʼiʼ biempire Méhigodi	Azteker
Łéétsoh bee atsiniltłʼish álʼį́	Kärnenergi
Łéétsoh beeʼeldǫǫhtsoh beeʼalį́į́h	Kärnvapen
Chidí naaʼnaʼí beeʼeldǫǫh bikááʼ dah naaznilígíí	Stridsvagn
Dah woozh	Jordgubbe
Jalisco Hahoodzo	Jalisco
Mágí bichʼiyąʼ	Kokospalm
Dzidzétsoh	Persika
Chʼil łitsxooí	Apelsin
Chʼil dishooí	Kiwi
Chʼil dootłʼizhí díkʼǫ́zhígíí	Lime
Abeʼ yistiní	Glass
Méhigo bizaad	Nahuatl
Diné bizaad	Navajo (språk)
Jeeʼiighááh	Tvestjärtar
Tenochtitlan	Tenochtitlán
Ásáí Bizaad	Arabiska
Honeezílígi	Subtropiskt klimat
Atʼaʼ yiltʼąąʼí	Palmer
Niłchiis	Järv
Tsin yilátah ayání	Giraff
Naalʼeełídaaʼí	Näbbdjur
Naʼashǫ́ʼii	Ödlor
Béésh bee akʼeʼelchí áłtsisígíí	Persondator
Wikiibíídiiya:Naaltsoos nizhónígo ádaalyaaígíí	Wikipedia:Utmärkta artiklar
Bee álnééhí:Link FA	Mall:Link FA
Bimááʼ Hahoodzo	Vermont
Hoozdoh	Phoenix
Tʼáyaałchííʼ	Guldspett
Táłkááʼ tsʼin bíchį́į́hnézí	Gavial
Tsin naaʼeeł chidí naatʼaʼí bee nágéhéʼ	Hangarfartyg
Tsídiitsoh	Struts
Kolíya bikéyah (Ałtsʼáʼáztiin)	Korea
Mąʼiitsoh	Varg
Chʼídeeldlóohiitsoh	Träskonäbb
Hodíłchʼilgi dlǫ́ʼiitsoh	Indisk palmmård
Tóidoozohii bidaaʼ łichííʼígíí	Rörhöna
Táłtłʼááh yilcháazhii	Svampdjur
Tónteel naʼashjéʼii	Havsspindlar
Séigoʼ bíláshgaanézí	Amblypyger
Naʼashjéʼii jáádnézí	Lockespindlar
Séigoʼchilí bitseeʼ ádinígíí	Klokrypare
Séigoʼ	Skorpioner
Zahalchíʼii	Skorpionspindlar
Hastiin Emperor Qianlong	Qianlong-kejsaren
Séigoʼ bitseeʼ áłtsʼózígíí	Gisselskorpioner
Yaaʼ doo yitʼíinii	Kvalster
Hodíłchʼilgi naaʼahóóhai	Tinamofåglar
Tłʼiishkʼosí (tsídii)	Ormhalsfåglar
Télii	Åsna
Náshdóítsoh noodǫ́zígíí	Tiger
Kʼíneeshbízhiinééz	Spaghetti
Chʼosh yoołgai bitsʼaʼígíí	Ostron
Tábąąhgi łeeyiʼ chʼosh	Sandmask
Azeeʼ hókániitsoh	Vägtistel
Táłkáaʼgi Tsídii	Andfåglar
Tązhii dóó Naaʼahóóhai Ndahalinígíí	Hönsfåglar
Naalʼeełii keelóól	Doppingar
Tsídii Deílʼésígíí	Storkfåglar
Daʼałtʼoʼígíí Biyęęzhii Deiłchíhígíí	Kloakdjur
Adijiłii bíchį́į́hnézí	Myrpiggsvin
Biyázhí neiyéhé	Pungråttor
Hazéítsʼósii	Jordekorrar
Chidí bikʼah	Petroleum
Chéłchaaʼ	Skalbaggar
Łį́į́ʼ ałchiní	Przewalskis häst
Dlǫ́ʼii yił aheełtʼéhii noodǫ́zígíí	Sebramangust
Naʼastsʼǫǫsíʼniiʼí	Punggrävlingar
Shash naʼazísí	Vombater
Nahatʼeʼiitsohchilí	Råttkänguruer
Náʼagéédí łichíiʼii	Guldmullvadar
Bįįh Danilínígíí	Hjortdjur
Tin	Is
Tłʼohchin díchʼííʼí	Vitlök
Taʼneeskʼání áłtsʼóózígíí	Gurka
Tłʼohchin (chʼil daadánígíí)	Lök (art)
Chʼil łichxíʼí	Tomat
Béésh Łichíiʼii Bikéyah Náhookǫsjígo Siʼanígíí	Nordcypern
Naʼazhǫǫsh Hátsoh	Las Vegas
Náshdóí dilwoʼí	Gepard
Tsékǫʼ	Kol (bränsle)
Néʼéshjaaʼ	Ugglor
Bíígháán Dahólónígíí	Ryggradsdjur
Kʼishchííʼ	Björkar
Ǫǫbǫʼii	Härfågel
Náshdóí Ndahalinígíí	Kattdjur
Yádiłhił yiiyídíʼ nahosdzáán yináádáłiʼ	Internationella rymdstationen
Tó wónaanídę́ę́ʼ toohjįʼ noołnahii	Gråhäger
Hashkʼaan dijéʼé	Dadelpalm
Wááshindoon (Ałtsʼáʼáztiin)	Washington (olika betydelser)
Bidił Daazdoígíí dóó Daʼalghałígíí	Rovdjur
Chʼoshtsoh	Kackerlackor
Dlǫ́ʼii yázhí	Vessla
Tsʼíʼii dóó Tséʼédǫ́ʼii	Tvåvingar
Biniiʼłigaii (néʼéshjaaʼ)	Tornuggla
Mąʼii Ndahalinígíí	Hunddjur
Bijáád Ádaadinígíí	Blötdjur
Chʼosh łitsxooí dóó Chʼosh łichííʼí	Nyckelpigor
Táłkááʼ naalzheehí	Fiskgjuse
Bizaʼazis Dahólónígíí	Pungdjur
Dlǫ́ʼiiłgaii	Hermelin
Naalʼeełí bitsiiʼ dootłʼizhí	Gräsand
Sǫʼ łóóʼ	Sjöstjärnor
Giníłbáhí	Duvhök
Tʼádootłʼizhii	Nötskrika
Zhį́ʼii	Korp
Táłkááʼ tsʼin Danilínígíí	Krokodildjur
Chʼosh bikágí dantłʼizí	Kräftdjur
Dééł	Tranor
Chʼosh bitsʼaʼígíí	Musslor
Łóóʼ ooshgę́ęzhii	Broskfiskar
Tániilʼáí	Trollsländor
Wóláchííʼ yildeełí bikágí ntłʼizí	Myrkottar
Gah Danilínígíí	Hardjur
Tsísʼnátsoh	Humlor
Hazéí yiltseeʼí	Röllika
Chʼosh bikǫʼí	Lysmaskar
Zéédzísgaii	Fasan
Dlǫ́ʼii Ndahalinígíí	Mårddjur
Tsin yiłkaałii	Hackspettar
Bideeʼtsʼinígíí	Slidhornsdjur
Dééł dóó Tóidoozohii Ndahalinígíí	Tran- och rallfåglar
Gáagii dóó Joogii Ndahalinígíí	Kråkfåglar
Chʼiltaatʼagii	Blå kärrhök
Tsin naaʼeeł diné bee nágéhéʼ	Färja
Gad	Ensläktet
Jááłánii	Mångfotingar
Biishchʼid Dahólónígíí	Högre däggdjur
Chʼosh Deildeełii	Äkta insektsätare
Tó wónaanídę́ę́ʼ naalʼeełítsoh łibáhígíí	Grågås
Tónteel dóó Tábąąhgi Tsídii	Vadarfåglar
Ńdíshchíitah dlǫ́ʼii	Mård
Biyaatsʼiin Dahólónígíí	Käkförsedda ryggradsdjur
Tooh łéʼétsoh	Bisam
Chaatʼíní	Ängssyra
Łóóʼ hashkéhé dootłʼizhígíí	Blåhaj
Wóʼatsʼǫǫsii Ádaatʼéhígíí	Halvvingar
Atsáłgaii	Fjällvråk
Béégashiiʼilí	Jak
Tó wónaanídę́ę́ʼ dlǫ́ʼii	Iller
Tsxį́į́łnaalkʼįhii	Seglare
Dziłditłʼoii Bił Hahoodzo	San Juan County, Utah
Hakʼaz naalʼeełí	Ejder
Naalʼeełítsoh bitsiiʼ halzhinígíí	Kanadagås
Chʼó	Gransläktet
Łóóʼtsoh łizhin dóó łigaígíí	Späckhuggare
Jáádtsʼósí	Skärfläckor
Téél dzítsooii dóó Tsétah chʼosh	Jordlöpare
Naalʼeełítsoh diłhiłígíí	Prutgås
Tábąąh dlǫ́ʼii	Mink
Dlǫ́ʼii bitéél halgaií	Stenmård
Tábąąstííntsoh łibáhígíí	Gråsäl
Naakaii Łizhiní Bikéyahdi Hadahóólįįdígíí	Afrotheria
Diné Nááhódlóonii bizaad	Athabaskiska språk
Łį́į́ʼ bitsísʼná	Styngflugor
Tónteel tsídii	Måsfåglar
Ałtį́į́ jikʼáshí (chʼil)	Fräken
Hazaʼaleehtsoh (dííshjį́ ááłjiní)	Selleri
Kʼaalógii dóó Iichʼąhii	Fjärilar
Díłdánii yił aheełtʼéhii	Vaktel
Chʼałdą́ą́ʼ / Jádí nátʼoh (chʼil daadánígíí)	Sparris
Tséʼédǫ́ʼii dootłʼizhí	Spyflugor
Jaaʼabaní Danilínígíí	Fladdermöss
Wóónałchídii	Knäppare
Tsídii bidaanézí	Storkar
Dlǫ́ʼii	Mustela
Lókʼaaʼ	Bladvass
Tsídiiłbáhí	Sparvfinkar
Biłʼeʼeliníʼ	Bakpulver
Táłtłʼááh chʼoshchilí	Lysräkor
Tsiiʼyiishbizhí Dinéʼiʼ Bikéyah	Kina (region)
Naalʼeełí binááʼ łitsooígíí	Knipa
Tábąąstíín	Utter
Jélii łóóʼ	Medusa (zoologi)
Náshdóíłgaii łikizhígíí	Snöleopard
Tábąąstííntsoh Danilínígíí	Sälar
Dlǫ́ǫ́ʼ	Präriehundar
Náshdóí bijaałizhiní	Ökenlo
Chʼóhojilyééh	Spikklubba
Chʼah Diʼilii Bikéyahdę́ę́ʼ naalʼeełítsoh	Svangås
Tsídii yáłtiʼí	Papegojfåglar
Tééh łį́į́ʼ	Zebror
Náshdóí łikizhígíí	Ozelot
Dííłdzid jeeshóóʼ	Smutsgam
Tʼáadoo leʼé danílʼį́ bił hazʼą́	Museum
Shash łizhin dóó łigaígíí	Jättepanda
Shash łigaígíí	Isbjörn
Gaantsʼosí	Sjöliljor
Hastiin alą́ąjįʼ dahsidáhígíí Theodore Roosevelt	Theodore Roosevelt
Neeshchʼííłgai	Cashew
Beeʼódleehí	Fälla
Dilní bee Nidaʼanéhígíí	Musikinstrument
Dééłgai	Svanar
Bikááʼ náʼoobałí	Helikopter
Dziʼizítsoh	Motorcykel
Tééhoołtsódii	Flodhäst
Séí	Sand
Naakaii Łizhiní Bikéyahdę́ę́ʼ náshdóítsoh łikizhígíí	Leopard
Déélgééd	Noshörningar
Beeʼeldííl Dahsinil	Albuquerque
Hashkʼaan dootłʼizhí (babáayah)	Papaya
Náshdóítsoh	Puma
Ásáí dinéʼiʼ	Araber
Deeteel	Älg
Shádiʼááhdę́ę́ʼ náshdóítsoh łikizhígíí	Jaguar
Lókʼaatsoh	Bambu
Káango (Ałtsʼáʼáztiin)	Kongo
Kʼaiʼ	Videsläktet
Shash bizaʼazis hólóní	Koala
Náshdóí kʼos bee naashchʼąąʼígíí	Trädleopard
Shashtsoh	Brunbjörn
Łéʼétsoh	Råttor
Akʼáán	Mjöl
Mágítsoh	Gorillor
Bitsįʼ yishtłizhii	Indianer
Chʼil akʼahí	Avokado
Neeshchʼííłbáhí	Jordnöt
Dzidzétsoh díkʼǫ́ǫzhii	Aprikos
Naʼashǫ́ʼii łahgo ánééhé	Kameleonter
Yootó	Santa Fe, New Mexico
Łééchąąłgaii	Greyhound
Nahatʼeʼiitsoh Bikéyahdę́ę́ʼ łééchąąʼí ałchiní	Dingo
Chʼééhjiyáán	Vattenmelon
Teide	Teide
Naʼastsʼǫǫsí	Möss
Hakʼaz bįįh	Ren
Chʼosh doo yitʼínii	Mikroorganism
Táshchozhii	Svalor
Neeshchʼííʼ hááheeshchiiʼí	Mandel
Łóóʼ bigaan tseebíí	Åttaarmade bläckfiskar
Chʼosh bikágí ntłʼizí	Krabbor
Tábąąstííntsoh bideeʼ hólónígíí	Valross
Mágí diʼilí	Orangutanger
Atsátsoh	Kungsörn
Łóóʼtʼą́hí atsiniltłʼish ííłʼínígíí	Torpediniformes
Chʼil łitsxooí ntsxaaígíí	Grapefrukt
Kʼíníjíłʼahí (dííshjį́ ááłjiní)	Krusbär
Kʼaalógiiłgaígíí	Vitfjärilar
Naʼastsʼǫǫsí binááʼ áłtsʼíísígíí	Näbbmöss
Dzaanééz	Mula
Tsinlátah shash łichíʼígíí	Kattbjörn
Tsídii jáádnézí	Flamingoer
Tééh łééchąąʼí	Hyenor
Łóóʼtsoh dootłʼizhígíí	Blåval
Sóól	Lönnsläktet
Aghaaʼ	Ull
Shádiʼááhdę́ę́ʼ tłʼízí	Lama
Mósíʼilí	Perser (kattras)
Lókʼaatah mósí ałchiní	Djungelkatt
Náátsʼózídę́ę́ʼ mósíłkizhii ałchinígíí	Leopardkatt
Náshdóítʼą́ʼí łikizhígíí	Serval
Tábąąh béégashii	Vattenbuffel
Béégashiitsoh naʼałkǫ́ǫ́ʼígíí	Manater
Hastiin Leiw Éíwiksson	Leif Eriksson
Akágí yitsʼǫǫsii	Iglar
Anáʼálwoʼ:TʼAN (FAQ)	Wikipedia:Vanliga frågor
Táłkááʼ tsʼin	Krokodiler
Chidítsoh	Lastbil
Dlǫ́ʼiitsoh áłtsʼózígíí	Genetter
Gáagii	Corvus
Tó wónaanídę́ę́ʼ náshdóí	Lodjur
Jááłánii (bitsiitsʼiin nteelígíí)	Enkelfotingar
Giní	Falco (släkte)
Dahiitį́hii	Kolibrier
Tsídii biyęęzhtsohígíí	Kivier
Tązhii	Kalkoner
Chʼosh (Bíígháán Ádaadinígíí)	Ryggradslösa djur
Gáagii naashchʼąąʼígíí	Blåkråkor
Mąʼii	Prärievarg
Dah Naatʼaʼí Sǫʼ bił Sinil	The Star-Spangled Banner
Akʼah sisíʼí tsin	Eukalyptussläktet
Mááya dinéʼiʼ	Mayaindianer
Gahtsoh	Harar (släkte)
Bisóodi bíchį́į́h nineezí	Jordsvin
Sonora Hahoodzo	Sonora (delstat)
Nahakʼízii	Syrsor
Chaaʼ	Bävrar
Chʼilzooł	Broccoli
Kááʼtsʼiní	Bältdjur
Atsʼiis naałdzid	Lungcancer
Yágháhoníkáángóó ałánátʼahí	Space Shuttle
Béésh náábałí atsiniltłʼish ííłʼínígíí	Vindkraftverk
Méhigo tééh	Anahuac
Shą́ą́ʼnahalghałí (naaldeehii)	Hyraxar
Nahatʼeʼiitsoh łichíiʼii	Röd jättekänguru
Azeeniłchin	Kransblommiga växter
Chʼał	Stjärtlösa groddjur
Tsxilghááh	Stjärtgroddjur
Shádiʼááhdę́ę́ʼ atsátsoh	Harpyja (fågel)
Shádiʼááhdę́ę́ʼ chʼał kʼaasdáhígíí	Pilgiftsgrodor
Chʼał niłtólí	Glasgrodor
Chʼał dichʼízhí	Äkta paddor
Tónteel tsídiitsoh	Albatrosser
Chidí nadlééh	Cabriolet
Chʼał atʼąąʼ nahalinii	Megophryidae
Naashgalí	Mescaleroapacher
Bisóodi ałchiní	Vildsvin
Mariner 10	Mariner 10
Sǫʼ łóóʼ bigaanézí	Ormstjärnor
Dághaałóóʼ	Malartade fiskar
Łóóʼtʼą́hí	Plattfiskar
Toohjįʼ ndiigaii	Snöhäger
Kʼaalógii bitseeʼ hólóní	Riddarfjärilar
Mágí binááʼtsohígíí	Spökdjur
Chiiłchin	Rhus aromatica
Ndoochííʼ	Pterospora andromedea
Tó wónaanídę́ę́ʼ dlǫ́ʼiiłkizhii	Tigeriller
Díłdánii	Tofsvaktlar
Táłtłʼááh łį́į́ʼ	Sjöhästar
Łóóʼ bíígháántsiighąąʼ ádaadinígíí	Pirålar
Béésh Sinil	Winslow, Arizona
Achʼįʼ Náhiłtį́į́	Safford, Arizona
Tó wónaanídę́ę́ʼ dzeeh	Kronhjort
Tsézhin Deezʼáhí	St. Johns, Arizona
Béésh Bá Hooghan	Globe, Arizona
Kinłání (Hoozdoh Hahoodzo)	Flagstaff
Michoacán Hahoodzo	Michoacán de Ocampo
Tʼiisyaakin	Holbrook, Arizona
Naʼníʼá Hótsaa	Page, Arizona
Táłtłʼááh chʼosh daadánígíí	Räkor
Mágíshzhin	Schimpanser
Łóóʼntsxaaí łikizhígíí	Valhaj
Dlǫ́ʼii yił Aheedaałtʼéhígíí	Manguster
Béésh Bichʼahníí Bikéyahdę́ę́ʼ ayání	Visent
Łóóʼtsoh bitsiiʼ dikʼání	Kaskelot
Waaʼ (dííshjį́ ááłjiní)	Spenat
Néʼéshjaatsoh	Virginiauv
Shádiʼááhdę́ę́ʼ tłʼízíʼilí	Alpacka
Chʼosh ditłʼooí	Fjärilslarv
Łóóʼ bigaan neeznání	Teuthida
Bijáád noodǫ́ǫzii	Okapi
Méhigo Hahoodzo	Mexiko (delstat)
Ayání	Bisonoxe
Mąʼiiłgaii	Fjällräv
Táłtłʼááh chʼosh chʼééh digháhii bideetsohígíí	Sjöharar
Gólízhii Danilínígíí	Skunkar
Táłtłʼááh adijiłii	Sjöborrar
Nahachagii	Gräshoppor
Wóóneeshchʼįįdii (nahachaʼígíí)	Vandringsgräshoppor
Tsídiitsoh ditsʼozígíí	Emu
Ałhaʼdeetʼaah	Avtal
Naayééʼ tsídii	Archaeopteryx
Tsísʼná (bitłʼizh ííłʼínígíí)	Honungsbin
Chééwokii dinéʼiʼ	Cherokeser
Tsin naaʼeeł hééł bee nágéhéʼ	Lastfartyg
Ałtį́į́ jikʼáshí áłtsʼózígíí (chʼil)	Åkerfräken
Yéigo ałhoshii	Sovmöss
Naʼashjéʼii bijéí dah łichíiʼii	Svart änka
Mágí dághaaʼígíí	Kejsartamarin
Didzéłchííʼ	Järnekssläktet
Naałání	Comancher
Oozéí / Ayahkinii	Hopi
Toohjįʼ noołnahiitsoh	Goliathäger
Bidááʼ Haʼaztʼiʼ Tsékooh	Grand Canyon
Táłtłʼááh naʼashjéʼii	Vattenspindel
Táłtłʼááh tsisteełtsoh	Havslädersköldpadda
Nahatʼeʼii	Känguruspringmöss
Tsídii yáłtiʼí yázhí	Undulat
Tábąąh mąʼii	Tvättbjörn
Hołchʼíʼí	Nässelsläktet
Tsįdláád	Usnea
Dáághahii dinéʼiʼ	Fransmän
Shash łizhinígíí	Svartbjörn
Náshdóí bizaʼazis hólóní	Pungvarg
Łeeyiʼ chʼosh	Daggmask
Shash bitéélgaígíí	Kragbjörn
Chʼoshtʼą́hí	Plattmaskar
Hashtłʼish jeeshóóʼ	Lammgam
Jádí bíchį́į́htsohígíí	Saigaantilop
Táłtłʼááh chʼoshtsoh chʼééh digháhii	Sjögurkor
Tsísʼná bizǫ́ǫ́z ádinígíí	Gaddlösa bin
Chidí naatʼaʼí dilwoʼí	Jaktflygplan
Bíchį́į́h naatsʼǫǫdí	Tapirer
Tó wónaanídę́ę́ʼ mąʼii	Guldschakal
Chʼóshgai (tsin)	Vitgran
Łóóʼ Bigaan Dahólónígíí	Bläckfiskar
Naʼashǫ́ʼii łóóʼ	Ålartade fiskar
Dahbaʼ (tsin)	Askar
Łóóʼ hashkéhétsoh	Vithaj
Neeshchʼííłchííʼ	Kastanjesläktet
Chį́į́hnézí nahatʼeʼígíí	Springnäbbmöss
Táłtłʼááh ayání	Dugong
Dibé Diníí Bikéyahdę́ę́ʼ náshdóí	Panterlo
Maadíséloo	Monticello, Utah
Toohjįʼ ndiigaiitsoh	Ägretthäger
Wóóneeshchʼįįdii	Cikador
Dééshzhiin	Svart svan
Naakaii náásééł	Bönsyrsor
Dlǫ́ǫ́ʼ ntsxaaígíí	Kapybara
Mąʼii bijaaʼtsohí	Fennek
Dilchaʼ	Murmeldjur
Náshdóí łibáhígíí	Rödlo
Chʼilhaatʼaʼii	Stenfalk
Tééh hóyáaniitsoh	Vitval
Jádí bideeʼ yisdizígíí	Impala
Náátsʼózídę́ę́ʼ mąʼiiłchííʼ	Asiatisk vildhund
Łóóʼtsoh bighą́ą́ʼ yílkʼidígíí	Knölval
Ghą́ą́ʼnaakiskʼidii	Kamel
Tábąąh mąʼiiniiʼí	Mårdhund
Naʼazhǫǫsh (ndajiné dóó adazhdikaʼgi)	Kasino
Ndikʼąʼ	Gossypium hirsutum
Dlǫ́tʼą́ʼí	Surikat
Azeeʼ hókániitsoh (chʼil daadánígíí)	Kronärtskocka
Kéchwa dinéʼiʼ	Quechuafolket
Mąʼii bizaʼazis hólóní	Tasmansk djävul
Shash bítááʼłgaígíí	Glasögonbjörn
Jádítsoh	Större kudu
Naatʼáanii Moctezuma II	Moctezuma II
Biwooʼ Ádaałtsʼíísígíí	Håriga trögdjur
Ásáí dinéʼiʼ bikéyah	Arabvärlden
Shash yázhí	Malajbjörn
Shash ndilnaʼii	Läppbjörn
Teeł	Kaveldunssläktet
Chʼódeenínii	Blågran
Łéʼétsoh yiljaaʼí	Ranunkelsläktet
Hakʼaz náshdóí	Kanadensiskt lodjur
Mąʼii yił Ałhidanoolinígíí Yázhí	Halvbjörnar
Béésh Bichʼahii beʼakétłʼóól dijoolí	Kålrabbi
Nahooyéí (chʼil naʼatłʼoʼii)	Vindesläktet
Tłʼoh waaʼí nahalinígíí	Vitklöver
Tséʼésgízii	Gullrips
Tábąąstííntsoh dághaaʼígíí	Storsäl
Hoshdódii chʼil	Rundkrassing
Atʼééké bijish yázhí	Brysselkål
Tsékooh	Kanjon
Bisńdíshchííʼ	Eriogonum fasciculatum
Noodah	Agavesläktet
Łeeʼdoolʼeezí	Snyltrotsväxter
Kinteel Bił Hahoodzo	San Juan County, New Mexico
Beeʼeldííl Dahsinil Bił Hahoodzo	Bernalillo County
Aniłtʼánii	Nätvingar
Kʼaalógii bijáád dį́įʼii	Praktfjärilar
Nímasii yiyání	Coloradoskalbagge
Awééʼchíʼí (chʼil)	Blåklockssläktet
Taʼaghálii	Vedelsläktet
Naaʼołí yiltʼąąʼí	Vialsläktet
Azeeʼ ndootʼeezhí łibáhígíí	Kransborre
Hastóí tsiiyéélí	Klematissläktet
Chʼilátah atsʼos	Dunörtssläktet
Kʼish	Gråal
Dééłjáád	Krusskräppa
Shį́náldzidí (chʼil bilátah hózhóón)	Lejongapssläktet
Kʼįįʼ	Sumaksläktet
Naaztání	Gleditsia triacanthos
Táłkááʼbéésh	Pilbladssläktet
Tsinyaa tłʼoh	Gröesläktet
Tłʼééʼ yiigáhii	Nattljussläktet
Tłʼoh deeskʼidí	Svinamarant
Wóóseekʼidii	Svärmare
Dzílí bíláshgaan	Skatnäva
Díkʼǫ́ǫ́zhí (chʼil)	Fetmållor
Tʼąąʼdoolghasí	Gåsört
Teełikaní	Havssälting
Láʼashdlaʼ	Klättervildvin
Tséghániłchʼi	Portlak
Zééʼiilwoʼii	Kavlen
Chéchʼil ntłʼizí yiltʼąąʼí	Mahonia
Tólchiintsoh	Knölsyska
Tséyaa hataałí	Kålrot
Tłʼohtsʼózí	Tågsläktet
Tłʼoh dichʼíízh	Starrsläktet
Shashdą́ą́ʼ	Berberissläktet
Tłʼoh waaʼítsoh	Vit sötväppling
Díkʼǫ́ǫ́zhí yiltʼąąʼí	Svinmålla
Bįįh yildeeʼí	Lyktörtssläktet
Kʼaalógii bitʼaʼ ndikʼąʼ nahalinígíí	Juvelvingar
Hosh niteelí	Opuntiasläktet
Teeł bitʼąąʼłánígíí	Skogssävssläktet
Chʼał nineezí	Oxgroda
Tééh hóyáanii bíchį́į́htsahí	Narval
Mágí bíchį́į́htsohígíí	Babianer
Bįįh łikizhígíí (Béésh Bichʼahníí Bikéyahdę́ę́ʼígíí)	Dovhjort
Tábąąh ayání	Afrikansk buffel
Nátʼostsoh	Kungsljus
Teeł náyizí	Östersjötåg
Tólchiin (chʼil)	Åkermynta
Dibé diníí dinéʼiʼ	Spanjorer
Táłkááʼ dah yikał	Källfränen
Binaʼadaałtzózí	Japaner
Kʼįįshzhíní	Virginiahägg
Chʼil awoshí	Sodaört
Chʼil naamaasii	Vit amarant
Naʼashjéʼiichʼil	Grusviva
Tłʼohdaʼaghálii	Buketthirs
Ahaditʼáán	Strandskräppa
Yéʼiibeʼetsʼos	Taklosta
Kʼaiʼ łichíʼii	Videkornell
Naazkaadí	Skedamarant
Tsáʼásziʼ nteelí	Palmlilja
Ałtaʼneetsʼéhiitsʼóóz	Glycyrrhiza lepidota
Ostseʼ yiltʼąąʼí	Stillfrö
Ostseʼ	Hamnsenap
Azeediilchʼílii	Blålupin
Toohjįʼhotso (chʼil)	Strandheliotrop
Bikétłʼóól názbąs	Vit dunört
Dzidzé ditʼódí	Sen häggmispel
Gad yił aheełtʼéhígíí	Tamarisk
Łóóʼ bíchį́į́h nineezí	Svärdfisk
Łį́į́ʼ Ndahalinígíí	Hästdjur
Binááʼ Ádaałtsʼózí bichʼil łigaií	Kinakål
Azeedíchʼííʼ	Chilipeppar
Kolíya Tááʼ Bikéyahą́ą	Koreas tre kungariken
Łeehdoolʼeez łichííʼí	Rödbeta
Hashkʼaantsoh yiltʼeesígíí	Kokbanan
Iiʼnótʼį́į́	Infektion
Chʼah Diʼilii Bikéyahdę́ę́ʼ mósí ałchinígíí	Pallaskatt
Tááʼyaʼniiltʼóshiiłbáhígíí	Ökenkardinal
Jááłánii (bikágí ntłʼizígíí)	Dubbelfotingar
Iichʼąhii ntsxaaígíí	Atlasspinnare
Łóóʼ ńdídzihígíí	Lungfiskar
Chʼíshiibeezhii	Mesfåglar
Giní jáádnézí	Sekreterarfågel
Hakʼaz néʼéshjaaʼ	Fjälluggla
Shádiʼááhdę́ę́ʼ jeeshóóʼ	Kondor
Chidí naatʼaʼítsoh beeʼeldǫǫh bikǫʼ neiyéhé	Bombflygplan
Shash bighą́ąʼgi hadzíbáhí	Grizzlybjörn
Kǫʼ naʼałbąąsii	Ånglok
Ndíyíliitsoh	Solros
Naaʼahóóhaiłkizhígíí	Pärlhöns
Tłʼiish yighání	Honungsgrävling
Dadilhóni aheltłʼidígíí	Handgranat
Naakaii Łizhiní Bikéyahdę́ę́ʼ łééchąąʼí ałchiní	Afrikansk vildhund
Aniłtʼánii (tʼááłaʼajínígoʼígíí)	Dagsländor
Ayánítsoh bighą́ą́ʼaskʼidígíí	Gaur (djur)
Máaz yikááʼ nandahí Spirit	MER-A
Hakʼaz giníłgaii	Jaktfalk
Tsétah jeeshóóʼ łibáhí	Gåsgam
Tééh łééchąąʼí łikizhígíí	Fläckig hyena
Tłʼízí ałchiní	Vildget
Yaaʼ dóó chʼosh bíchį́į́h dadichʼízhí	Hakmaskar
Beeʼeldǫǫh	Musköt
Chʼosh bitsʼaʼígíí bigaan dahólónígíí	Armfotingar
Tʼąąʼdoolghasí (daadánígíí)	Sydcikoria
Dlǫ́ʼii (bílaʼashdlaʼii bilį́į́ʼ)	Tamiller
Łóóʼtsoh łibáhígíí	Gråval
Chʼah Diʼilii Bikéyahdę́ę́ʼ atsátsoh	Stäppörn
Yiisnááh	Krigsfångenskap
Dzeeh	Wapitihjort
Tsinlátahgi tsídii nahatʼeʼígíí	Musfåglar
Nátʼoh (chʼil)	Virginiatobak
Tsin naaʼeeł bee daʼahijighánígíí	Slagskepp
Tsísʼná yiyání	Biätare (familj)
Bisóodi bizęęs dį́įʼii	Vårtsvin
Dlǫ́ʼiitsoh naalzheehígíí	Fossa
Nahachagii biyázhí	Bladlöss
Naalkʼįhiitsoh	Pälsfladdrare
Łóóʼ naatʼaʼí	Flygfiskar
Hakʼaz ayání	Myskoxe
Tsétah gah	Pipharar
Mąʼiitsoh bikʼos bineʼdę́ę́ʼ łizhinígíí	Manvarg
Iichʼąhiitsʼósí	Nattsländor
Kéyah Dańlínídę́ę́ʼ atsátsoh	Apörn
Tábąąstííntsoh bíchį́į́htsohígíí	Sjöelefanter
Łóóʼntsxaaí díníchʼahii	Brugd
Chʼosh yighání	Jordvarg
Mágí bitseeʼ noodǫ́zígíí	Ringsvanslemur
Táyiʼ chʼoshnézí	Slemmaskar
Dlǫ́tsʼósí łibáhígíí	Smalstrimmig mangust
Tó naagoʼ	Droppe
Dlǫ́ʼiitsoh Danilínígíí	Viverrider
Mágí bigaanézí	Gibboner
Bílaneezii	Fingerdjur
Séí mąʼii	Korsakräv
Naalʼeełítsoh bitéél halchíʼí	Rödhalsad gås
Tłʼízí bideeʼ yisdizígíí	Skruvhornsget
Jádí	Gaffelantilop
Wónikǫsí	Spökskräckor
Tééh łééchąąʼí noodǫ́zígíí	Strimmig hyena
Tsídiiłchxoní	Hoatzin
Táłtłʼááh chʼoshtʼą́hí bikááʼtsʼinígíí	Ledsnäckor
Mąʼii bighą́ąʼgi hadzíjiní	Schabrakschakal
Naakaii Łizhiní Bikéyahdę́ę́ʼ mąʼiiłchííʼ	Etiopisk varg
Tsétah dibé	Tjockhornsfår
Dibé dóó Tłʼízí Ndahalinígíí	Getdjur
Mágí bíchį́į́h dootłʼizhígíí	Mandrill
Tó wónaanídę́ę́ʼ dibé ałchiní	Mufflonfår
Tsiighájíłchí	Snärjor
Bįįhyázhí biwooʼnézí	Sibiriskt myskdjur
Dzeeh łikizhígíí	Sikahjort
Tábąąh mósí ałchiní	Fiskarkatt
Chį́į́h yee achʼiishíhii	Sågfiskar
Shádiʼááhdę́ę́ʼ hodíłchʼil mąʼii	Skogshund
Hakʼaz mágí	Japansk makak
Tsé Biiʼ Ndzisgaii	Monument Valley
Mágí bíchį́į́h niilyoolígíí	Näsapa
Shádiʼááhdę́ę́ʼ tsídiitsoh	Större nandu
Dáádílí łibáhígí	Brun havsabborre
Náátsʼózídę́ę́ʼ mósíłtsxooí ałchinígíí	Asiatisk guldkatt
Łóóʼnteeltsoh	Klumpfisk
Gaanłáníchilí dóó Gaanłání doo yitʼíinii	Hydra (djur)
Atłʼóóh	Vävning
Chʼoshkʼaaʼ	Pilmaskar
Tábąąh bįįh	Vattenrådjur
Hodíłchʼil jeeshóóʼ	Kungsgam
Dlǫ́ǫ́ʼ bitseetłʼooígíí	Chinchillor
Achʼąąʼ adáʼatsʼiʼ	Vaccination
Néʼéshjaaʼ bíńdáhii	Hökuggla
Bitseeʼ yee adiłhałii	Mississippialligator
Jádítsoh noodǫ́zígíí	Bongo (antilop)
Níyolgi naatʼaʼígíí (tónteel tsídii)	Stormsvalor
Tádídíín yiyání	Bladbaggar
Yílnoodii (łóóʼ)	Sphyraena
Shádiʼááhdę́ę́ʼ łéʼétsoh bitseeʼ ádinígíí	Agutier
Chʼosh bitsʼaʼłáaʼii	Urmollusker
Naʼashǫ́ʼii łóóʼ hashkéhé	Kråshaj
Jeeshóóʼ	Kalifornisk kondor
Táłkááʼ chʼó	Bäckmärke
Chʼosh doo yitʼíinii bee nílʼíní	Mikroskop
Tsin ditʼinii	Sislar
Joogii	Blåskrika
Łeeyiʼ nahakʼízii	Mullvadssyrsor
Náátsʼózídę́ę́ʼ naalʼeełí	Mandarinand
Mąʼii bijaaʼabanígíí	Öronhund
Yéʼii bitsáʼásziʼ	Yucca elata
Tsídiitsoh bikʼos dootłʼizhí	Kasuarer
Atsiniltłʼish ííłʼíinii (naʼashǫ́ʼii łóóʼ)	Darrål
Dįʼ	Skogshöns
Niicháadii (łóóʼ)	Blåsfiskar
Tééhoołtsódiichilí	Dvärgflodhäst
Kʼiiznoodǫ́ǫzii (tsin yigházhígíí)	Pakor
Wóláchííʼ yildeełítsoh	Jättemyrslok
Dibéʼniiʼí	Rödbrun fibi
Bináʼadaałtsózí bitsin naaʼeeł	Djonk
Níłtsą́goʼ (bideeneezígíí)	Långhorningar
Tséʼédǫ́ʼii bitsiinézí	Näbbsländor
Tłʼohtahgi díłdánii yił aheełtʼéhii	Springhöns
Łóóʼyiniʼįįhí (tónteel tsídii)	Labbar
Shádiʼááhdę́ę́ʼ tó hóyáanii	Amazondelfin
Binaʼadaałtsózí dinéʼi	Orienten
Łóóʼ adishishí	Spjutrockor
Tsin yąąh dzootʼihí	Nötväckor
Atʼaʼ yiltʼąąʼí dah sidáhígíí (chʼosh ntsxaaígíí)	Kokoskrabba
Yółeehii	Marulkartade fiskar
Tiníléí	Gilaödla
Dijádídlǫ́ʼí	Berglärka
Tłʼoh	Gräsmatta
Dinas	Mjölon
Mąʼii bikʼiizgi hadzíjiní	Sidstrimmig schakal
Yadiizį́įgo ayání	Giraffgasell
Télii bijáád noodǫ́zí	Afrikansk vildåsna
Bitsʼáá bidaʼhodiʼniil	Brända jordens taktik
Mágíłchííʼ	Vanlig lejontamarin
Dááʼadeeʼii	Skedstorkar
Łóóʼ hashkéhé bitsiiʼ dikʼání	Hammarhajar
Taahilnoodii	Sulor
Kʼíneedlíshii adiłhashígíí	Ekoxbaggar
Łééh yidi tóʼígíí	Akvifer
Naʼashǫ́ʼiitsoh naʼałkǫ́ʼígíí	Havsleguan
Tsídiisháshii	Sidensvansar
Yaaʼ bitsʼaʼígíí	Sköldlöss
Daateel	Båtnäbb
Tééh łééchąąʼí ditsʼozígíí	Brun hyena
Tsétaʼ łį́į́ʼ	Mustang
Kénézí	Jaçanor
Naalʼeełítsoh yił aheełtʼéhii łizhin dóó łigaiígíí	Skatgås
Mąʼii chʼil	Gullrissläktet
Yaadaaʼnézí (tónteel tsídii)	Saxnäbbar
Tsídii disxǫsígíí	Jakamarer
Náátsʼózídę́ę́ʼ mósíłchíiʼii ałchinígíí	Borneoguldkatt
Shádiʼááhdę́ę́ʼ tsétah mósí ałchinígíí	Andisk katt
Tsinlátahgi dlǫ́ʼiitsoh	Binturong
Jeeshóóʼ łizhinígíí	Korpgam
Naałʼashí	Fågelspindlar
Dééłdą́ą́ʼ	Örnbräken
Hashkʼaan yildeełígíí (tsídii)	Turakoer
Łį́į́chilí	Shetlandsponny
Daakʼį́į́ʼ	Numenius
Mąʼiiłtsooí łibáhígíí	Gråräv
Naʼashǫ́ʼiitsoh dootłʼizhígíí	Grön leguan
Chidí bikéíjį́ʼ adeizʼááhígíí	Pickup (fordon)
Bįįh bitseełgaiígíí	Vitsvanshjort
Díʼdikii (jádí)	Dik-dikantiloper
Hakʼaz mąʼiitsoh	Polarvarg
Dark Ages	Den mörka tiden
Łeeyiʼ jááłániichilí	Fåfotingar
Aniłtʼánii (bikʼosnézí)	Halssländor
Ááhooshtʼįįh	Kapitulation
Tséʼédǫ́ʼii dishooí	Blomflugor
Tsáʼásziʼ dóó Noodah	Agaveväxter
Bichʼah Dootłʼizhii	FN:s fredsbevarande styrkor
Dlǫ́ʼii łizhin dóó łitsooígíí	Gulstrupig mård
Chʼosh ałchozhii (chéłchaaʼ)	Ängrar
Łeʼesoołii (bitseeʼ naakiígíí)	Larvborstsvansar
Dlǫ́ʼátsoh	Skogsmurmeldjur
Chʼééh digháhii dóó Tsisteeł	Sköldpaddor
Tááʼyaʼniiltʼóshii	Kardinaler
Łóóʼ bigaanłánígo bitsʼaʼígíí	Pärlbåtar
Łeʼesoołii (bitseeʼ tááʼígíí)	Fjällborstsvansar
Tłʼézhii	Bromsar
Tániilʼáítsʼóóz	Flicksländor och jungfrusländor
Naashtʼézhí	Zuniindianerna
Aniłtʼániitsʼóóz	Myrlejonsländor
Tó wónaanídę́ę́ʼ hazéí bíchį́į́hnézí	Spetsekorrar
Hakʼaz gah	Polarhare
Bįįh łikizhígíí (Naakaii Dootłʼizhii Bikéyahdę́ę́ʼígíí)	Axishjort
Nahashchʼidí (naaldeehii)	Nordamerikansk grävling
Bisóodi bideeʼ názhahígíí	Hjortsvin
Tsídii bichʼahtsooígíí	Större hornkorp
Shádiʼááhdę́ę́ʼ bisóodi diʼilígíí	Navelsvin
Náʼagéédí bizaʼazis hólóní	Pungmullvadar
Bilagáana	Vit (hudfärg)
Tłʼézhiiłbáhí	Parasitflugor
Shash nátʼoh	Tiggarnöt
Jádítsoh diłhiłígíí	Nyala
Jádítsoh bideeʼ shiyishígíí	Sabelantilop
Dlǫ́ʼiitsoh łikizhígíí	Civett
Tsinaʼayąʼii yildeełí	Myrpungdjur
Tsétah tłʼízí	Snöget
Jááłániichilí bighádzígaiígíí	Dvärgfotingar
Gahchilí	Dvärghare
Tsiishgaii	Dvärgnötväcka
Cháʼoł bidahtsʼaaʼ	Arceuthobium
Dééłgai bitsiiʼ halzhinígíí	Svarthalsad svan
Chʼosh nahachagii	Dvärgstritar
Hóółtseiigi naʼastsʼǫǫsí	Ökenråttor
Gaanłání	Cylinderrosor
Dibédą́ą́ʼ	Bisonbusksläktet
Tádídíín yiyání łichíʼígíí	Liljebagge
Laanaa Yáʼátʼéehgo Késhmish	We Wish You a Merry Christmas
Naʼazǫ́ǫzii	Spindelsteklar
Jáád neishoodí (naʼashjéʼii haalzheehígíí)	Vägsteklar
Naalʼeełí bidaatsʼózí	Mergus
Chį́į́shłigaií (bílaʼashdlaʼii bilį́į́ʼ)	Tamgås
Nahatʼeʼiitsoh Bikéyahdę́ę́ʼ naalʼeełítsoh łibáhígíí	Hönsgås
Dahsánítsoh	Vanligt piggsvin
Naʼastsʼǫǫsí bitseeʼ dichʼízhí	Taggmöss
Tsétah nahatʼeʼiitsoh	Klippkänguruer
Táłkááʼ dilwoʼí	Skräddare (insekt)
Akáshtʼóózh biyaʼ	Stövsländor
Łeʼesoołii (bideeʼ ádinígíí)	Trevfotingar
Ąąʼąʼii	Skator
Jádí bideeʼ dį́įʼii	Fyrhornsantilop
Táłtłʼááh chʼosh ntsxaaígíí	Japansk spindelkrabba
Mósí ałchiní bitsiiʼtʼąhígíí	Platthuvudkatt
Naakaii Łizhiní Bikéyahdę́ę́ʼ naalʼeełítsoh dibéłchíʼígíí	Nilgås
Hosh aditsahiitsoh	Saguarokaktus
Tʼáá łichíʼígo náʼagéédí	Kalråtta
Tsisteeł łizhinígíí	Rödfotad skogssköldpadda
Tééh jeeshóóʼ	Vitryggig gam
Iichʼąhii noodǫ́zí	Hyles lineata
Atʼąąʼ nahalinii	Vandrande blad
Ghą́ą́ʼnoodǫ́ǫzii (tsin yigházhígíí)	Pacarana
Tsáʼásziʼ bideeʼí	Yucca baccata
Łéʼétsoh beeniʼíhoniitaahígíí	Egentliga marsvin
Naʼashǫ́ʼii dichʼízhii	Paddleguaner
Ásaaʼ neiyéhii	Oljebaggar
Naʼashǫ́ʼiitsoh łitsooígíí	Galapagos landleguan
Shádiʼááhdę́ę́ʼ tiníléí	Skorpiongiftödla
Sahdii Bisí (Tsé Nástánii)	Petrified Forest
Tsé Bighánílíní	Antelope Canyon
Naakaii Dootłʼizhii bimósí ałchinígíí	Rostfläckig katt
Naʼashǫ́ʼiiłchííʼ dootłʼizhígíí	Agama mwanzae
Kʼaabizhii	Vårtkaktussläktet
Dahiitį́hídą́ą́ʼtsoh	Målarborstar
Wálázhini	Messor
Dlǫ́ʼbéʼézhóóʼ	Aristida
Chʼil abeʼéntsxaaí	Orange sidenört
Jádí yildeeʼí	Asclepias asperula
Ndilkal (chʼil)	Cucurbita foetidissima
Chʼįdą́ą́ʼ	Ceanothus
Dlǫ́ʼii nátʼoh	Nicotiana attenuata
Haashchʼéʼédą́ą́ʼ	Lycium pallidum
Dáʼághálii	Sunnhampor
Chʼil abeʼétsoh	Asclepias speciosa
Chʼał bikʼos ádinígíí	Nasikabatrachus sahyadrensis
Níłtsą́goʼ	Pleocomidae
Jéí náyoogisii	Kägelkaktussläktet
Chʼiidą́ą́tsʼóóz	Vicia americana
Tłʼiish bideeʼtsʼóóz	Asclepias verticillata
Tłʼohtah náshdóí	Leopardus pajeros
Tsídii naʼałkǫ́ʼígíí	Lunnesläktet
Tsisteeł diyogí	Matamata (sköldpadda)
Łóóʼ adishishí ntsxaaígíí	Manta
Tónteel bibąąh hóyáanii	Asiatisk tumlare
Naakaii Łizhiní Bikéyahdę́ę́ʼ tsétah dibé	Manfår
Náhookǫsdę́ę́ʼ dlǫ́ʼii	Amerikansk mård
Naalʼeełí naashchʼąąʼígíí	Brudand
Tsinlátah nahatʼeʼiitsoh	Trädkänguruer
Tsin naaʼeeł łóó beeʼháʼhaalʼééłiʼ	Trålare
Chʼosh biyaʼ	Vridvingar
Táłtłʼááh chʼosh	Dykare (skalbaggar)
Gáagii dinéʼiʼ	Kråkindianer
Shádiʼááhdę́ę́ʼ tábąąstííntsoh	Sydamerikanskt sjölejon
Táłtłʼááh álééh	Amerikansk gråhäger
Tsísʼnáłtsooítsoh	Bålgetingar
Táłtłʼááh naakaii náásééł yił aheełtʼéhii	Mantisräkor
Náátsʼózídę́ę́ʼ tsiiłtsooí	Guldfasan
Bisóodi Danilínígíí	Suina
Gólízhii noodǫ́zígíí	Strimmig skunk
Tsinlátah naʼashǫ́ʼiitsoh	Iguana delicatissima
Tó bichʼosh (séigoʼ nahalinígíí)	Klodyvel
Naʼastsʼǫǫsí bijaaʼntsxaaígíí	Större kaninpunggrävling
Tsʼání	Tallskrika
Chʼééh digháhii bitsʼaʼ yilzhólí	Lädersköldpaddor
Chį́į́shghą́ʼiiłgaii	Vitbröstad nötväcka
Hastiin Biʼééʼ Łichíiʼii	Kit Carson
Tábąąstííntsoh (Akééháshį́į́dę́ę́ʼígíí)	Kaliforniskt sjölejon
Mósí bizaʼazis hólóní	Pungmårdar
Tségad	Mosslumrar
Tsįyaalzhahí	Amerikansk sparvhök
Hashtłʼishdi chʼééh digháhii	Slamsköldpaddor
Yaaʼ nahachagiígíí	Loppor
Kéʼ łizhiní	Svartfotsindianer
Tábąąsdísí áłtsʼíísí	Fläckdrillsnäppa
Náátsʼózídę́ę́ʼ toohjįʼ ndiigaii	Sidenhäger
Dlǫ́ʼii łizhiní	Svartfotad iller
Wóláchííʼ yildeełí łizhin dóó łigaígíí	Tamanduor
Lókʼaatah bisóodi	Busksvin
Hodíłchʼil tłʼízí	Sydlig serov
Hakʼaz Dineʼé Bikéyahdę́ę́ʼ tábąąstííntsoh	Stellers sjölejon
Dziłtah dlǫ́ʼii	Bergsvessla
Naayééʼ tsídiitsoh	Moafåglar
Atseełtsoii	Rödstjärtad vråk
Tóniłhę́ęshii (dééł)	Trumpetartrana
Naaltsoos Mormon Wolyéhígíí	Mormons bok
Téél halchíʼí	Vandringstrast
Dlǫ́ʼátah néʼéshjaaʼ	Prärieuggla
Naʼashǫ́ʼii bijáád ádinígíí	Masködlor
Naʼatłʼoʼii (chʼosh)	Spinnfotingar
Dííłdzid yiyání	Kortvingar
Tsintah łéʼétsoh	Egentliga skogsråttor
Kʼiishzhinii (tsin)	Carpinus caroliniana
Tʼiisbáí	Amerikansk asp
Yáhashjool yázhí	Amerikansk dvärgrördrom
Tłʼéeʼgo mágí	Nattapor
Náʼagéédíchilí	Neurotrichus gibbsii
Tsʼíʼii jáádnézí	Storharkrankar
Chʼil ditsʼozíłchííʼ	Rambutan
Mágíłtsooí bináázhiní	Saimiri sciureus
Taʼneeskʼání	Nätmelon
Tsídiiłtsooí bitʼaʼ łizhinígíí	Guldsiska
Tsʼíʼii noodǫ́zí	Asiatisk tigermygga
Anaasází	Anasazikulturen
Chʼééh digháhiitsoh	Galapagossköldpadda
Tsineeshbízhii	Amerikansk trädkrypare
Yeenaʼałkǫ́ʼíłániichilí	Remipedia
Naʼnízhoozhí Bił Hahoodzo	McKinley County
Mąʼii Deeshgiizh Bił Hahoodzo	Sandoval County
Naatoohí Bił Hahoodzo	Cibola County
Tábąąstííntsoh łikizhígíí	Largasäl
Toohjįʼ noołnahii yázhí	Grönryggad häger
Báshdo	Barstow, Kalifornien
Łóóʼ hashkéhé bíchį́į́hnézí	Trollhaj
Tłʼiishtsiiʼí (łóóʼ)	Ormhuvudfiskar
Chéłchaaʼ bideeneezígíí	Herkulesbagge
Déłí	Prärietrana
Ąąʼąʼiiłbáhí	Blåskata
Tsétah chaaʼ	Ekorrbäver
Sighóla	Socorro, New Mexico
Chéłchaaʼ disxǫsígíí	Praktbaggar
Naalʼeełí dootłʼizhí	Blåvingad årta
Dlǫ́tsʼósí łichííʼígíí	Ringsvansmangust
Jádídlǫ́ʼii	Husgärdsmyg
Yaayááhalzhiin	Svartstrupig sparv
Tséʼédǫ́ʼii	Egentliga flugor
Chʼagiitsoh	Gulhuvad ängstrupial
Dahsání dah Yikahjí Tsin Deigházhígíí	Piggsvinsartade gnagare
Gad niʼeełí	Röden
Níyolgi naʼałkǫ́ʼígíí (tónteel tsídii)	Dykpetreller
Tsinaʼayąʼii biyázhí	Jordlöss
Sóól dichʼíizhii	Acer glabrum
Tseekʼi nástánii	Ammospermophilus
Naatooh Sikʼaiʼí	Grants, New Mexico
Tsooʼtsʼiní (łóóʼ)	Osteoglossidae
Tsinaʼayąʼii	Termiter
Náʼagéédí bíchį́į́h sǫʼ nahalinígíí	Stjärnmullvad
Naaléełchííʼ	Tjocknäbbad parakit
Naaʼahóóhai disxǫsígíí	Glansfasaner
Tsįyaatsiiłchííʼ	Rubintyrann
Náhookǫsdę́ę́ʼ tsétah dibé	Amerikanskt snöfår
Níłtsą́goʼ łichííʼígíí (chʼil abeʼé bichʼosh)	Tetraopes tetrophthalmus
Łóóʼ binááʼtsohí	Priacanthidae
Tsisteeł bikʼosneezígíí	Ormhalssköldpaddor
Kilim	Kelim
Táłtłʼááh wónitłʼizí	Asellus aquaticus
Naatsisʼáán bińdíshchííʼ	Pinus flexilis
Chąąneiłhizii	Stumpbaggar
Tʼáyaałtso	Sonoraspett
Nákʼeʼnáʼijiní	Rödbröstad nötväcka
Ałtaʼneetsʼéhii	Gullfrön
Wáláchíʼétah nahachagiichilí	Myrmecophilidae
Yáhashjool yił aheełtʼéhii	Solrall
Tsintah bisóoditsoh	Skogssvin
Zééjíjinii	Tofsvärnfågel
Dziłghą́ʼiʼ	Västliga apacher
Naʼashǫ́ʼii hááʼáchʼiidí	Gambelia
Kááʼtsʼiní ditłʼooígíí	Hårbältor
Gahtsohdą́ą́ʼ	Krascheninnikovia lanata
Naalkʼįhíchilí (bizaʼazis hólónígíí)	Dvärgflygpungmus
Dlǫ́ʼii yił aheełtʼéhii łibáhígíí	Indisk mungo
Adijiłii yił aheełtʼéhí	Mindre igelkottanrek
Łóóʼ hashkéhé bitseeneezígíí	Rävhaj
Chį́į́shłigaií dóó Naalʼeełítsoh	Anserinae
Jádí biniiʼtsʼózí	Hartebeest
Tábąąh jádí	Ellipsvattenbock
Jádí binááʼ dį́įʼii	Hirolaantilop
Tó wónaanídę́ę́ʼ dlǫ́ʼáyázhí	Sisel
Ásáí Dineʼé Bikéyahdę́ę́ʼ mąʼiitsoh	Arabisk varg
Dlǫ́iitsoh bíchį́į́hdzísgaiígíí	Maskpalmmård
Aniłtʼánii yázhí	Rundbladloppor
Chʼał mágí nahalinii	Phyllomedusa sauvagii
Sǫʼ tsisteeł	Strålsköldpadda
Nahatʼeʼiitsoh Bikéyahdę́ę́ʼ tązhii	Australisk buskhöna
Mąʼii dootłʼizhí	Kattfrett
Táłkááʼ dilwoʼítsʼóóz	Vattenmätare (insekt)
Chʼoshtsoh bíláshgaantsohí łikizhígíí	Enoplometopus
Łeʼesoołii (nahachaʼígíí)	Hoppborstsvansar
Tóidoozohii bidaaʼ łigaiígíí	Sothöns
Chéłchaaʼtsoh	Noshornsbaggar
Wódisxǫsí	Sköldskinnbaggar
Kʼaalógiitsoh disxǫsígíí	Morpho
Tsisteeł hashkéhé	Huggsköldpaddor
Tsilhazésii	Gråstrupig topptyrann
Naʼastsʼǫǫsí bizaʼazis hólóní	Pungspetsekorrar
Wáláchííʼ	Trädgårdsrödmyra
Tsídiidą́ą́ʼ	Floxsläktet
Wóniłchxoní	Bärfisar
Tsiikʼánii (tsídii)	Skuggstork
Nahatʼeʼii niłchxoní	Myskkänguru
Náátsʼózídę́ę́ʼ tsiidootłʼizhii	Större argusfasan
Ábishjaaʼ (daadánígíí)	Matsvampar
Tábąąh bisóodiłchíiʼii	Penselsvin
Kéyah Dańlínídę́ę́ʼ naalʼeełí	Filippinand
Tiníléítsoh naʼałkǫ́ʼígíí	Bandvaran
Kézhoozhʼilí (tsin yigházhígíí)	Kamfingerråttor
Jádí bideeneezígíí	Oryx
Beehai	Jicarillaapacher
Dáádílí łikizhígíí	Leopardabborre
Mágíłbáhí	Diademmarkatta
Jaaʼditłʼoʼí naalkʼįhígíí (bizaʼazis hólónígíí)	Jätteflygfalanger
Nahatʼeʼiitsoh yázhí	Buskvallabyer
Tóshchíín / Naadą́ą́ʼ dootłʼizhí	Välling
Sisnaajiní	Blanca Peak
Séí tiníléítsoh	Varanus gouldii
Dlǫ́ʼii yił aheełtʼéhítsʼózí	Slank mangust
Łóóʼ bigháhootʼíní	Ambassidae
Chʼosh áłtʼą́ą́ʼígíí	Fröskinnbaggar
Dééłtsoh	Koritrapp
Shádiʼááhdę́ę́ʼ dahsání	Coendou prehensilis
Dlǫ́ʼii bitseenézí	Långsvansad vessla
Kéyahígíí nidineesdzaʼ	Dust Bowl
Nahachagii dootłʼizhí	Vårtbitare
Tsé Bíyah Aniiʼáhí	Chacokulturens nationalhistoriska park
Nahatʼeʼiitsoh Bikéyahdę́ę́ʼ biyázhí neiyéhé	Pungräv
Tsísʼnádą́ą́ʼ	Gaillardia
Jeeshóóʼ ałchozhígíí	Palmgam
Łóóʼ adiłdoní	Sprutfiskar
Dlǫ́ʼii yił aheełtʼéhii łitsxooígíí	Gul mangust
Naakaii Łizhiní Bikéyahdę́ę́ʼ nahatʼeʼii	Springhare
Táłtłʼááh chʼosh chʼééh digháhii bitsʼaʼ ádinígíí	Nakensnäckor
Tiníléítsoh noodǫ́zígíí	Nilvaran
Naʼashǫ́ʼii bideewozhii	Dabbagamer
Chʼał ntsxaaígíí	Goliatgroda
Tééh naaʼahóóhaitʼą́ʼí	Frankoliner
Naalʼeełí (bílaʼashdlaʼii bilį́į́ʼ)	Anka
Yáhashjool	Amerikansk rördrom
Dlǫ́ʼii yił aheełtʼéhii yázhí	Dvärgmangust
Nahatʼeʼiitsoh Bikéyahdę́ę́ʼ tábąąstííntsoh	Australiskt sjölejon
Mąʼiiłtsooí yázhí	Ökenkatträv
Gałbáhí	Bomullssvanskaniner
Tsékááʼgóó naagháhii (chʼosh)	Mantophasmatodea
Tłʼohtahilzhahí	Seriemor
Táłtłʼááh tsxilghááhtsoh	Jättesalamandrar
Dibé dághaaʼígíí	Japansk serov
Chʼééh digháhii bitsiiʼntsxaaígíí	Storhuvudsköldpadda
Tsékʼi naʼałkǫ́ʼii	Bisamnäbbmus
Kéyah Dańlínídę́ę́ʼ dzeeh dóó bįįh	Rusa
Naʼastsʼǫǫsítsoh (chʼosh yildeełígíí)	Haitisnabelslidmus
Chʼagii	Rödvingetrupial
Łéʼétsoh diwozhí	Månråtta
Łéʼétsoh bizaʼazis hólóní	Byrnes pungmus
Dlǫ́ʼiitsoh noodǫ́zígíí	Bandad palmmård
Tábąąstííntsoh łizhin dóó łigaiígíí	Bandsäl
Jeeshóóʼ bitsiiłgaiígíí	Vithuvad gam
Tábąądijádí	Skrikstrandpipare
Shádiʼááhdę́ę́ʼ niłchiis	Grisoner
Naʼazísí	Kindpåsråttor
Łeeyiʼ chʼał dichʼízhí	Rhinophrynus dorsalis
Táłtłʼááh naatʼáʼii	Dactylopteridae
Naakaii Dootłʼizhí Dabikéyah	Sydasien
Ńdaʼatʼaałii bideeʼ dahólónígíí	Pecora
Sháńdíín bitsʼą́ą́dę́ę́ʼ atsiniltłʼish álʼį́	Solpanel
Tsé noolchʼóshii	Kanjongärdsmyg
Naʼashǫ́ʼii kááʼtsʼinígíí	Sydafrikansk gördelödla
Diltʼóshii	Gråmesar
Kinteel (Yootó Hahoodzo)	Aztec, New Mexico
Néʼétsah azeeʼ	Kanadabinka
Naʼastsʼǫǫsí bitsʼohígíí	Halvtanrekar
Atsá diłhiłígíí	Svartörn
Ąąʼąʼii dootłʼizhígíí	Grönskata
Bisóodi dághaaʼígíí	Skäggsvin
Iichʼąhii biyázhí	Mjöllöss
Dólii	Bergsialia
Tsiikʼánii (łóóʼ ooshgę́ęzhii)	Hajrockor
Mágí biniiłgaígíí	Sakiapa
Wónaʼałtéhii	Rovflugor
Tłʼoh azihii	Efedraväxter
Kʼaalógii bitʼaʼ disxǫsgo łikizhígíí	Metallmärken
Tiníléítsoh bikʼosnézí	Ökenvaran
Shádiʼááhdę́ę́ʼ gahniiʼí ntsxaaígíí	Maror
Łéʼétsoh bitseetłʼooígíí	Klippråtta
Dilzhę́ʼii	Stellerskrika
Mágí naashchʼąąʼígíí	Kostymapa
Chʼosh naʼałkǫ́ʼí	Palpbaggar
Tééh jádítsoh	Elandantiloper
Łeeyiʼ bitiiní	Sorkar
Atsáłbáí	Präriefalk
Dáádílítsoh	Epinephelus lanceolatus
Tsédááʼ sikaadí	Anagrambräcka
Tsétah bįįhchilí	Puduhjortar
Tsʼánídílzhiʼí	Snårskrika
Iichʼąh	Konvulsion
Kiisʼáanii	Puebloindianer
Jeeshóóʼ bitsiiłtsooí	Savanngam
Dlǫ́ʼii noodǫ́zígíí	Afrikansk bandiller
Tiníléítsoh dootłʼizhígíí	Smaragdvaran
Yáázhłání (naaldlooshii)	Vanlig tanrek
Łéʼétsoh yił aheełtʼéhii	Buskråttor
Tábąąh łéʼétsoh	Hydromys chrysogaster
Ghą́ą́ʼdiʼilii (tsin yigházhígíí)	Manråtta
Lókʼaaʼ yigházhígíí	Rörråttor
Dichin	Svält
Chį́į́hʼadeeʼii (łóóʼ)	Skedstörar
Hazéíntsxaaígíí	Jätteekorrar
Kéyah Dańlínídę́ę́ʼ bisóodi bizęęs hastání	Visayavårtsvin
Dzílí	Cooperhök
Dah Naatʼaʼí Bééhoʼdílzin	Pledge of Allegiance
Tó bichʼosh (tsiiyaago naʼałkǫ́ʼígíí)	Ryggsimmare
Tónteel táshchozhii	Tärnor
Naʼastsʼǫǫsí noodǫ́zígíí	Gräsmöss
Tówoł	Taos
Kʼish biyaʼ dootłʼizhígíí	Allövbagge
Tsáʼásziʼtsʼóóz	Yucca glauca
Dóliiłchííʼ	Västsialia
Łóóʼ binááʼ ádiní	Amblyopsidae
Aniłtʼánii łizhinígíí	Sävsländor
Mágí bichį́į́łgaígíí	Svartkindad vitnäsa
Tábąąh chʼosh	Strandskinnbaggar
Naakaii Bikéyahdę́ę́ʼ bįįh yázhí	Spetshjortar
Naʼashǫ́ʼii dootłʼizhí (naaldeehii)	Halsbandsleguan
Naʼashǫ́ʼiiłbáhí	Ökenleguan
Dlǫ́tsʼósí noodǫ́zígíí	Galidictis grandidieri
Łéʼétsoh gahjaaʼígíí	Hypogeomys antimena
Chʼoshtsoh bíláshgaanʼilí	Kiwada
Anáʼálwoʼ:Bee hadítʼéhígíí	Wikipedia:Hjälp
Táłtłʼááh chʼoshtsoh bideeneezí	Palinuridae
Táshchozhiizhiin	Svart fibi
Moháábii dinéʼiʼ	Mohave
Kin Łichííʼ (Kiisʼáanii bikin)	San Juan Pueblo
Néʼéshjaaʼkálii	Kaktusuggla
Tiníléítsoh łikizhígíí	Jättevaran
Tiníléítsoh bíchį́į́h dikʼání	Varanus albigularis
Tsé noolchʼóshiiłbáhí	Klippgärdsmyg
Dloziłgaii	Tamiasciurus
Tsísʼná dootłʼizhí	Guldsteklar
Tsʼahchʼil	Klotmalvor
Wóósitsʼílí	Vägglus
Níłtsą́goʼ dootłʼizhígíí	Cotinis mutabilis
Biizhii	Större falknattskärra
Tsʼááhbįįh	Physaria
Łéʼétsoh binááʼ ádiní	Spalax
Tábąąh ndoochííʼ	Grönpyrola
Kǫʼ naʼałbąąsii hééł bee nágéhéʼ	Godståg
Tádídíín dootłʼizh áłtsʼíísí	Fjällklocka
Dlǫ́ʼiitsoh bizééʼ noodǫ́zí	Viverra tangalunga
Jaaʼabaní	Småfladdermöss
Chʼosh chʼééh digháhii bideeʼ dį́įʼii	Landlungsnäckor
Azeediłhiłí	Kolvvedel
Tséʼédǫ́ʼii łibáhígíí	Köttflugor
Dlozishzhiin	Borstörad ekorre
Aniłtʼánii (naakaii náásééł nahalinígíí)	Fångsländor
Tsisteeł naʼazísí	Gopherus
Tó Diłhił Biih Yílį́	Snowflake, Arizona
Kin Łání (Dibé Nitsaa Hahoodzo)	Durango, Colorado
Tsé Yaatóhí	Cortez, Colorado
Tótaʼ	Farmington, New Mexico
Tó Naneesdizí	Tuba City, Arizona
Táłtłʼááh chʼoshtsoh bideeteelí	Scyllaridae
Tséyiʼ (Chʼínílį́įgiʼígíí)	Canyon de Chelly nationalmonument
Chʼoshtsoh bíláshgaantsohí (tónteelgiʼígíí)	Hummer
Kʼaiʼbisii	Rostskogstrast
Dlǫ́ʼiiłtsooí	Japansk mård
Táshchozhii dootłʼizhí	Blå storsvala
Nihookááʼ tsídii bichʼahígíí	Hornkorpar
Tsísʼnáłtsooí	Jordgetingar
Azeeʼ hókánii łibáhígíí	Svinmolke
Jélii łóóʼ daʼhólzhaʼígíí	Bandsalper
Gólízhii binághah dah łigaiígíí	Kapuschongskunk
Dloziłbáhí	Sciurus griseus
Nahatʼeʼii jáádnézí	Ökenspringråttor
Tsiiʼnteelí (łóóʼ)	Platycephalidae
Bikétłʼááh Hoolzhólígíí	Tylopoda
Tǫ́ʼgaaʼ	Cochiti Pueblo
Táłtłʼááh séigoʼ bitsʼaʼígíí	Dolksvans
Nááʼnoodǫ́ǫzii	Skärvfrön
Chʼagiiłbáhí	Kostarar
Jáád neishoodítsʼóóz	Brokparasitsteklar
Bitsiichįįshgahí	Grå nötkråka
Naʼashǫ́ʼii naatʼaʼí	Flygdrakar (kräldjur)
Łeeyiʼ chʼosh bikágí ntłʼizí	Hippoidea
Gólízhii bíchį́į́h tʼáá łichíiʼii	Trynskunkar
Iichʼąhii naashchʼąąʼígíí	Chrysiridia rhipheus
Wóóseetsʼiniiniłhiní	Grottvårtbitare
Ałchʼįʼ beʼastłʼóní	Tamales
Bilátah náʼoogisí	Pseudostellaria jamesiana
Tó bichʼosh (wónikǫsí nahalinígíí)	Ranatra
Gólízhii yistłʼinígíí	Fläckskunkar
Biniiʼnoodǫ́zí (tsin yigázhígíí)	Viscacha
Tsísʼnátsoh diłhiłígíí	Snickarbin
Aniłtʼánii (bideeneezígíí)	Fjärilsländor
Shádiʼááhdę́ę́ʼ chʼoshtsoh bíláshgaantsohí	Parastacidae
Zábąąhnteelii (łóóʼ ooshgę́ęzhii)	Rhina ancylostoma
Sílátsoh (chʼil)	Höstrudbeckia
Gahjaaʼí bitseeneezígíí	Bergsviscachor
Tłʼohdeeí	Chenopodium fremontii
Naaldlooshii Bikéshgaan Dahólónígíí	Hovdjur
Nóódaʼí	Ute
Tó Dínéeshzheeʼ	Kayenta, Arizona
Táłkááʼ dilwoʼí yázhí	Bäcklöpare
Néʼézhiin	Rödnackad savspett
Ginítsoh diłhiłí	Mindre svartvråk
Hoshdódii	Skriknattskärra
Chʼééh digháhii bitsʼaʼ dah deezʼáhí	Graptemys
Táłtłááh chʼoshyog	Nereididae
Łį́į́ʼ bidą́ą́ʼtsʼóóz	Psoralea esculenta
Dlǫ́ʼii yił aheełtʼéhii diłhiłígíí	Grå kapmangust
Gadtsagí	Juniperus monosperma
Chʼosh bitsʼaʼ doolghasígíí	Kammusslor
Hashkʼaan bichʼosh	Knoppmalar
Chaatʼíní bichʼosh	Gastrophysa viridula
Ndilkal biyaʼ noodǫ́zígíí	Acalymma vittatum
Iichʼąhii bitʼaʼ ahéédiníʼáhí	Eumorpha achemon
Tádídíín yiyání łizhinígíí	Timarcha
Chʼałdą́ą́ʼ bichʼosh	Crioceris
Niʼbéshjah	Segelbusksläktet
Yéʼiitsoh Bidił Niníyęęzh	El Malpais nationalmonument
Tsékʼi Naʼasdzooí (Yootó Hahoodzo)	El Morro nationalmonument
Tsídii bidaatsoh naashchʼąąʼí	Tukaner
Chʼał bikéshgaan hólóní	Xenopus
Tó bichʼosh (ałchozhígíí)	Buksimmare
Tó wónaanídę́ę́ʼ nahashchʼidí	Meles (släkte)
Wónitłʼizí nahalinígíí	Klotdubbelfotingar
Nahashchʼidí yił aheełtʼéhii yázhí	Solgrävlingar
Dáánézí (łóóʼ)	Centriscidae
Tłʼiish bichóhí	Sidvindare
Tsékʼi yaʼiiʼáhii	Manduca sexta
Táłkááʼ sikaadí	Fältarv
Táłtłʼááh chʼosh chʼééh digháhii bitsiiʼ dikʼání	Cephalaspidea
Dahtooʼ yinooghałii	Kärrgärdsmyg
Chʼó bidághaaʼ	Skägglav (svamp)
Tsédááʼii	Hornkvalster
Dahiitį́į́hildaaʼígíí	Praktlobelia
Atʼaʼ éljołí nahalinígíí (táłtłʼááh chʼosh)	Sabellidae
Tʼááłáhági átʼéego:Bééshbichʼahí	Kategori:Tyskland
Tʼááłáhági átʼéego:Wááshindoon bikéyah ałhidadiidzooígíí	Kategori:USA
Táłtłʼááh kʼaaʼ (łóóʼ)	Fistularia
Tʼááłáhági átʼéego:Dibé diníí bikéyah	Kategori:Spanien
Tʼááłáhági átʼéego:Naakaii Bikéyah	Kategori:Mexiko
Nteelbitʼąąłánígíí	Iris missouriensis
Naalkʼįhí bizaʼazis hólóní	Petaurus
Wóódeʼełchíhii	Bredkantskinnbaggar
Naʼashǫ́ʼii diwozhígíí	Jättegördelödla
Tsinlátah mąʼii	Olingobjörnar
Chʼóyáázh nahalinígíí (táłtłʼááh chʼosh)	Spirobranchus giganteus
Naatsédlózii	Tuppgökar
Tʼááłáhági átʼéego:Bidił daazdoígíí dóó daʼałtʼoʼígíí	Kategori:Däggdjur
Tʼááłáhági átʼéego:Naaldlooshii dadichʼízhii	Kategori:Kräldjur
Tʼááłáhági átʼéego:Biyáázh Tsʼǫʼasánígíí	Kategori:Groddjur
Tʼááłáhági átʼéego:Tsídii	Kategori:Fåglar
Tʼááłáhági átʼéego:Chʼosh doo yitʼíinii dláádí dóó Ábishjaaʼ	Kategori:Svampar
Tʼááłáhági átʼéego:Chʼil	Kategori:Växter
Tʼááłáhági átʼéego:Nátʼą́ą́ʼ náháneʼ	Kategori:Historia
Tʼááłáhági átʼéego:Naʼalkaah	Kategori:Vetenskap
Béégashii bideetsohí	Ankole-Watusi
Tsétaʼkin	San Ildefonso Pueblo
Góóhníinii	Havasupai
Azeeʼ ndootʼeezhítsoh	Lila temynta
Tsísʼná disxǫsígíí	Orkidébin
Łóóʼtsoh bizábąąh shiyishí	Eubalaena
Tsin bizęęs	Polyporus
Tó hájiiloh	Santo Domingo Pueblo
Naashashí (Yootó Hahoodzo)	Santa Clara Pueblo
Táłtłʼááh chʼosh chʼééh digháhii bikeeʼ nteelígíí	Borrsnäckor
Táshchozhii ndiilkʼísii	Stensvala
Tsídiiłtsooiiłkizhígíí	Präriesparv
Ndilkal biyaʼ łikizhígíí	Diabrotica undecimpunctata
Neeshchʼííʼ biyaʼ	Hylobius
Hosh yiyání (níłtsą́goʼ)	Moneilema
Aniłtʼánii łibáhígíí	Fältrovskinnbaggar
Wóótsʼóóz	Krumhornskinnbaggar
Nichʼiʼí	Doftverbena
Iichʼąhii	Nattfjärilar
Chʼoshtsoh yázhí bíláshgaantsohí	Trollhumrar
Roman dinéʼiʼ	Romerska riket
Naadą́ą́ʼ bichʼosh	Diabrotica virgifera
Dlodziłgai bichʼil	Ipomopsis aggregata
Chʼil deenínii	Kali tragus
Dził Bílátah Łitsooí	Sunset Crater Volcano nationalmonument
Azeeʼ ndootʼeezhí	Monarda punctata
Shádiʼááhdę́ę́ʼ tsékʼi dlǫ́ǫ́ʼ	Klippmarsvin
Áshįįhí Kiisʼáaniígíí	Laguna Pueblo
Chʼoshtsoh bikágí diwozhí	Trollkrabbor
Tábąąh naʼashǫ́ʼii	Physignathus
Tséʼnaa Naʼníʼáhí	Rainbow Bridge nationalmonument
Dilzhʼíʼ	Yavapai
Dáádílí ntsxaaígíí	Goliatgrouper
Chʼosh ałchozhii (iichʼąhii)	Klädesmal
Wóóchį́į́hnézí	Lyktstritar
Tsiitsʼiin łichíʼítsoh	Stenopelmatidae
Bitátʼahkin	Navajo nationalmonument
Anaashashi dinéʼiʼ	Tewa
Dookʼoʼoosłííd	San Francisco Peaks
Tʼááłáhági átʼéego:Ałtsʼáʼáztiin	Kategori:Förgreningssidor
Tsintah bįįhchilí	Tragulus
Yiikʼiʼdaʼ hiiznáʼ	Offensiv
Tʼiistsʼóóz	Populus angustifolia
Tsékʼi naʼazólii	Sauromalus
Sǫʼtsoh nátʼoh	Salix exigua
Gad diltáłii	Juniperus deppeana
Tsétsohkʼįįʼ	Symphoricarpos orbiculatus
Atsá	Örnar
Naʼashǫ́ʼiinteeltsxooí	Platysaurus imperator
Séíbéʼézhóóʼ	Muhlygräs
Atsábéʼézhóóʼ	Andropogon glomeratus
Tłʼoh Łikizhí	Tesuque Pueblo
Dibé łizhiní dinéʼiʼ	San Felipe Pueblo
Chʼał nineezí bidą́ą́ʼ	Epipactis gigantea
Tséchʼil	Quercus gambelii
Ndilnaʼii	Sengångare
Tsísʼnáyázhí	Vägbin
Chʼałtʼą́hí	Pipa (djur)
Dą́ʼáchaan	Ustilago
Níłtsą́goʼ noodǫ́zígíí	Polyphylla decemlineata
Chʼil dilyésii	Gutierrezia
Iichʼąhiiłgai bitʼaʼnézí	Thysania agrippina
Séí nahachagiichilí (chʼosh bikágí ntłʼizí)	Tångloppor
Wóláchííʼ azeeʼ	Dyssodia
Wóótʼą́hí	Barkskinnbaggar
Jááłánii bitsiitsʼiin łichííʼígíí	Scolopendra heros
Woodiniih azeeʼ (chʼil)	Brunögon
Íijeehí	Piggfrön
Azeeʼ hókánii	Potentilla gracilis
Tsą́ą́haltsʼaaʼ	Lepidium montanum
Dinastsoh	Arctostaphylos patula
Kʼaasdá bee yigą́	Rosenflockel
Díkʼǫ́ǫ́zhízlíní	Atriplex confertifolia
Tłʼiish yiltsiiʼí	Penstemon palmeri
Niłtsínii	Arisaema triphyllum
Táłchaaʼ	Phyllophaga
Jááłánii noodǫ́zígíí	Scolopendra polymorpha
Chąąʼinii	Rumex hymenosepalus
Chʼil łizhiní	Coleogyne ramosissima
Nááʼ łitsooí	Silverskatta
Naʼashǫ́ʼiinteelí	Platysaurus intermedius
Biʼééʼ dootłʼizhgo disxǫsígíí	Quetzaler
Kʼíneedlíshiidą́ą́ʼ	Abronia fragrans
Naʼashǫ́ʼiidą́ą́ʼ	Asclepias subverticillata
Díwózhii łibáhígíí	Atriplex canescens
Áłchínídą́ą́ʼ (chʼil)	Calochortus nuttallii
Tʼááłáhági átʼéego:Stubs	Kategori:Stubbar
Tʼááłáhági átʼéego:Chidí naatʼaʼí	Kategori:Luftfarkoster
Tsékʼi naʼazólii yistłʼinígíí	Sauromalus varius
Naʼashjéʼiidą́ą́ʼ	Croton texensis
Bįįh yiljaaʼí	Frasera speciosa
Yiltsiiʼígíí	Physaria fendleri
Azeetsoh	Erysimum capitatum
Áłchínítsoh (chʼil)	Tradescantia occidentalis
Tsʼahbįįh	Stanleya pinnata
Niʼdiidlídii	Oryzopsis hymenoides
Tłʼoh łichííʼ	Sorghastrum nutans
Tłʼiish kʼaaʼ beeʼiiłkóóh	Eremocrinum albomarginatum
Wóláchíídą́ą́ʼ hasooł	Eriogonum inflatum
Yilchʼozhʼazeeʼ	Lupinus lyallii
Azeeʼ shaazhí	Bohusranunkel
Diniʼeechʼil áłtsʼóózígíí	Linum lewisii
Náʼagéédí	Nannospalax
Bee álnééhí:User uk-2	Mall:Användare uk-2
Naadą́ą́ʼ biyaʼ	Sitophilus zeamais
Awéétsʼáál (chʼil)	Purshia tridentata
Tsiisxǫsii	Eudicella gralli
Tábąąsdísí	Beckasiner
Naadą́ą́ʼ yiltʼąąʼí	Vipprams
Łóóʼ biyaʼ (chʼosh bikágí ntłʼizí)	Argulus
Tʼááłáhági átʼéego:Wikipedia bots	Kategori:Wikipedia:Robotar
Chooyin azeeʼ	Småblommig nunneört
Tó iishį́hí	Suaeda nigra
Azeeʼ ntłʼiní	Sphaeralcea coccinea
Tó bichʼosh (dichʼízhígíí)	Gelastocoridae
Áłtsínítsoh	Toxicoscordion venenosum
Tónteel zhį́ʼii	Skarvar
Niłtsínii bikétłʼóól dijoolí (daadánígíí)	Majrova
Bee álnééhí:Tl	Mall:Mall
Tʼááłáhági átʼéego:Bee Hazʼáanii	Kategori:Juridik
Tʼááłáhági átʼéego:Kéyah daʼnaaznilígíí dóó kéyah biłhaʼdaʼhaasdzoígíí	Kategori:Världens länder
Wikiibíídiiya:Dahwéetʼaahígíí	Wikipedia:Administratörer
Wikiibíídiiya:Botígíí beehazʼą́ąnii	Wikipedia:Robotar
Azeeʼbíniʼí	Lupinus argenteus
Tłʼézhiiłtsxooí	Adejeania
Azeeʼ nichʼiʼí	Phacelia crenulata
Ííjip	Egypten
Dlodziłgaii bitseeʼ (tłʼoh)	Skäggräs
Bee álnééhí:Bot	Mall:Bot
Deeteel Bikéyah	Kanada
Tsʼíʼii bitʼaʼ ádinígíí	Chionea
Wikiibíídiiya:Baa haneʼ	Wikipedia:Om
Tʼááłáhági átʼéego:Béésh bichʼahníí bikéyah	Kategori:Europas länder
Tʼááłáhági átʼéego:Choyoołʼįįhí Bizaad	Kategori:Användare efter språk
Anáʼálwoʼ:Wikiibíídiiya beehazʼą́ąnii	Wikipedia:Policy och riktlinjer
Tséłnííʼjí (chʼil)	Adiantum capillus-veneris
Tsékʼi naʼałchʼízhii	Nässelisop
Séigoʼischʼííʼ (chʼil)	Aliciella leptomeria
Azeeʼ ntłʼinítsoh	Potentilla pensylvanica
Hazéí yiltʼąąʼí	Aquilegia elegantula
Azeetłʼohí	Eremogone aculeata
Mąʼii náʼoołjił azeeʼ	Astragalus kentrophyta
Bee álnééhí:Softredirect	Mall:Mjuk omdirigering
Chʼosh chʼééh digháhii	Snäckor
Tłʼoh hosh	Tagghirs
Azeeʼ naneesdizí	Boechera perennans
Tʼááłáhági átʼéego:Saad	Kategori:Språk
Wikiibíídiiya:General disclaimer	Wikipedia:Allmänt förbehåll
Tʼááłáhági átʼéego:Noindexed pages	Kategori:Icke-indexerade sidor
Wikiibíídiiya:Statistics	Wikipedia:Statistik
Kʼíłtsíniih	Calochortus luteus
Nátʼoh niłchiin	Castilleja affinis
Bįįhdą́ą́ʼ	Ceanothus fendleri
Tʼąąʼnázbąsí	Cercis occidentalis
Tséʼésdaazí	Cercocarpus montanus
Nahatʼeʼiitsoh	Känguru
Azeeʼ yishtłʼish	Dvärgcollinsia
Chʼáchʼosh azeeʼ	Cordylanthus ramosus
Tʼiis bichʼosh (níłtsą́goʼ)	Plectrodera scalator
Hazaʼaleehtsoh	Cymopterus purpurascens
Niʼtsʼǫǫsii	Dalea candida
Jaaniłtsʼílí (chʼil)	Trifolium wormskioldii
Naʼastsʼǫǫsí yiltʼąąʼí	Trifolium eriocephalum
Ayání bichʼil	Mexikohattar
Azeeʼitʼééł	Luddkämpar
Bikéétsíín ditłʼooí	Tetraneuris
Kʼihooteelí	Delphinium bicolor
Níłtsą́goʼtsoh	Derobrachus geminatus
Ostseʼtsoh	Grått stillfrö
Chʼil hochʼid	Dithyrea
Łóóʼ hashkéhéchilí	Havsmusartade fiskar
Tʼááłáhági átʼéego:Living people	Kategori:Levande personer
Tʼááłáhági átʼéego:Béésh bee akʼeʼelchíhí tʼáá bí nitsékeesígíí	Kategori:Datasystem
Naayízí (chʼil)	Squash (växt)
Zééʼiilwoʼii ntsaaígíí	Elymus elymoides
Tłʼoh azihii łibáhígíí	Ephedra torreyana
Dikos azeeʼ (chʼil)	Ephedra viridis
Niʼhaghandii (chʼil)	Eriogonum heermannii
Biłnátʼohii	Eriogonum jamesii
Bisńdíshchííʼ biʼáadii	Eriogonum microthecum
Bee álnééhí:!	Mall:!
Bee álnééhí:Bots	Mall:Bots
Chʼil ntłʼizí	Fendlera rupicola
Tʼááłáhági átʼéego:Naaltsoos	Kategori:Böcker
Bee álnééhí:Wikisource	Mall:Wikisource
Bee álnééhí:Babel	Mall:Babel
Bee álnééhí:Commons	Mall:Commons
Bitʼąąʼdzisgai	Frasera albomarginata
Bee álnééhí:Stub	Mall:Stub
Bee álnééhí:User af-1	Mall:Användare af-1
Bee álnééhí:User als-1	Mall:Användare als-1
Bee álnééhí:User ar-1	Mall:Användare ar-1
Bee álnééhí:User az	Mall:Användare az
Bee álnééhí:User eo-1	Mall:Användare eo-1
Bee álnééhí:See also	Mall:Se även
Bee álnééhí:User da-2	Mall:Användare da-2
Bee álnééhí:User da	Mall:Användare da
Bee álnééhí:User ca-1	Mall:Användare ca-1
Bee álnééhí:User ca-4	Mall:Användare ca-4
Bee álnééhí:User be-2	Mall:Användare be-2
Bee álnééhí:User da-1	Mall:Användare da-1
Bee álnééhí:User cs-1	Mall:Användare cs-1
Bee álnééhí:User bg-1	Mall:Användare bg-1
Bee álnééhí:User eo-3	Mall:Användare eo-3
Bee álnééhí:User de	Mall:Användare de
Bee álnééhí:User de-1	Mall:Användare de-1
Bee álnééhí:User eu-4	Mall:Användare eu-4
Bee álnééhí:User et-1	Mall:Användare et-1
Bee álnééhí:User el	Mall:Användare el
Bee álnééhí:User es	Mall:Användare es
Bee álnééhí:User de-3	Mall:Användare de-3
Bee álnééhí:User en-3	Mall:Användare en-3
Bee álnééhí:User el-1	Mall:Användare el-1
Bee álnééhí:User en-1	Mall:Användare en-1
Bee álnééhí:User en-2	Mall:Användare en-2
Bee álnééhí:User eo-2	Mall:Användare eo-2
Bee álnééhí:User en-4	Mall:Användare en-4
Bee álnééhí:User fi	Mall:Användare fi
Bee álnééhí:User en-0	Mall:Användare en-0
Bee álnééhí:User en	Mall:Användare en
Bee álnééhí:User de-2	Mall:Användare de-2
Bee álnééhí:User es-1	Mall:Användare es-1
Bee álnééhí:User fa	Mall:Användare fa
Bee álnééhí:User fi-1	Mall:Användare fi-1
Bee álnééhí:User fr-1	Mall:Användare fr-1
Atsá nátʼoh	Bollgilia
Bee álnééhí:User ia-2	Mall:Användare ia-2
Bee álnééhí:User he-2	Mall:Användare he-2
Bee álnééhí:User he-1	Mall:Användare he-1
Bee álnééhí:User hu	Mall:Användare hu
Bee álnééhí:User id-3	Mall:Användare id-3
Bee álnééhí:User io-3	Mall:Användare io-3
Bee álnééhí:User it-3	Mall:Användare it-3
Bee álnééhí:User grc-1	Mall:Användare grc-1
Bee álnééhí:User ja-4	Mall:Användare ja-4
Bee álnééhí:User sk	Mall:Användare sk
Bee álnééhí:User tr-2	Mall:Användare tr-2
Bee álnééhí:User fr-2	Mall:Användare fr-2
Bee álnééhí:User tr	Mall:Användare tr
Bee álnééhí:User ja	Mall:Användare ja
Bee álnééhí:User ja-1	Mall:Användare ja-1
Bee álnééhí:User it-1	Mall:Användare it-1
Bee álnééhí:User hr-1	Mall:Användare hr-1
Bee álnééhí:User fr	Mall:Användare fr
Bee álnééhí:User he	Mall:Användare he
Dlǫ́ʼii azeeʼ	Ipomopsis gunnisonii
Tádídíín dootłʼizh (tłʼízí azeeʼ)	Delphinium scaposum
Azeeʼ noodǫ́zígíí	Dalea lanata
Bisdááʼáshchʼil	Purshia glandulosa
Tsʼíshazeeʼ	Physaria newberryi
Naʼachííʼ azeeʼ	Euphorbia brachycera
Tááʼyiilchóshii	Astragalus allochrous
Dishchʼid azeeʼ	Cordylanthus kingii
Áłchíníłchííʼ (chʼil)	Calochortus gunnisonii
Tłʼiishtsoh bichʼil	Frasera paniculata
Azeeʼ haajinítsoh	Lithospermum multiflorum
Iináájí azeeʼ	Penstemon ambiguus
Azeeʼ awoshí	Ribes pinetorum
Azeeʼ biiʼ jíchiiʼ	Astragalus lonchocarpus
Chʼółchiin	Pseudocymopterus montanus
Łeeʼazeeʼ	Eriogonum alatum
Atsá chʼil	Lupinus kingii
Tʼááłáhági átʼéego:Chʼosh bijáád hastánígíí	Kategori:Insekter
Tʼááłáhági átʼéego:Choyoołʼįįhí uk	Kategori:Användare uk
Tʼááłáhági átʼéego:Choyoołʼįįhí uk-N	Kategori:Användare uk-N
Tʼááłáhági átʼéego:Chʼiyáán	Kategori:Mat
Bee álnééhí:User sv	Mall:Användare sv
Bee álnééhí:SIL	Mall:Språk/kodlista
Bee álnééhí:User it	Mall:Användare it
Bee álnééhí:User uk	Mall:Användare uk
Bee álnééhí:User es-2	Mall:Användare es-2
Tʼááłáhági átʼéego:Choyoołʼįįhí ms	Kategori:Användare ms
Tʼááłáhági átʼéego:Choyoołʼįįhí fr-1	Kategori:Användare fr-1
Bee álnééhí:Image label	Mall:Image label
Tʼááłáhági átʼéego:Atsá dóó Giní Ndahalinígíí	Kategori:Falconiformes
Bee álnééhí:User hi-3	Mall:Användare hi-3
Tʼááłáhági átʼéego:Choyoołʼįįhí en-4	Kategori:Användare en-4
Tʼááłáhági átʼéego:Choyoołʼįįhí en	Kategori:Användare en
Tʼááłáhági átʼéego:Choyoołʼįįhí zh	Kategori:Användare zh
Tʼááłáhági átʼéego:Choyoołʼįįhí zh-N	Kategori:Användare zh-N
Tʼááłáhági átʼéego:Choyoołʼįįhí en-2	Kategori:Användare en-2
Bee álnééhí:User eo	Mall:Användare eo
Bee álnééhí:User zh	Mall:Användare zh
Bee álnééhí:User ru-4	Mall:Användare ru-4
Bee álnééhí:GeoTemplate	Mall:GeoTemplate
Bee álnééhí:User nl-1	Mall:Användare nl-1
Bee álnééhí:User nl-2	Mall:Användare nl-2
Tʼááłáhági átʼéego:Néʼéshjaaʼ	Kategori:Ugglor
Tʼááłáhági átʼéego:Choyoołʼįįhí hi	Kategori:Användare hi
Tʼááłáhági átʼéego:Choyoołʼįįhí ms-N	Kategori:Användare ms-N
Tłʼoh niłchiin	Hedeoma drummondii
Tʼááłáhági átʼéego:Dził	Kategori:Berg
Bee álnééhí:User ru	Mall:Användare ru
Tʼááłáhági átʼéego:Kéyah dah siʼánígíí	Kategori:Amerika
Tʼááłáhági átʼéego:Choyoołʼįįhí bizaad-Templates	Kategori:Babelmallar
Bee álnééhí:Archive	Mall:Arkivbox
Bee álnééhí:User eo-4	Mall:Användare eo-4
Tʼááłáhági átʼéego:Siláołtsooí	Kategori:Militärväsen
Tʼááłáhági átʼéego:Naʼashǫ́ʼii	Kategori:Ödlor
Bee álnééhí:Tb	Mall:Talkback
Bee álnééhí:Pt elements	Mall:Periodiska systemet navbox
Bee álnééhí:User pl	Mall:Användare pl
Bee álnééhí:User nl	Mall:Användare nl-N
Bee álnééhí:User no-2	Mall:Användare no-2
Bee álnééhí:Image label end	Mall:Image label end
Bee álnééhí:Userpage	Mall:Wikipediaanvändare
Bee álnééhí:Emergency-bot-shutoff	Mall:Nödstopp för robot
Bee álnééhí:User pl-1	Mall:Användare pl-1
Bee álnééhí:Image label small	Mall:Image label small
Bee álnééhí:User fr-3	Mall:Användare fr-3
Bee álnééhí:User lt	Mall:Användare lt
Bee álnééhí:User nds-1	Mall:Användare nds-1
Tʼááłáhági átʼéego:Hosh	Kategori:Cactaceae
Díłdánii (Ałtsʼáʼáztiin)	Vaktlar
Bee álnééhí:User tr-4	Mall:Användare tr-4
Bee álnééhí:User is-2	Mall:Användare is-2
Bee álnééhí:User en-5	Mall:Användare en-5
Tʼááłáhági átʼéego:Choyoołʼįįhí ja-N	Kategori:Användare ja-N
Bee álnééhí:@	Mall:@
Tʼááłáhági átʼéego:Tłʼoh	Kategori:Poaceae
Bee álnééhí:Ałtsʼáʼáztiin	Mall:Förgrening
Bee álnééhí:User ksh	Mall:Användare ksh
Bee álnééhí:User yue-3	Mall:Användare zh-yue-3
Bee álnééhí:User no	Mall:Användare no
Bee álnééhí:User yue-1	Mall:Användare zh-yue-1
Bee álnééhí:Chʼiyáánbiiʼ	Mall:Näringsvärden
Bee álnééhí:User sv-2	Mall:Användare sv-2
Bee álnééhí:User it-2	Mall:Användare it-2
Tʼááłáhági átʼéego:Kǫʼ naʼałbąąsii	Kategori:Spårtrafik
Bee álnééhí:User pt-2	Mall:Användare pt-2
Bee álnééhí:User ro	Mall:Användare ro
Bee álnééhí:User lv	Mall:Användare lv
Tʼááłáhági átʼéego:Choyoołʼįįhí vi-3	Kategori:Användare vi-3
Bee álnééhí:User la-1	Mall:Användare la-1
Tʼááłáhági átʼéego:Templates/doc	Kategori:Malldokumentation
Tʼááłáhági átʼéego:Choyoołʼįįhí yue	Kategori:Användare zh-yue
Tʼááłáhági átʼéego:Choyoołʼįįhí mzn	Kategori:Användare mzn
Tʼááłáhági átʼéego:Choyoołʼįįhí az	Kategori:Användare az
Tʼááłáhági átʼéego:Choyoołʼįįhí be	Kategori:Användare be
Tʼááłáhági átʼéego:Choyoołʼįįhí nb-N	Kategori:Användare nb-N
Tʼááłáhági átʼéego:Choyoołʼįįhí bs	Kategori:Användare bs
Tʼááłáhági átʼéego:Choyoołʼįįhí hr	Kategori:Användare hr
Tʼááłáhági átʼéego:Choyoołʼįįhí sk	Kategori:Användare sk
Tʼááłáhági átʼéego:Choyoołʼįįhí sl	Kategori:Användare sl
Tʼááłáhági átʼéego:Choyoołʼįįhí eo	Kategori:Användare eo
Tʼááłáhági átʼéego:Choyoołʼįįhí et	Kategori:Användare et
Tʼááłáhági átʼéego:Choyoołʼįįhí fr	Kategori:Användare fr
Tʼááłáhági átʼéego:Choyoołʼįįhí gl	Kategori:Användare gl
Tʼááłáhági átʼéego:Choyoołʼįįhí cy	Kategori:Användare cy
Tʼááłáhági átʼéego:Choyoołʼįįhí hu-N	Kategori:Användare hu-N
Tʼááłáhági átʼéego:Choyoołʼįįhí id	Kategori:Användare id
Tʼááłáhági átʼéego:Choyoołʼįįhí ia	Kategori:Användare ia
Tʼááłáhági átʼéego:Choyoołʼįįhí ga	Kategori:Användare ga
Tʼááłáhági átʼéego:Choyoołʼįįhí ja	Kategori:Användare ja
Tʼááłáhági átʼéego:Choyoołʼįįhí rn	Kategori:Användare rn
Tʼááłáhági átʼéego:Choyoołʼįįhí la	Kategori:Användare la
Tʼááłáhági átʼéego:Choyoołʼįįhí li	Kategori:Användare li
Tʼááłáhági átʼéego:Choyoołʼįįhí lt	Kategori:Användare lt
Tʼááłáhági átʼéego:Choyoołʼįįhí mk	Kategori:Användare mk
Tʼááłáhági átʼéego:Choyoołʼįįhí mg	Kategori:Användare mg
Tʼááłáhági átʼéego:Choyoołʼįįhí mwl	Kategori:Användare mwl
Tʼááłáhági átʼéego:Choyoołʼįįhí nn	Kategori:Användare nn
Tʼááłáhági átʼéego:Choyoołʼįįhí oc	Kategori:Användare oc
Tʼááłáhági átʼéego:Choyoołʼįįhí pt	Kategori:Användare pt
Tʼááłáhági átʼéego:Choyoołʼįįhí ro	Kategori:Användare ro
Tʼááłáhági átʼéego:Choyoołʼįįhí sh	Kategori:Användare sh
Tʼááłáhági átʼéego:Choyoołʼįįhí sv	Kategori:Användare sv
Tʼááłáhági átʼéego:Choyoołʼįįhí sw	Kategori:Användare sw
Tʼááłáhági átʼéego:Choyoołʼįįhí sa	Kategori:Användare sa
Tʼááłáhági átʼéego:Choyoołʼįįhí th	Kategori:Användare th
Tʼááłáhági átʼéego:Choyoołʼįįhí ta	Kategori:Användare ta
Tʼááłáhági átʼéego:Choyoołʼįįhí cs-3	Kategori:Användare cs-3
Tʼááłáhági átʼéego:Choyoołʼįįhí et-3	Kategori:Användare et-3
Tʼááłáhági átʼéego:Choyoołʼįįhí fr-3	Kategori:Användare fr-3
Tʼááłáhági átʼéego:Choyoołʼįįhí cy-3	Kategori:Användare cy-3
Tʼááłáhági átʼéego:Choyoołʼįįhí ia-3	Kategori:Användare ia-3
Tʼááłáhági átʼéego:Choyoołʼįįhí it-3	Kategori:Användare it-3
Tʼááłáhági átʼéego:Choyoołʼįįhí ja-3	Kategori:Användare ja-3
Tʼááłáhági átʼéego:Choyoołʼįįhí li-3	Kategori:Användare li-3
Tʼááłáhági átʼéego:Choyoołʼįįhí lt-3	Kategori:Användare lt-3
Tʼááłáhági átʼéego:Choyoołʼįįhí mk-3	Kategori:Användare mk-3
Tʼááłáhági átʼéego:Choyoołʼįįhí nl-3	Kategori:Användare nl-3
Tʼááłáhági átʼéego:Choyoołʼįįhí no-3	Kategori:Användare no-3
Tʼááłáhági átʼéego:Choyoołʼįįhí pl-3	Kategori:Användare pl-3
Tʼááłáhági átʼéego:Choyoołʼįįhí sw-3	Kategori:Användare sw-3
Tʼááłáhági átʼéego:Choyoołʼįįhí tr-3	Kategori:Användare tr-3
Tʼááłáhági átʼéego:Choyoołʼįįhí ar-3	Kategori:Användare ar-3
Tʼááłáhági átʼéego:Choyoołʼįįhí an-1	Kategori:Användare an-1
Tʼááłáhági átʼéego:Choyoołʼįįhí be-1	Kategori:Användare be-1
Tʼááłáhági átʼéego:Choyoołʼįįhí cs-1	Kategori:Användare cs-1
Tʼááłáhági átʼéego:Choyoołʼįįhí da-1	Kategori:Användare da-1
Tʼááłáhági átʼéego:Choyoołʼįįhí sl-1	Kategori:Användare sl-1
Tʼááłáhági átʼéego:Choyoołʼįįhí et-1	Kategori:Användare et-1
Tʼááłáhági átʼéego:Choyoołʼįįhí fi-1	Kategori:Användare fi-1
Tʼááłáhági átʼéego:Choyoołʼįįhí cy-1	Kategori:Användare cy-1
Tʼááłáhági átʼéego:Choyoołʼįįhí hi-1	Kategori:Användare hi-1
Tʼááłáhági átʼéego:Choyoołʼįįhí ia-1	Kategori:Användare ia-1
Tʼááłáhági átʼéego:Choyoołʼįįhí ga-1	Kategori:Användare ga-1
Tʼááłáhági átʼéego:Choyoołʼįįhí jv-1	Kategori:Användare jv-1
Tʼááłáhági átʼéego:Choyoołʼįįhí ku-1	Kategori:Användare ku-1
Tʼááłáhági átʼéego:Choyoołʼįįhí lv-1	Kategori:Användare lv-1
Tʼááłáhági átʼéego:Choyoołʼįįhí mk-1	Kategori:Användare mk-1
Tʼááłáhági átʼéego:Choyoołʼįįhí nl-1	Kategori:Användare nl-1
Tʼááłáhági átʼéego:Choyoołʼįįhí oc-1	Kategori:Användare oc-1
Tʼááłáhági átʼéego:Choyoołʼįįhí pl-1	Kategori:Användare pl-1
Tʼááłáhági átʼéego:Choyoołʼįįhí ro-1	Kategori:Användare ro-1
Tʼááłáhági átʼéego:Choyoołʼįįhí sh-1	Kategori:Användare sh-1
Tʼááłáhági átʼéego:Choyoołʼįįhí sw-1	Kategori:Användare sw-1
Tʼááłáhági átʼéego:Choyoołʼįįhí sa-1	Kategori:Användare sa-1
Tʼááłáhági átʼéego:Choyoołʼįįhí tr-1	Kategori:Användare tr-1
Tʼááłáhági átʼéego:Choyoołʼįįhí ar-1	Kategori:Användare ar-1
Tʼááłáhági átʼéego:Choyoołʼįįhí cs-4	Kategori:Användare cs-4
Tʼááłáhági átʼéego:Choyoołʼįįhí ko-4	Kategori:Användare ko-4
Tʼááłáhági átʼéego:Choyoołʼįįhí et-4	Kategori:Användare et-4
Tʼááłáhági átʼéego:Choyoołʼįįhí fr-4	Kategori:Användare fr-4
Tʼááłáhági átʼéego:Choyoołʼįįhí hu-4	Kategori:Användare hu-4
Tʼááłáhági átʼéego:Choyoołʼįįhí ia-4	Kategori:Användare ia-4
Tʼááłáhági átʼéego:Choyoołʼįįhí it-4	Kategori:Användare it-4
Tʼááłáhági átʼéego:Choyoołʼįįhí li-4	Kategori:Användare li-4
Tʼááłáhági átʼéego:Choyoołʼįįhí pl-4	Kategori:Användare pl-4
Tʼááłáhági átʼéego:Choyoołʼįįhí ar-4	Kategori:Användare ar-4
Tʼááłáhági átʼéego:Choyoołʼįįhí mzn-2	Kategori:Användare mzn-2
Tʼááłáhági átʼéego:Choyoołʼįįhí be-2	Kategori:Användare be-2
Tʼááłáhági átʼéego:Choyoołʼįįhí bs-2	Kategori:Användare bs-2
Tʼááłáhági átʼéego:Choyoołʼįįhí cs-2	Kategori:Användare cs-2
Tʼááłáhági átʼéego:Choyoołʼįįhí da-2	Kategori:Användare da-2
Tʼááłáhági átʼéego:Choyoołʼįįhí sk-2	Kategori:Användare sk-2
Tʼááłáhági átʼéego:Choyoołʼįįhí sl-2	Kategori:Användare sl-2
Tʼááłáhági átʼéego:Choyoołʼįįhí et-2	Kategori:Användare et-2
Tʼááłáhági átʼéego:Choyoołʼįįhí fr-2	Kategori:Användare fr-2
Tʼááłáhági átʼéego:Choyoołʼįįhí cy-2	Kategori:Användare cy-2
Tʼááłáhági átʼéego:Choyoołʼįįhí hi-2	Kategori:Användare hi-2
Tʼááłáhági átʼéego:Choyoołʼįįhí hu-2	Kategori:Användare hu-2
Tʼááłáhági átʼéego:Choyoołʼįįhí ia-2	Kategori:Användare ia-2
Tʼááłáhági átʼéego:Choyoołʼįįhí it-2	Kategori:Användare it-2
Tʼááłáhági átʼéego:Choyoołʼįįhí ja-2	Kategori:Användare ja-2
Tʼááłáhági átʼéego:Choyoołʼįįhí rn-2	Kategori:Användare rn-2
Tʼááłáhági átʼéego:Choyoołʼįįhí la-2	Kategori:Användare la-2
Tʼááłáhági átʼéego:Choyoołʼįįhí mwl-2	Kategori:Användare mwl-2
Tʼááłáhági átʼéego:Choyoołʼįįhí nl-2	Kategori:Användare nl-2
Tʼááłáhági átʼéego:Choyoołʼįįhí oc-2	Kategori:Användare oc-2
Tʼááłáhági átʼéego:Choyoołʼįįhí pl-2	Kategori:Användare pl-2
Tʼááłáhági átʼéego:Choyoołʼįįhí sh-2	Kategori:Användare sh-2
Tʼááłáhági átʼéego:Choyoołʼįįhí sv-2	Kategori:Användare sv-2
Tʼááłáhági átʼéego:Choyoołʼįįhí sw-2	Kategori:Användare sw-2
Tʼááłáhági átʼéego:Choyoołʼįįhí tr-2	Kategori:Användare tr-2
Tʼááłáhági átʼéego:Choyoołʼįįhí ar-2	Kategori:Användare ar-2
Tʼááłáhági átʼéego:Choyoołʼįįhí hy-N	Kategori:Användare hy-N
Tʼááłáhági átʼéego:Choyoołʼįįhí ast-N	Kategori:Användare ast-N
Tʼááłáhági átʼéego:Choyoołʼįįhí be-N	Kategori:Användare be-N
Tʼááłáhági átʼéego:Choyoołʼįįhí cs-N	Kategori:Användare cs-N
Tʼááłáhági átʼéego:Choyoołʼįįhí ko-N	Kategori:Användare ko-N
Tʼááłáhági átʼéego:Choyoołʼįįhí hr-N	Kategori:Användare hr-N
Tʼááłáhági átʼéego:Choyoołʼįįhí sl-N	Kategori:Användare sl-N
Tʼááłáhági átʼéego:Choyoołʼįįhí et-N	Kategori:Användare et-N
Tʼááłáhági átʼéego:Choyoołʼįįhí fr-N	Kategori:Användare fr-N
Tʼááłáhági átʼéego:Choyoołʼįįhí fy-N	Kategori:Användare fy-N
Tʼááłáhági átʼéego:Choyoołʼįįhí gl-N	Kategori:Användare gl-N
Tʼááłáhági átʼéego:Choyoołʼįįhí cy-N	Kategori:Användare cy-N
Tʼááłáhági átʼéego:Choyoołʼįįhí id-N	Kategori:Användare id-N
Tʼááłáhági átʼéego:Choyoołʼįįhí ia-N	Kategori:Användare ia-N
Tʼááłáhági átʼéego:Choyoołʼįįhí is-N	Kategori:Användare is-N
Tʼááłáhági átʼéego:Choyoołʼįįhí it-N	Kategori:Användare it-N
Tʼááłáhági átʼéego:Choyoołʼįįhí ku-N	Kategori:Användare ku-N
Tʼááłáhági átʼéego:Choyoołʼįįhí lv-N	Kategori:Användare lv-N
Tʼááłáhági átʼéego:Choyoołʼįįhí li-N	Kategori:Användare li-N
Tʼááłáhági átʼéego:Choyoołʼįįhí lt-N	Kategori:Användare lt-N
Tʼááłáhági átʼéego:Choyoołʼįįhí lb-N	Kategori:Användare lb-N
Tʼááłáhági átʼéego:Choyoołʼįįhí mg-N	Kategori:Användare mg-N
Tʼááłáhági átʼéego:Choyoołʼįįhí nl-N	Kategori:Användare nl-N
Tʼááłáhági átʼéego:Choyoołʼįįhí no-N	Kategori:Användare no-N
Tʼááłáhági átʼéego:Choyoołʼįįhí nn-N	Kategori:Användare nn-N
Tʼááłáhági átʼéego:Choyoołʼįįhí or-N	Kategori:Användare or-N
Tʼááłáhági átʼéego:Choyoołʼįįhí ru-N	Kategori:Användare ru-N
Tʼááłáhági átʼéego:Choyoołʼįįhí sw-N	Kategori:Användare sw-N
Tʼááłáhági átʼéego:Choyoołʼįįhí ta-N	Kategori:Användare ta-N
Tʼááłáhági átʼéego:Choyoołʼįįhí ar-N	Kategori:Användare ar-N
Bee álnééhí:User yue	Mall:Användare zh-yue
Tʼááłáhági átʼéego:Choyoołʼįįhí eu-3	Kategori:Användare eu-3
Tʼááłáhági átʼéego:Choyoołʼįįhí eu-N	Kategori:Användare eu-N
Tʼááłáhági átʼéego:Choyoołʼįįhí af	Kategori:Användare af
Tʼááłáhági átʼéego:Choyoołʼįįhí af-1	Kategori:Användare af-1
Tʼááłáhági átʼéego:Choyoołʼįįhí af-2	Kategori:Användare af-2
Tʼááłáhági átʼéego:Choyoołʼįįhí af-3	Kategori:Användare af-3
Tʼááłáhági átʼéego:Choyoołʼįįhí af-4	Kategori:Användare af-4
Tʼááłáhági átʼéego:Choyoołʼįįhí af-N	Kategori:Användare af-N
Tʼááłáhági átʼéego:Choyoołʼįįhí als	Kategori:Användare als
Tʼááłáhági átʼéego:Choyoołʼįįhí als-1	Kategori:Användare als-1
Tʼááłáhági átʼéego:Choyoołʼįįhí an	Kategori:Användare an
Tʼááłáhági átʼéego:Choyoołʼįįhí ar	Kategori:Användare ar
Tʼááłáhági átʼéego:Choyoołʼįįhí ast	Kategori:Användare ast
Tʼááłáhági átʼéego:Choyoołʼįįhí az-2	Kategori:Användare az-2
Tʼááłáhági átʼéego:Choyoołʼįįhí az-N	Kategori:Användare az-N
Tʼááłáhági átʼéego:Choyoołʼįįhí bg	Kategori:Användare bg
Tʼááłáhági átʼéego:Choyoołʼįįhí bg-1	Kategori:Användare bg-1
Tʼááłáhági átʼéego:Choyoołʼįįhí bg-N	Kategori:Användare bg-N
Tʼááłáhági átʼéego:Choyoołʼįįhí bn	Kategori:Användare bn
Tʼááłáhági átʼéego:Choyoołʼįįhí bn-2	Kategori:Användare bn-2
Tʼááłáhági átʼéego:Choyoołʼįįhí bn-N	Kategori:Användare bn-N
Tʼááłáhági átʼéego:Choyoołʼįįhí ca	Kategori:Användare ca
Tʼááłáhági átʼéego:Choyoołʼįįhí ca-1	Kategori:Användare ca-1
Tʼááłáhági átʼéego:Choyoołʼįįhí ca-2	Kategori:Användare ca-2
Tʼááłáhági átʼéego:Tádídíín deiyání	Kategori:Bladbaggar
Tʼááłáhági átʼéego:Choyoołʼįįhí ca-3	Kategori:Användare ca-3
Tʼááłáhági átʼéego:Choyoołʼįįhí ca-4	Kategori:Användare ca-4
Tʼááłáhági átʼéego:Choyoołʼįįhí ca-N	Kategori:Användare ca-N
Tʼááłáhági átʼéego:Choyoołʼįįhí cs	Kategori:Användare cs
Tʼááłáhági átʼéego:Choyoołʼįįhí da	Kategori:Användare da
Tʼááłáhági átʼéego:Choyoołʼįįhí sk-N	Kategori:Användare sk-N
Tʼááłáhági átʼéego:Choyoołʼįįhí da-3	Kategori:Användare da-3
Tʼááłáhági átʼéego:Choyoołʼįįhí da-4	Kategori:Användare da-4
Tʼááłáhági átʼéego:Choyoołʼįįhí de	Kategori:Användare de
Tʼááłáhági átʼéego:Choyoołʼįįhí de-2	Kategori:Användare de-2
Tʼááłáhági átʼéego:Choyoołʼįįhí de-3	Kategori:Användare de-3
Tʼááłáhági átʼéego:Choyoołʼįįhí de-4	Kategori:Användare de-4
Tʼááłáhági átʼéego:Choyoołʼįįhí de-N	Kategori:Användare de-N
Tʼááłáhági átʼéego:Choyoołʼįįhí dsb	Kategori:Användare dsb
Tʼááłáhági átʼéego:Choyoołʼįįhí dsb-1	Kategori:Användare dsb-1
Tʼááłáhági átʼéego:Choyoołʼįįhí el	Kategori:Användare el
Tʼááłáhági átʼéego:Choyoołʼįįhí el-1	Kategori:Användare el-1
Tʼááłáhági átʼéego:Choyoołʼįįhí el-2	Kategori:Användare el-2
Tʼááłáhági átʼéego:Choyoołʼįįhí el-3	Kategori:Användare el-3
Tʼááłáhági átʼéego:Choyoołʼįįhí el-N	Kategori:Användare el-N
Tʼááłáhági átʼéego:Choyoołʼįįhí en-0	Kategori:Användare en-0
Tʼááłáhági átʼéego:Choyoołʼįįhí en-3	Kategori:Användare en-3
Tʼááłáhági átʼéego:Choyoołʼįįhí en-N	Kategori:Användare en-N
Tʼááłáhági átʼéego:Choyoołʼįįhí eo-1	Kategori:Användare eo-1
Tʼááłáhági átʼéego:Choyoołʼįįhí eo-2	Kategori:Användare eo-2
Tʼááłáhági átʼéego:Choyoołʼįįhí eo-3	Kategori:Användare eo-3
Tʼááłáhági átʼéego:Choyoołʼįįhí eo-4	Kategori:Användare eo-4
Tʼááłáhági átʼéego:Choyoołʼįįhí eo-N	Kategori:Användare eo-N
Tʼááłáhági átʼéego:Choyoołʼįįhí es	Kategori:Användare es
Tʼááłáhági átʼéego:Choyoołʼįįhí es-1	Kategori:Användare es-1
Tʼááłáhági átʼéego:Choyoołʼįįhí es-2	Kategori:Användare es-2
Tʼááłáhági átʼéego:Choyoołʼįįhí es-3	Kategori:Användare es-3
Tʼááłáhági átʼéego:Choyoołʼįįhí es-4	Kategori:Användare es-4
Tʼááłáhági átʼéego:Choyoołʼįįhí es-N	Kategori:Användare es-N
Tʼááłáhági átʼéego:Choyoołʼįįhí eu	Kategori:Användare eu
Tʼááłáhági átʼéego:Choyoołʼįįhí eu-1	Kategori:Användare eu-1
Tʼááłáhági átʼéego:Choyoołʼįįhí eu-2	Kategori:Användare eu-2
Tʼááłáhági átʼéego:Choyoołʼįįhí eu-4	Kategori:Användare eu-4
Tʼááłáhági átʼéego:Choyoołʼįįhí fa	Kategori:Användare fa
Tʼááłáhági átʼéego:Choyoołʼįįhí fa-3	Kategori:Användare fa-3
Tʼááłáhági átʼéego:Choyoołʼįįhí fa-N	Kategori:Användare fa-N
Tʼááłáhági átʼéego:Choyoołʼįįhí fi	Kategori:Användare fi
Tʼááłáhági átʼéego:Choyoołʼįįhí fi-2	Kategori:Användare fi-2
Tʼááłáhági átʼéego:Gólízhii	Kategori:Skunkar
Tʼááłáhági átʼéego:Choyoołʼįįhí fi-3	Kategori:Användare fi-3
Tʼááłáhági átʼéego:Choyoołʼįįhí fi-4	Kategori:Användare fi-4
Tʼááłáhági átʼéego:Choyoołʼįįhí fi-N	Kategori:Användare fi-N
Tʼááłáhági átʼéego:Choyoołʼįįhí fy	Kategori:Användare fy
Tʼááłáhági átʼéego:Choyoołʼįįhí fy-1	Kategori:Användare fy-1
Tʼááłáhági átʼéego:Choyoołʼįįhí ga-2	Kategori:Användare ga-2
Tʼááłáhági átʼéego:Choyoołʼįįhí ga-3	Kategori:Användare ga-3
Tʼááłáhági átʼéego:Choyoołʼįįhí ga-N	Kategori:Användare ga-N
Tʼááłáhági átʼéego:Choyoołʼįįhí grc	Kategori:Användare grc
Tʼááłáhági átʼéego:Choyoołʼįįhí grc-1	Kategori:Användare grc-1
Tʼááłáhági átʼéego:Choyoołʼįįhí grc-2	Kategori:Användare grc-2
Tʼááłáhági átʼéego:Choyoołʼįįhí grc-3	Kategori:Användare grc-3
Tʼááłáhági átʼéego:Choyoołʼįįhí he	Kategori:Användare he
Tʼááłáhági átʼéego:Choyoołʼįįhí he-1	Kategori:Användare he-1
Tʼááłáhági átʼéego:Choyoołʼįįhí he-2	Kategori:Användare he-2
Tʼááłáhági átʼéego:Choyoołʼįįhí he-3	Kategori:Användare he-3
Tʼááłáhági átʼéego:Choyoołʼįįhí he-N	Kategori:Användare he-N
Tʼááłáhági átʼéego:Choyoołʼįįhí hr-1	Kategori:Användare hr-1
Tʼááłáhági átʼéego:Choyoołʼįįhí hr-2	Kategori:Användare hr-2
Tʼááłáhági átʼéego:Choyoołʼįįhí hr-3	Kategori:Användare hr-3
Tʼááłáhági átʼéego:Choyoołʼįįhí hr-4	Kategori:Användare hr-4
Tʼááłáhági átʼéego:Choyoołʼįįhí hsb	Kategori:Användare hsb
Tʼááłáhági átʼéego:Choyoołʼįįhí hsb-1	Kategori:Användare hsb-1
Tʼááłáhági átʼéego:Choyoołʼįįhí hu	Kategori:Användare hu
Tʼááłáhági átʼéego:Choyoołʼįįhí hu-1	Kategori:Användare hu-1
Tʼááłáhági átʼéego:Choyoołʼįįhí hu-3	Kategori:Användare hu-3
Tʼááłáhági átʼéego:Choyoołʼįįhí hy	Kategori:Användare hy
Tʼááłáhági átʼéego:Choyoołʼįįhí hy-1	Kategori:Användare hy-1
Tʼááłáhági átʼéego:Choyoołʼįįhí hy-2	Kategori:Användare hy-2
Tʼááłáhági átʼéego:Choyoołʼįįhí hy-3	Kategori:Användare hy-3
Tʼááłáhági átʼéego:Choyoołʼįįhí id-1	Kategori:Användare id-1
Tʼááłáhági átʼéego:Choyoołʼįįhí id-3	Kategori:Användare id-3
Tʼááłáhági átʼéego:Choyoołʼįįhí io	Kategori:Användare io
Tʼááłáhági átʼéego:Choyoołʼįįhí io-3	Kategori:Användare io-3
Tʼááłáhági átʼéego:Choyoołʼįįhí is	Kategori:Användare is
Tʼááłáhági átʼéego:Choyoołʼįįhí is-1	Kategori:Användare is-1
Tʼááłáhági átʼéego:Choyoołʼįįhí is-2	Kategori:Användare is-2
Tʼááłáhági átʼéego:Choyoołʼįįhí is-3	Kategori:Användare is-3
Tʼááłáhági átʼéego:Choyoołʼįįhí als-N	Kategori:Användare als-N
Bee álnééhí:User la-3	Mall:Användare la-3
Tʼááłáhági átʼéego:Choyoołʼįįhí pt-3	Kategori:Användare pt-3
Tʼááłáhági átʼéego:Choyoołʼįįhí pl-N	Kategori:Användare pl-N
Tʼááłáhági átʼéego:Choyoołʼįįhí pt-1	Kategori:Användare pt-1
Tʼááłáhági átʼéego:Choyoołʼįįhí ka-1	Kategori:Användare ka-1
Tʼááłáhági átʼéego:Choyoołʼįįhí it	Kategori:Användare it
Tʼááłáhági átʼéego:Choyoołʼįįhí it-1	Kategori:Användare it-1
Tʼááłáhági átʼéego:Choyoołʼįįhí ja-1	Kategori:Användare ja-1
Tʼááłáhági átʼéego:Choyoołʼįįhí jv	Kategori:Användare jv
Tʼááłáhági átʼéego:Choyoołʼįįhí ka	Kategori:Användare ka
Tʼááłáhági átʼéego:Choyoołʼįįhí ka-2	Kategori:Användare ka-2
Tʼááłáhági átʼéego:Choyoołʼįįhí ka-3	Kategori:Användare ka-3
Tʼááłáhági átʼéego:Choyoołʼįįhí ka-N	Kategori:Användare ka-N
Tʼááłáhági átʼéego:Choyoołʼįįhí kn	Kategori:Användare kn
Tʼááłáhági átʼéego:Choyoołʼįįhí kn-1	Kategori:Användare kn-1
Tʼááłáhági átʼéego:Choyoołʼįįhí ko	Kategori:Användare ko
Tʼááłáhági átʼéego:Wááshindoon bikéyah bił haʼdaʼhaasdzoígíí	Kategori:USA:s delstater
Tʼááłáhági átʼéego:Choyoołʼįįhí ko-1	Kategori:Användare ko-1
Tʼááłáhági átʼéego:Choyoołʼįįhí ko-2	Kategori:Användare ko-2
Tʼááłáhági átʼéego:Choyoołʼįįhí ko-3	Kategori:Användare ko-3
Tʼááłáhági átʼéego:Choyoołʼįįhí ksh	Kategori:Användare ksh
Tʼááłáhági átʼéego:Choyoołʼįįhí ksh-1	Kategori:Användare ksh-1
Tʼááłáhági átʼéego:Choyoołʼįįhí ksh-N	Kategori:Användare ksh-N
Tʼááłáhági átʼéego:Choyoołʼįįhí ku	Kategori:Användare ku
Tʼááłáhági átʼéego:Choyoołʼįįhí ku-3	Kategori:Användare ku-3
Tʼááłáhági átʼéego:Choyoołʼįįhí ku-4	Kategori:Användare ku-4
Tʼááłáhági átʼéego:Choyoołʼįįhí la-1	Kategori:Användare la-1
Tʼááłáhági átʼéego:Choyoołʼįįhí la-3	Kategori:Användare la-3
Tʼááłáhági átʼéego:Choyoołʼįįhí la-N	Kategori:Användare la-N
Tʼááłáhági átʼéego:Choyoołʼįįhí lb	Kategori:Användare lb
Tʼááłáhági átʼéego:Dibé Nitsaa Hahoodzodi kin naaznilígíí	Kategori:Orter i Colorado
Tʼááłáhági átʼéego:Choyoołʼįįhí nn-2	Kategori:Användare nn-2
Tʼááłáhági átʼéego:Choyoołʼįįhí ru-1	Kategori:Användare ru-1
Bee álnééhí:User af-4	Mall:Användare af-4
Yaaʼ bijáád hastánígíí	Djurlöss
Bee álnééhí:User sv-1	Mall:Användare sv-1
Tʼááłáhági átʼéego:Choyoołʼįįhí lv	Kategori:Användare lv
Nahasdzáán bimagnetic field	Jordens magnetfält
Tʼááłáhági átʼéego:Choyoołʼįįhí nds	Kategori:Användare nds
Tʼááłáhági átʼéego:Choyoołʼįįhí nds-1	Kategori:Användare nds-1
Tʼááłáhági átʼéego:Choyoołʼįįhí nds-2	Kategori:Användare nds-2
Tʼááłáhági átʼéego:Kéyah Ałhidadiidzooígíí dóó Ahiih Yikaígíí	Kategori:Internationella organisationer
Tʼááłáhági átʼéego:Chʼosh bijáád dahólónígíí	Kategori:Leddjur
Tʼááłáhági átʼéego:Kʼaalógii	Kategori:Dagfjärilar
Tʼááłáhági átʼéego:Tó	Kategori:Vatten
Tʼááłáhági átʼéego:Tsáʼásziʼ dóó Noodah	Kategori:Agavaceae
Tʼááłáhági átʼéego:Bidił daazdoígíí dóó daʼalghałígíí	Kategori:Rovdjur
Tʼááłáhági átʼéego:Choyoołʼįįhí nn-1	Kategori:Användare nn-1
Tʼááłáhági átʼéego:Choyoołʼįįhí nb	Kategori:Användare nb
Bee álnééhí:User sw-1	Mall:Användare sw-1
Bee álnééhí:User ka-1	Mall:Användare ka-1
Bee álnééhí:User af	Mall:Användare af
Tʼááłáhági átʼéego:Naakaii Łizhiní Bikéyah	Kategori:Afrikas länder
Bee álnééhí:User ka-3	Mall:Användare ka-3
Bee álnééhí:User da-3	Mall:Användare da-3
Bee álnééhí:User ka-4	Mall:Användare ka-4
Bee álnééhí:User ja-2	Mall:Användare ja-2
Bee álnééhí:User ko-1	Mall:Användare ko-1
Bee álnééhí:User cs	Mall:Användare cs
Bee álnééhí:User ru-2	Mall:Användare ru-2
Bee álnééhí:User es-3	Mall:Användare es-3
Bee álnééhí:User ko-3	Mall:Användare ko-3
Tʼááłáhági átʼéego:Tsin bineestʼąʼ dadíkʼǫ́zhígíí	Kategori:Citrus
Tʼááłáhági átʼéego:Choyoołʼįįhí pt-2	Kategori:Användare pt-2
Tʼááłáhági átʼéego:Choyoołʼįįhí pt-N	Kategori:Användare pt-N
Tʼááłáhági átʼéego:Choyoołʼįįhí qu	Kategori:Användare qu
Tʼááłáhági átʼéego:Choyoołʼįįhí ro-2	Kategori:Användare ro-2
Tʼááłáhági átʼéego:Choyoołʼįįhí ro-3	Kategori:Användare ro-3
Tʼááłáhági átʼéego:Choyoołʼįįhí ro-N	Kategori:Användare ro-N
Tʼááłáhági átʼéego:Choyoołʼįįhí ru	Kategori:Användare ru
Tʼááłáhági átʼéego:Choyoołʼįįhí ru-2	Kategori:Användare ru-2
Tʼááłáhági átʼéego:Choyoołʼįįhí ru-3	Kategori:Användare ru-3
Tʼááłáhági átʼéego:Choyoołʼįįhí ru-4	Kategori:Användare ru-4
Tʼááłáhági átʼéego:Choyoołʼįįhí sk-1	Kategori:Användare sk-1
Tʼááłáhági átʼéego:Choyoołʼįįhí sk-3	Kategori:Användare sk-3
Tʼááłáhági átʼéego:Choyoołʼįįhí sr	Kategori:Användare sr
Tʼááłáhági átʼéego:Choyoołʼįįhí sr-1	Kategori:Användare sr-1
Tʼááłáhági átʼéego:Choyoołʼįįhí sr-2	Kategori:Användare sr-2
Tʼááłáhági átʼéego:Choyoołʼįįhí sr-3	Kategori:Användare sr-3
Tʼááłáhági átʼéego:Choyoołʼįįhí sr-N	Kategori:Användare sr-N
Tʼááłáhági átʼéego:Choyoołʼįįhí sv-1	Kategori:Användare sv-1
Tʼááłáhági átʼéego:Choyoołʼįįhí sv-3	Kategori:Användare sv-3
Tʼááłáhági átʼéego:Choyoołʼįįhí sv-4	Kategori:Användare sv-4
Tʼááłáhági átʼéego:Choyoołʼįįhí sv-N	Kategori:Användare sv-N
Tʼááłáhági átʼéego:Choyoołʼįįhí th-N	Kategori:Användare th-N
Tʼááłáhági átʼéego:Choyoołʼįįhí tr	Kategori:Användare tr
Tʼááłáhági átʼéego:Choyoołʼįįhí tr-4	Kategori:Användare tr-4
Tʼááłáhági átʼéego:Choyoołʼįįhí tr-N	Kategori:Användare tr-N
Tʼááłáhági átʼéego:Choyoołʼįįhí uk-1	Kategori:Användare uk-1
Tʼááłáhági átʼéego:Choyoołʼįįhí uk-2	Kategori:Användare uk-2
Tʼááłáhági átʼéego:Choyoołʼįįhí uk-3	Kategori:Användare uk-3
Tʼááłáhági átʼéego:Choyoołʼįįhí uk-4	Kategori:Användare uk-4
Tʼááłáhági átʼéego:Choyoołʼįįhí vi	Kategori:Användare vi
Tʼááłáhági átʼéego:Choyoołʼįįhí vi-1	Kategori:Användare vi-1
Tʼááłáhági átʼéego:Choyoołʼįįhí vi-2	Kategori:Användare vi-2
Tʼááłáhági átʼéego:Choyoołʼįįhí vi-4	Kategori:Användare vi-4
Tʼááłáhági átʼéego:Choyoołʼįįhí vi-N	Kategori:Användare vi-N
Tʼááłáhági átʼéego:Choyoołʼįįhí yue-1	Kategori:Användare zh-yue-1
Tʼááłáhági átʼéego:Choyoołʼįįhí yue-2	Kategori:Användare zh-yue-2
Tʼááłáhági átʼéego:Choyoołʼįįhí yue-3	Kategori:Användare zh-yue-3
Tʼááłáhági átʼéego:Choyoołʼįįhí yue-4	Kategori:Användare zh-yue-4
Bee álnééhí:User ro-1	Mall:Användare ro-1
Tʼááłáhági átʼéego:Tsin ííʼáhígíí	Kategori:Träd
Bee álnééhí:User nds-2	Mall:Användare nds-2
Azeeʼ naneesdizítsʼóóz	Lithospermum canescens
Bee álnééhí:User ca	Mall:Användare ca
Tʼááłáhági átʼéego:Mágí	Kategori:Primater
Bee álnééhí:LivingP	Mall:NLP
Bee álnééhí:User sv-3	Mall:Användare sv-3
Yéʼii bidą́ą́ʼ yiltʼąąʼí	Stjärnrams
Bee álnééhí:User hy-1	Mall:Användare hy-1
Bee álnééhí:User hsb-1	Mall:Användare hsb-1
Tʼááłáhági átʼéego:Naʼiiniʼ	Kategori:Handel
Bee álnééhí:User af-3	Mall:Användare af-3
Tʼááłáhági átʼéego:Naaki góneʼ yéigo daʼahijoogą́ą́ʼ	Kategori:Andra världskriget
Íiłtłʼį́hii	Mentzelia multiflora
Íiłtłʼį́hiitsʼóóz	Mentzelia pumila
Gad niʼeełii bílátah łichíʼígíí	Kinesisk tamarisk
Chʼil abeʼétsʼóóz	Euphorbia fendleri
Tʼááłáhági átʼéego:Mósí dóó Náshdóí	Kategori:Kattdjur
Tłʼoh shoh dikʼáanii	Munroa squarrosa
Tʼááłáhági átʼéego:Tó Kéyah Bináhaazyínígíí	Kategori:Östater
Bee álnééhí:User az-2	Mall:Användare az-2
Bee álnééhí:User ca-2	Mall:Användare ca-2
Bee álnééhí:User ca-3	Mall:Användare ca-3
Bee álnééhí:User et-3	Mall:Användare et-3
Bee álnééhí:User he-3	Mall:Användare he-3
Bee álnééhí:User hy	Mall:Användare hy
Bee álnééhí:User ka	Mall:Användare ka
Bee álnééhí:User ko	Mall:Användare ko
Bee álnééhí:User ku	Mall:Användare ku
Bee álnééhí:User la-2	Mall:Användare la-2
Bee álnééhí:User mk-1	Mall:Användare mk-1
Bee álnééhí:User nn-2	Mall:Användare nn-2
Bee álnééhí:User pt	Mall:Användare pt
Bee álnééhí:User ro-2	Mall:Användare ro-2
Bee álnééhí:User ru-1	Mall:Användare ru-1
Bee álnééhí:User sk-1	Mall:Användare sk-1
Bee álnééhí:User sk-2	Mall:Användare sk-2
Bee álnééhí:User sr-1	Mall:Användare sr-1
Bee álnééhí:User uk-1	Mall:Användare uk-1
Bee álnééhí:User uk-4	Mall:Användare uk-4
Tʼááłáhági átʼéego:Naakaii Łizhiní Bikéyahdę́ę́ʼ Ndaaldeehii	Kategori:Afrikas fauna
Kʼįįʼ báhádzidígíí	Toxicodendron vernix
Tʼááłáhági átʼéego:Choyoołʼįįhí nl	Kategori:Användare nl
Tʼááłáhági átʼéego:Choyoołʼįįhí nn-3	Kategori:Användare nn-3
Tʼááłáhági átʼéego:Choyoołʼįįhí no-1	Kategori:Användare no-1
Tʼááłáhági átʼéego:Choyoołʼįįhí no-2	Kategori:Användare no-2
Tʼááłáhági átʼéego:Choyoołʼįįhí no	Kategori:Användare no
Tʼááłáhági átʼéego:Choyoołʼįįhí pi-1	Kategori:Användare pi-1
Tʼááłáhági átʼéego:Choyoołʼįįhí zh-1	Kategori:Användare zh-1
Tʼááłáhági átʼéego:Choyoołʼįįhí zh-4	Kategori:Användare zh-4
Tʼááłáhági átʼéego:Choyoołʼįįhí zh-3	Kategori:Användare zh-3
Tʼááłáhági átʼéego:Choyoołʼįįhí zh-2	Kategori:Användare zh-2
Tʼááłáhági átʼéego:Atłʼóóh	Kategori:Vävning
Tʼááłáhági átʼéego:Mąʼii yił Ałhidanoolinígíí Yázhí	Kategori:Halvbjörnar
Tʼááłáhági átʼéego:Dlǫ́ʼiitsoh Danilínígíí	Kategori:Viverrider
Tʼááłáhági átʼéego:Chéłchaaʼ	Kategori:Skalbaggar
Tʼááłáhági átʼéego:Naakáí dootłʼizhí dóó Bééshbichʼahii dabizaad ndahalinígíí	Kategori:Indoeuropeiska språk
Tʼááłáhági átʼéego:Hazéí	Kategori:Ekorrar
Tʼááłáhági átʼéego:Chidí naatʼaʼí ńdinibįįhígi	Kategori:Flygplatser
Tʼááłáhági átʼéego:Áʼádaatʼéhígíí	Kategori:Grundämnen
Tʼááłáhági átʼéego:Mósí Danilínígíí	Kategori:Felis
Dibé nátʼoh	Oxytropis lambertii
Chʼoshtsoh bíláshgaantsohí (tónílį́įgiʼígíí)	Astacoidea
Tʼááłáhági átʼéego:Abeʼ bitsʼą́ą́dóó ádaalyaaígíí	Kategori:Mejeriprodukter
Tʼááłáhági átʼéego:Tsin dóó chʼil bineestʼąʼ	Kategori:Frukter
Tʼááłáhági átʼéego:Kʼaalógii dóó Iichʼąhii	Kategori:Fjärilar
Tʼááłáhági átʼéego:Chʼosh bijáád ádaadinígíí	Kategori:Blötdjur
Tʼááłáhági átʼéego:Deeteel Bikéyah bił haʼdaʼhaasdzoígíí	Kategori:Kanadas provinser och territorier
Tʼááłáhági átʼéego:Shádiʼááhdę́ę́ʼ Mágí	Kategori:Brednäsor
Tʼááłáhági átʼéego:Gáagii dóó Joogii Ndahalinígíí	Kategori:Kråkfåglar
Tʼááłáhági átʼéego:Mąʼii dóó Łééchąąʼí	Kategori:Hunddjur
Tʼááłáhági átʼéego:Ayání dóó Béégashii	Kategori:Oxdjur
Tʼááłáhági átʼéego:Tó Wónaanídę́ę́ʼ Mágí	Kategori:Markattartade apor
Tʼááłáhági átʼéego:Naayízí dóó taʼneeskʼání	Kategori:Cucurbitaceae
Tʼááłáhági átʼéego:Dlǫ́ʼii Ndahalinígíí	Kategori:Mårddjur
Tʼááłáhági átʼéego:Łóóʼtsoh biwooʼ dantłʼizígíí	Kategori:Odontoceti
Adidlą́halchiin	Valeriana arizonica
Azeeʼkʼahii	Streptanthus cordatus
Ałtsáʼázchʼil	Purshia stansburiana
Biyaadiłchííʼ	Penstemon barbatus
Chiiłchin diyógí	Rhus trilobata
Chʼałdą́ą́ʼ	Spädsalvia
Dinastsʼóóz	Paxistima myrsinites
Díwózhii yiltʼąąʼí	Kochia americana
Gáagi niłchíín	Toxicoscordion paniculatum
Tʼááłáhági átʼéego:Naaldeehii	Kategori:Djur
Tʼááłáhági átʼéego:Shádiʼááhdę́ę́ʼ Ndaaldeehii	Kategori:Sydamerikas fauna
Tʼááłáhági átʼéego:Bizaʼazis Dahólónígíí	Kategori:Pungdjur
Kétłʼáhí (chʼil)	Polygonum douglasii
Łį́į́dą́ą́ʼ	Vit axmalva
Mąʼiidą́ą́ʼ	Forestiera pubescens
Tązhiiłchiin	Thalictrum fendleri
Tséniʼchʼil	Pellaea glabella
Tłʼiishdą́ą́ʼ	Fliknattskatta
Tʼááłáhági átʼéego:Chʼosh chʼééh diikáhii	Kategori:Snäckor
Tʼááłáhági átʼéego:Chʼosh bitsʼaʼígíí	Kategori:Musslor
Azeeʼ ntłʼiní łibáhígíí	Bandmalva
Hagháʼníyoʼ (chʼil)	Penstemon strictus
Shį́náldzidí (tłʼoh)	Amerikansk ekorrsvingel
Tʼááłáhági átʼéego:Gah	Kategori:Lagomorpha
Tłʼohtsáhí	Sporobolus airoides
Tʼááłáhági átʼéego:Łóóʼtsoh dóó Tééh hóyáanii	Kategori:Valar
Gad bidahtsʼaaʼ	Phoradendron juniperinum
Tʼááłáhági átʼéego:Eʼeʼaahjí Tónteel bikáaʼgi Kéyah dah Ndaaʼeełígíí	Kategori:Öar i Stilla havet
Tʼááłáhági átʼéego:Łóóʼ Bigaan Dahólónígíí	Kategori:Bläckfiskar
Tʼááłáhági átʼéego:Chʼééh digháhii dóó Tsisteeł	Kategori:Sköldpaddor
Tʼááłáhági átʼéego:Naayééʼ	Kategori:Dinosaurier
Tʼááłáhági átʼéego:Choyoołʼįįhí pi	Kategori:Användare pi
Tʼááłáhági átʼéego:Choyoołʼįįhí pl	Kategori:Användare pl
Tʼááłáhági átʼéego:Chʼosh bikágí dantłʼizí	Kategori:Kräftdjur
Tʼááłáhági átʼéego:Jaaʼabaní	Kategori:Fladdermöss
Tʼááłáhági átʼéego:Tłʼiish	Kategori:Ormar
Tʼááłáhági átʼéego:Shádiʼááhjí kéyah yistinígíí	Kategori:Antarktis
Tʼááłáhági átʼéego:Beʼekʼid	Kategori:Insjöar
Kʼíshíshjį́į́zh	Klättersumak
Tʼááłáhági átʼéego:Bįįh	Kategori:Hjortdjur
Bee álnééhí:User sw-3	Mall:Användare sw-3
Tʼááłáhági átʼéego:Łóóʼ hashkéhé	Kategori:Hajar
Tʼááłáhági átʼéego:Łóóʼ ooshgę́ęzhii	Kategori:Broskfiskar
Tʼááłáhági átʼéego:Chidí	Kategori:Bilar
Bee álnééhí:User lb	Mall:Användare lb
Bee álnééhí:User af-2	Mall:Användare af-2
Chąąshtʼezhiitsoh	Morot
Tʼááłáhági átʼéego:Kéyah bił haʼdaʼhaasdzoígíí	Kategori:Regionala politiska indelningar
Kʼish bichʼosh (níłtsą́goʼ)	Rosalia funebris
Tséyooʼáałii	Vivlar
Tʼááłáhági átʼéego:Łį́į́ʼ Ndahalinígíí	Kategori:Hästdjur
Tʼááłáhági átʼéego:Wóʼatsʼǫǫsii Ádaatʼéhígíí	Kategori:Halvvingar
Tʼááłáhági átʼéego:Tsin Deigházhígíí	Kategori:Gnagare
Bee álnééhí:User hr-2	Mall:Användare hr-2
Bee álnééhí:User sl-1	Mall:Användare sl-1
Tʼááłáhági átʼéego:Choyoołʼįįhí ab	Kategori:Användare ab
Tʼááłáhági átʼéego:Choyoołʼįįhí ab-3	Kategori:Användare ab-3
Tʼááłáhági átʼéego:Choyoołʼįįhí ka-4	Kategori:Användare ka-4
Bee álnééhí:User an-1	Mall:Användare an-1
Bee álnééhí:User yue-4	Mall:Användare zh-yue-4
Bee álnééhí:User yue-2	Mall:Användare zh-yue-2
Bee álnééhí:User vi-1	Mall:Användare vi-1
Bee álnééhí:User sw	Mall:Användare sw
Bee álnééhí:User oc-2	Mall:Användare oc-2
Bee álnééhí:User lv-1	Mall:Användare lv-1
Bee álnééhí:User la	Mall:Användare la
Bee álnééhí:User ku-4	Mall:Användare ku-4
Bee álnééhí:User ku-3	Mall:Användare ku-3
Bee álnééhí:User ku-1	Mall:Användare ku-1
Bee álnééhí:User ksh-1	Mall:Användare ksh-1
Bee álnééhí:User ka-2	Mall:Användare ka-2
Bee álnééhí:User it-4	Mall:Användare it-4
Bee álnééhí:User is-3	Mall:Användare is-3
Bee álnééhí:User ia-4	Mall:Användare ia-4
Bee álnééhí:User ia-3	Mall:Användare ia-3
Bee álnééhí:User ia-1	Mall:Användare ia-1
Bee álnééhí:User ia	Mall:Användare ia
Bee álnééhí:User hi-2	Mall:Användare hi-2
Bee álnééhí:User grc-2	Mall:Användare grc-2
Bee álnééhí:User be-1	Mall:Användare be-1
Tʼááłáhági átʼéego:Dlǫ́ʼii yił Aheedaałtʼéhígíí	Kategori:Manguster
Tʼááłáhági átʼéego:Hoozdo Hahoodzodi chidí naatʼaʼí ńdinibįįhígi	Kategori:Flygplatser i Arizona
Tʼááłáhági átʼéego:Yootó Hahoodzodi chidí naatʼaʼí ńdinibįįhígi	Kategori:Flygplatser i New Mexico
Tʼááłáhági átʼéego:Beeʼeldííldahsinil	Kategori:Albuquerque
Tʼááłáhági átʼéego:Táłkáaʼgi Tsídii	Kategori:Andfåglar
Tʼááłáhági átʼéego:Chʼosh bijáád tseebíhígíí	Kategori:Spindeldjur
Tʼááłáhági átʼéego:Shash	Kategori:Björnar
Tʼááłáhági átʼéego:Tsin deiłkaałii	Kategori:Hackspettar
Tʼááłáhági átʼéego:Tsékooh	Kategori:Kanjoner
Tó bichʼoshtsoh	Jättesimskinnbaggar
Tʼááłáhági átʼéego:Bílaʼashdlaʼii bilį́į́ʼ danilínígíí	Kategori:Husdjur
Tʼááłáhági átʼéego:Dziil / Atsiniltłʼish álʼį́	Kategori:Energi
Tʼááłáhági átʼéego:Shádiʼááh biyaadi dóó Kéyah Yistinígíí bikáaʼgi Ndaaldeehii	Kategori:Antarktis fauna
Tʼááłáhági átʼéego:Nahatʼeʼiitsoh Bikéyahdę́ę́ʼ Ndaaldeehii	Kategori:Australiens fauna
Tʼááłáhági átʼéego:Tsʼíʼii dóó Tséʼédǫ́ʼii	Kategori:Tvåvingar
Tʼááłáhági átʼéego:Tązhii dóó Naaʼahóóhai Ndahalinígíí	Kategori:Hönsfåglar
Tʼááłáhági átʼéego:Tééh łééchąąʼí	Kategori:Hyenor
Tʼááłáhági átʼéego:Wónitłʼizí	Kategori:Gråsuggor och tånglöss
Tʼááłáhági átʼéego:Kǫʼ naʼałbąąsii ninádaaltłiʼígi	Kategori:Järnvägsstationer
Tʼááłáhági átʼéego:Daʼałtʼoʼígíí biyęęzhii deiłchíhígíí	Kategori:Kloakdjur
Tʼááłáhági átʼéego:Nahachagii dóó Nahakʼízii	Kategori:Hopprätvingar
Tʼááłáhági átʼéego:Chéłchaaʼ bigaantéłígíí	Kategori:Bladhorningar
Tʼááłáhági átʼéego:Tábąąsdísí	Kategori:Snäppor
Tʼááłáhági átʼéego:Séigoʼ	Kategori:Skorpioner
Tʼááłáhági átʼéego:Tsin naaʼeeł	Kategori:Fartyg
Tʼááłáhági átʼéego:Naabeehó bikéyah bikáaʼgi kin dah shijaaʼgo naaznilígíí	Kategori:Orter i Navajo Nation
Tʼááłáhági átʼéego:Naʼashjéʼii	Kategori:Spindlar
Tʼááłáhági átʼéego:Jááłánii	Kategori:Mångfotingar
Tʼááłáhági átʼéego:Choyoołʼįįhí no-4	Kategori:Användare no-4
Tʼááłáhági átʼéego:Azeeʼ	Kategori:Medicinalväxter
Tʼááłáhági átʼéego:Choyoołʼįįhí nl-4	Kategori:Användare nl-4
Tʼááłáhági átʼéego:Naʼastsʼǫǫsí dóó Łéʼétsoh	Kategori:Muridae
Bee álnééhí:User cs-2	Mall:Användare cs-2
Bee álnééhí:Image label begin	Mall:Image label begin
Tʼááłáhági átʼéego:Yootó Hahoodzodi kin naaznilígíí	Kategori:Orter i New Mexico
Tʼááłáhági átʼéego:Dahsání dah Yikahjí Tsin Deigházhígíí	Kategori:Hystricomorpha
Tʼááłáhági átʼéego:Choyoołʼįįhí fa-4	Kategori:Användare fa-4
Bee álnééhí:User vi	Mall:Användare vi
Tʼááłáhági átʼéego:Choyoołʼįįhí en-1	Kategori:Användare en-1
Tʼááłáhági átʼéego:Choyoołʼįįhí de-1	Kategori:Användare de-1
Tʼááłáhági átʼéego:Bikétłʼááh Hoolzhólígíí	Kategori:Tylopoda
Tʼááłáhági átʼéego:Choyoołʼįįhí da-N	Kategori:Användare da-N
Tʼááłáhági átʼéego:Choyoołʼįįhí gl-2	Kategori:Användare gl-2
Tʼááłáhági átʼéego:Choyoołʼįįhí or	Kategori:Användare or
Yaaʼ bijáád tseebíhígíí	Fästingar
Gáagii bitłʼohchin	Prärielök
Dahsání	Nordamerikanskt trädpiggsvin
Tsiiyázhí (dééł)	Trumpetare (fåglar)
Bee álnééhí:User ru-3	Mall:Användare ru-3
Bee álnééhí:User nl-3	Mall:Användare nl-3
Bee álnééhí:User dsb-1	Mall:Användare dsb-1
Bee álnééhí:User hy-2	Mall:Användare hy-2
Bee álnééhí:User sv-4	Mall:Användare sv-4
Bee álnééhí:User hr-4	Mall:Användare hr-4
Bee álnééhí:User sw-2	Mall:Användare sw-2
Bee álnééhí:User sh-2	Mall:Användare sh-2
Bee álnééhí:User hy-3	Mall:Användare hy-3
Bee álnééhí:User id-1	Mall:Användare id-1
Tsídiidaatsohí	Pelikaner
Kʼaalógii	Dagfjärilar
Tsé nahalinii (łóóʼ)	Synanceia
Wónitłʼizí ntsxaaígíí	Bathynomus
Special:RecentChanges	Special:Senaste ändringar
Chʼil bílátaʼtsʼosí	Fallugia paradoxa
Tʼááłáhági átʼéego:Choyoołʼįįhí ja-4	Kategori:Användare ja-4
Gaantsʼosí dóó Sǫʼ łóóʼ biyaʼ	Myzostomida
Naʼashǫ́ʼii dootłʼizh (chʼil)	Allenrolfea occidentalis
Atseełtsʼózí (tónteel tsídii)	Tropikfåglar
