ئافرىقا	Afrika
ياپونىيە	Japan
جەنۇبىي ئامېرىكا	Sydamerika
نورۋېگىيە	Norge
Shotlandiye	Skottland
Wélsh	Wales
ۋېنگرىيە	Ungern
ئىسپانىيە	Spanien
ئامېرىكا قوشما شىتاتلىرى	USA
بېلگىيە	Belgien
ليۇكسېمبۇرگ	Luxemburg
يەر شارى	Jorden
گېئورگى ۋاشىنگتون	George Washington
فىنلاندىيە	Finland
شۋېتسىيە	Sverige
دانىيە	Danmark
لەھىستان	Polen
لىتۋا	Litauen
ئىتالىيە	Italien
شۋېتسارىيە	Schweiz
ئاۋستىرىيە	Österrike
گرېتسىيە	Grekland
تۈركىيە جۇمھۇرىيىتى	Turkiet
پورتۇگالىيە	Portugal
ياۋروپا	Europa
ئاسىيا	Asien
شىمالىي ئامېرىكا	Nordamerika
ۋىكىپېدىيە	Wikipedia
گوللاندىيە	Nederländerna
Nyu York Shehiri	New York
ۋاشىنگتون	Washington, D.C.
San Fransisko	San Francisco
Bérlin	Berlin
Los Anjélés	Los Angeles
كومپيۇتېر	Dator
بېرن	Bern
Jenwe	Genève
سيۇرىخ	Zürich
خەلقارالىق تور	Internet
باراك ئوباما	Barack Obama
ئۇرۇگۋاي	Uruguay
London	London
كايرو	Kairo
ئالما	Äpple
پارىژ	Paris
مېكسىكا	Mexiko
Kaliforniye Shitati	Kalifornien
Boston	Boston
مارس	Mars (planet)
كېنىيە	Kenya
ئېفىئوپىيە	Etiopien
گانا جۇمھۇرىيىتى	Ghana
شىر	Lejon
فرانسىيە	Frankrike
ئېسپېرانتو	Esperanto
ئىت	Hund
بۈيۈك بېرىتانىيە	Storbritannien
مۈشۈك	Katt
جۇڭخۇا خەلق جۇمھۇرىيىتى	Kina
فرانسۇز تىلى	Franska
برازىلىيە	Brasilien
روسىيە	Ryssland
قارا دېڭىز	Svarta havet
Toronto	Toronto
Alabama Shitati	Alabama
San Pawlo	São Paulo
Kwébék	Québec
ۋىكىپېدىيە ۋەخپى	Wikimedia Foundation
جىمى ۋالىس	Jimmy Wales
گېرمانىيە	Tyskland
بېلورۇسسىيە	Vitryssland
نېمىس تىلى	Tyska
ئىسلاندىيە	Island
ئېستونىيە	Estland
ساتۇرن	Saturnus
ئايروپىلان	Flygplan
جورج ۋولكېر بۇش	George W. Bush
لاتۋىيە	Lettland
ئۇكرائىنا	Ukraina
چېخ جۇمھۇرىيەتى	Tjeckien
سلوۋاكىيە	Slovakien
سلوۋېنىيە	Slovenien
مولدوۋا	Moldavien
رۇمىنىيە	Rumänien
بۇلغارىيە	Bulgarien
Rim	Rom
ماكېدونىيە	Makedonien
ئالبانىيە	Albanien
گرېنلاندىيە	Grönland
كرودىيە	Kroatien
بوسنىيە ۋە ھېرسېگوۋىنا	Bosnien och Hercegovina
ئەزەربەيجان	Azerbajdzjan
ئاندوررا	Andorra
سىپرۇس	Cypern
گرۇزىيە	Georgien
قازاقىستان	Kazakstan
مالتا	Malta
موناكو	Monaco
چېرنوگورىيە	Montenegro
ۋاتىكان شەھىرى	Vatikanstaten
سان مارىنو	San Marino
Bryussél	Bryssel (region)
كۇبا	Kuba
بېلىز	Belize
باربادوس	Barbados
ئاممىباپ ئاپتوموبىل	Volkswagen
ھىندونېزىيە	Indonesien
Wolfgang Amadeus Mozart	Wolfgang Amadeus Mozart
بىتخوۋىن	Ludwig van Beethoven
تۈرك تىلى	Turkiska
جەنۇبىي ئافرىقا	Sydafrika
ئالجىرىيە	Algeriet
ئۆزبېكىستان	Uzbekistan
Poznan	Poznań
Tashkent	Tasjkent
Warshawa	Warszawa
ياۋروۋىزىيون ناخشا مۇسابىقىسى	Eurovision Song Contest
تېلېۋىزور	Television
ئىسلاندىيە تىلى	Isländska
چىلى	Chile
ئەيسا مەسىھ	Jesus
گالىلېي	Galileo Galilei
مېركۇرىي	Merkurius
تارىخ	Historia
ئالما شىركىتى	Apple Inc.
ۋېنېرا	Venus
مۇھاببەت	Kärlek
يۇپىتېر	Jupiter
سامان يولى سىستىمېسى	Vintergatan
ئۇران (پلانىت)	Uranus
نىكولا ساركوزى	Nicolas Sarkozy
نېپتۇن	Neptunus
ئاسترونومىيە	Astronomi
سىنگاپور	Singapore
پلۇتون	Pluto
Montréal	Montréal
لىختېنشتېين	Liechtenstein
Kambrij	Cambridge
Facebook	Facebook
بىرىنچى دۇنيا ئۇرۇشى	Första världskriget
Kolon	Köln
سكوپليې	Skopje
Shchétsin	Szczecin
لاتىن تىلى	Latin
بەھرېيىن	Bahrain
ئەرمېنىيە	Armenien
سېربىيە	Serbien
Istanbul	Istanbul
ئاۋستىرالىيە	Australien
فىزىكا	Fysik
ئارگېنتىنا	Argentina
پېرۇ	Peru
بىئولوگىيە	Biologi
شىمالىي چاۋشيەن	Nordkorea
كامبوجا	Kambodja
قۇرئان كەرىم	Koranen
دىنوزاۋر	Dinosaurier
ئىسلام دىنى	Islam
ليۇبليانا	Ljubljana
Lion	Lyon
ياۋروپا ئىتتىپاقى	Europeiska unionen
سوفىيە	Sofia
شېئىر	Poesi
Milan	Milano
Turin	Turin
سوڭ	Analöppning
ئېۋېرېست	Mount Everest
ﻧﺎﭘﻮﻟﯧﺌﻮﻥ ﺑﻮﻧﺎﭘﺎﺭﺕ	Napoleon I
ۋېزۇۋىي	Vesuvius
قۇياش	Solen
قۇياش سىستېمىسى	Solsystemet
ھىدروگېن	Väte
گېلىي	Helium
لىتىي	Litium
بېرىللىي	Beryllium
شەرقىي تىمور	Östtimor
ئوسلو	Oslo
Bonn	Bonn
سېرېرا	Ceres (dvärgplanet)
لىسبون	Lissabon
ئېرىدا	Eris (dvärgplanet)
دۇبائى	Dubai
بور	Bor
Wérsayl	Versailles
كاربون	Kol
ۋولگا دەرياسى	Volga
ئازوت	Kväve
ئوكسىگېن	Syre
مۇزىكا	Musik
Wénitsiye	Venedig
Rénn Shehiri	Rennes
Lil	Lille
Moskwa	Moskva
فىتور	Fluor
ئىتاليان تىلى	Italienska
نىئون گازى	Neon
Sankt-Pétérburg	Sankt Petersburg
چاد	Tchad
ناترىي	Natrium
ماگنىي	Magnesium
ئاليۇمىن	Aluminium
يېڭى زېلاندىيە	Nya Zeeland
ھىندىستان	Indien
سىلىتسىي	Kisel
فرانسىي	Francium
Tuwalu	Tuvalu
فوسفور	Fosfor
تۆمۈر	Järn
Ton’ga	Tonga
گۈڭگۈرت	Svavel
ساموئا	Samoa
سولومون تاقىم ئاراللىرى	Salomonöarna
ۋانۇئاتۇ	Vanuatu
خلور گازى	Klor
پاپۇئا يېڭى گۋىنېيە	Papua Nya Guinea
پالاۋ	Palau
ئارگون	Argon
ناۋرۇ	Nauru
مىكرونېزىيە فېدېراتسىيىسى	Mikronesiens federerade stater
كالىي	Kalium
كالتىسىي	Kalcium
قوغۇشۇن	Bly
مارشال تاقىم ئاراللىرى	Marshallöarna
كىرىباتى	Kiribati
موڭغۇلىيە	Mongoliet
فىجى	Fiji
سكاندىي	Skandium
تىتان	Titan
ۋېنېسۇئېلا	Venezuela
چىڭگىزخان	Djingis khan
ۋانادىي	Vanadin
Méané Shitati	Maine
خروم	Krom
ئات	Häst
ئامستېردام	Amsterdam
ھايۋانات	Djur
سۇرىنام	Surinam
مانگان	Mangan
پاراگۋاي	Paraguay
گايانا	Guyana
ئېكۋادور	Ecuador
رېنىي	Rhenium
كولومبىيە	Colombia
كوبالت	Kobolt
ۋولفرام	Volfram
نىكېل	Nickel
بۇددا دىنى	Buddhism
بولىۋىيە	Bolivia
مىس	Koppar
ترىنىداد ۋە توباگو	Trinidad och Tobago
سېنت ۋىنسېنت ۋە گرېنادىن ئاراللىرى	Saint Vincent och Grenadinerna
سىنك	Zink
Yéngi Xampishir Shitati	New Hampshire
سېنت ليۇسىيە	Saint Lucia
داۋېىنچى	Leonardo da Vinci
سېنت كىتس ۋە نېۋىس	Saint Kitts och Nevis
زەمبۇرۇغ	Svampar
يامايكا	Jamaica
گرېنادا	Grenada
Massachuséts Shitati	Massachusetts
گۋاتېمالا	Guatemala
باھاما	Bahamas
Konnéktikat Shitati	Connecticut
ئانتىگۇئا ۋە باربۇدا	Antigua och Barbuda
Haway Shitati	Hawaii
ھوندۇراس	Honduras
دومىنىكا	Dominica
دومىنىكان جۇمھۇرىيەتى	Dominikanska republiken
ھايتى	Haiti
ئەل سالۋادور	El Salvador
ئىران	Iran
ئىراق	Irak
Alyaska Shitati	Alaska
كوستارىكا	Costa Rica
ئىسرائىلىيە	Israel
پاناما	Panama
يەمەن	Jemen
پولەك تىلى	Polska
ئىئوردانىيە	Jordanien
نىكاراگۇئا	Nicaragua
Florida Shitati	Florida
قىرغىزىستان	Kirgizistan
Arizona Shitati	Arizona
كۇۋەيت	Kuwait
لائوس	Laos
لىۋان	Libanon
Orégon Shitati	Oregon
مالدىۋ ئاراللىرى	Maldiverna
ئامېرىكا قىتئەسى	Amerika
Yuta Shitati	Utah
مالايسىيا	Malaysia
بىرما	Burma
نېپال	Nepal
ئومان	Oman
پاكىستان	Pakistan
قاتار	Qatar
سەئۇدى ئەرەبىستان	Saudiarabien
سرىلانكا	Sri Lanka
ستالىن	Josef Stalin
سۇرىيە	Syrien
بىراتۇ	Platon
گاللىي	Gallium
تاجىكىستان	Tadzjikistan
تەيۋەن	Taiwan
گېرمانىي	Germanium
تايلاند	Thailand
ئارسېن	Arsenik
تۈركمەنىستان	Turkmenistan
سېلېن	Selen
ئەرەب بىرلەشمە خەلىپىلىكى	Förenade Arabemiraten
بروم	Brom
Platina	Platina
ۋيېتنام	Vietnam
Nowosibirski	Novosibirsk
جەنۇبىي چاۋشيەن	Sydkorea
كرىپتون	Krypton
ئافغانىستان	Afghanistan
رۇبىدىي	Rubidium
ئالتۇن	Guld
قازان	Kazan
بانگلادېش	Bangladesh
مالى	Mali
ئانگولا	Angola
بۇتان	Bhutan
برۇنېي	Brunei
تانزانىيە	Tanzania
فىلىپپىن	Filippinerna
ئوتتۇرا ئافرىقا جۇمھۇرىيىتى	Centralafrikanska republiken
جەنۇبى قۇتۇپ	Sydpolen
شىمالى قۇتۇپ	Nordpolen
ئىسساك نيوتۇن	Isaac Newton
ئالبېرىت ئېينىشتېين	Albert Einstein
سترونتسىي	Strontium
ئىتترىي	Yttrium
ۋىسمۇت	Vismut
سېرىق رەڭ	Gul
توگو	Togo
تۇنىس	Tunisien
زامبىيە	Zambia
زىمبابۋې	Zimbabwe
بېيجىڭ شەھىرى	Peking
تۇۋا	Tuva
بېنىن	Benin
بوتسۋانا	Botswana
بۇركىنا فاسو	Burkina Faso
بۇرۇندى	Burundi
كومور ئاراللىرى	Komorerna
كونگو جۇمھۇرىيىتى	Kongo-Brazzaville
كونگو دېموكراتىك جۇمھۇرىيىتى	Kongo-Kinshasa
San Antonio	San Antonio
جىبۇتى	Djibouti
پولونىي	Polonium
ئېكۋاتور گۋىنېيىسى	Ekvatorialguinea
ئېرىترېيە	Eritrea
Yéngi Déhli	New Delhi
تبىلىسى	Tbilisi
ئاستاتىن	Astat
گابون	Gabon
گامبىيە	Gambia
ۋىنېيە	Guinea
گۋىنېيە بىسسائۇ	Guinea-Bissau
پىل چىشى قىرغىغى	Elfenbenskusten
كامېرۇن	Kamerun
يېشىل تۇمشۇق ئاراللىرى	Kap Verde
لېسوتو	Lesotho
لىبېرىيە	Liberia
لىۋىيە	Libyen
ماداگاسكار	Madagaskar
مالاۋى	Malawi
Shtutgart	Stuttgart
ماۋرىتانىيە	Mauretanien
ماۋرىتىئۇس	Mauritius
ماراكەش	Marocko
موزامبىك	Moçambique
نامىبىيە	Namibia
نىگېر	Niger
نىگېرىيە	Nigeria
دارۋىن	Charles Darwin
ئۇگاندا	Uganda
رۋاندا	Rwanda
سىركونىي	Zirkonium
San Tomé we Prinsipé	São Tomé och Príncipe
سېنېگال	Senegal
سېيشېل ئاراللىرى	Seychellerna
سيېررا لېئونې	Sierra Leone
سومالى	Somalia
نىئوبىي	Niob
جولیس سیزر	Julius Caesar
سۇدان	Sudan
سۋازىلېند	Swaziland
مولبېدىن	Molybden
تېخېتىسىي	Teknetium
Hamburg	Hamburg
گۇجارات	Gujarat
بىرلەشكەن دۆلەتلەر تەشكىلاتى	Förenta nationerna
گېئولوگىيە	Geologi
Exmetabad	Ahmedabad
يۈرەك	Hjärta
تېرە	Hud
پراگا	Prag
كۆك رەڭ	Blå
كۈمۈش	Silver
قەلەي	Tenn
ئۇران	Uran
سۈرمە	Antimon
پلوتونىي	Plutonium
نېپتونىي	Neptunium
كسېنون	Xenon
سېزىي	Cesium
پروتاكتىنىي	Protaktinium
بارىي	Barium
تورىي	Torium
گافنىي	Hafnium
ئاكتىنىي	Aktinium
تانتال	Tantal
بىل كلىنتون	Bill Clinton
رادىي	Radium
رادون	Radon
Bombay	Bombay
Michigan Shitati	Michigan
پوئېرتو رىكو	Puerto Rico
Illinoyiz Shitati	Illinois
Shimaliy Dakota Shitati	North Dakota
لومبارد	Lombardiet
Jenubiy Dakota Shitati	South Dakota
Montana Shitati	Montana
Wyoming Shitati	Wyoming
قۇدس	Jerusalem
Aydaxo Shitati	Idaho
Washin'giton Shitati	Washington (delstat)
رۇزېرفوردىي	Rutherfordium
Néwada shitati	Nevada
دۇبنىي	Dubnium
سىبورگىي	Seaborgium
بوھرىي	Bohrium
ھاسسىي	Hassium
مېيتنېرىي	Meitnerium
Kolorado Shitati	Colorado
دارمستادتىي	Darmstadtium
رۆنتگېنىي	Röntgenium
كوپېرنىي	Copernicium
تۈر:تۈرلەر يولباشچىسى	Kategori:Topp
ئاپېنىن تاغ تىزمىسى	Apenninerna
ئالپ تاغلىرى	Alperna
پاسكال	Blaise Pascal
Gant	Gent
Chikago	Chicago
ئۇنۇنترىي	Ununtrium
فلېروۋىي	Flerovium
ئۇنۇنپېنتىي	Ununpentium
لىۋىرمورىي	Livermorium
ئۇنۇنسېپتىي	Ununseptium
ئۇنۇنئوكتىي	Ununoktium
Arném	Arnhem
ئىسپان تىلى	Spanska
مونتېۋىدېئو	Montevideo
Filadélfiye	Philadelphia
Kalkutta	Calcutta
Déhli	Delhi
داكا	Dhaka
Ban'galor	Bangalore
Ömüchük	Spindlar
ئىسلامئاباد	Islamabad
ظاصتاص يئضةن مئؤة	Frukt
Wirginiye Shitati	Virginia
غەربىي ۋىرگىنىيە شىتاتى	West Virginia
Nyuyork Shitati	New York (delstat)
سېرىي	Cerium
پرازېئودىمىي	Praseodym
Rodé Arili Shitati	Rhode Island
نېئودىي	Neodym
Maryland Shitati	Maryland
Délawiyer Shitati	Delaware
يېۋروپىي	Europium
Oxayo Shtati	Ohio
Pénsilwaniye Shitati	Pennsylvania
Yéngi Jérséy Shtati	New Jersey
فىنلاندىيە تىلى	Finska
Indiyanna Shitati	Indiana
ئاپتوموبىل	Bil
Giorgiye Shitati	Georgia
Zagréb	Zagreb
Téksas Shitati	Texas
Jenubiy Karolina Shitati	South Carolina
سىتسىلىيە	Sicilien
مانىلا	Manila
ساردىنىيە ئارىلى	Sardinien
Bordo	Bordeaux
Buénos Ayrés	Buenos Aires
مېكسىكا شەھىرى	Mexico City
توكيو	Tokyo prefektur
Barsélona	Barcelona
Missisipi Shitati	Mississippi
Ténnéssi Shitati	Tennessee
Astana	Astana
Yéngi Méksika Shitati	New Mexico
ئافېنا	Aten
Minnésota Shitati	Minnesota
باغداد	Bagdad
Karakas	Caracas
Wiskonsin Shitati	Wisconsin
Puna	Pune
AC مىلان	AC Milan
Lowa Shitati	Iowa
Nébraska Shitati	Nebraska
گۋاتېمالا شەھىرى	Guatemala City
Kanzas Shitati	Kansas
ھىندى تىلى	Hindi
ماراتىچە	Marathi
Missori Shitati	Missouri
Loyizanna Shitati	Louisiana
Kéntukki Shitati	Kentucky
Arkanzas Shtati	Arkansas
ئوردو تىلى	Urdu
Oklaxoma Shitati	Oklahoma
Potsdam	Potsdam
Hanofér	Hannover
Myunxén	München
Drézdén	Dresden
ۋالىبول	Volleyboll
Wyéna	Wien
Kopénhagén	Köpenhamn
Stokgolm	Stockholm
Xélsinki	Helsingfors
دۇبلىن	Dublin
رېيكياۋىك	Reykjavik
Tallin	Tallinn
رىگا	Riga
براتىسلاۋا	Bratislava
Budapésht	Budapest
Danzig	Gdańsk
Frankfort	Frankfurt am Main
Wroklaw	Wrocław
لانتان	Lantan
جۈي	Prometium
چالغا	Samarium
گادولنىي	Gadolinium
تېربىي	Terbium
Katolik dini	Katolicism
ليۇكسېمبۇرگ شەھىرى	Luxemburg (stad)
دىسپروزىي	Dysprosium
ۋادۇز	Vaduz
ئىنجىل	Bibeln
گولمىي	Holmium
ئېربىي	Erbium
فنوم پېن	Phnom Penh
تۇلىي	Tulium
سايگون	Ho Chi Minh-staden
ئىتتېربىي	Ytterbium
لۇتېتسىي	Lutetium
خانوي	Hanoi
ھەقىقى ئەيسا چېركاۋى	The True Jesus Church
ئىنگىلىز تىلى	Engelska
Bangkok	Bangkok
ئاندوررا كەنتى	Andorra la Vella
كۇئالالۇمپۇر	Kuala Lumpur
تەيبېي شەھىرى	Taipei
ئامېرىتسىي	Americium
كىيۇرىي	Curium
Concepción, Chile	Concepción, Chile
بېركېلىي	Berkelium
كالىفورنىي	Californium
ئېينشتېينىي	Einsteinium
فېرمىي	Fermium
مېندېلېيېۋىي	Mendelevium
كىيېۋ	Kiev
نوبېلىي	Nobelium
لاۋرېنسىي	Lawrencium
كارېلىيە	Karelska republiken
Ottawa	Ottawa
Manitoba Ölkisi	Manitoba
Albérta	Alberta
Nowa Skotiye Ölkisi	Nova Scotia
يېرېۋان	Jerevan
دارېسسالام	Dar es-Salaam
خارتۇم	Khartoum
Yéngi Brunswik Ölkisi	New Brunswick
Britani Kolumbiye	British Columbia
Saskachéwan	Saskatchewan
Néwfundland Ölkisi	Newfoundland och Labrador
Gherbiy Shimal Rayoni	Northwest Territories
Yukon Rayoni	Yukon
Florénsa	Florens
Ésén	Essen
كومى	Komi (delrepublik)
Léypzig	Leipzig
Nyurnbérg	Nürnberg
Édmonton	Edmonton
Man'géym	Mannheim
Wiktoriye, Britani Kolumbiye	Victoria, British Columbia
Winnipég	Winnipeg
Halifaks	Halifax, Nova Scotia
Kwébék Shehiri	Québec (stad)
ئېلېكترون	Elektron
Birmin'gxam	Birmingham
مىنىسكى	Minsk
مىكروسوفىت شىركىتى	Microsoft
پروتون	Proton
Kurow	Kurów
Naplés	Neapel
Braunshwéyg	Braunschweig
Madrid	Madrid
سۇ ئاستى كېمىسى	Ubåt
مايكېل جېكسۇن	Michael Jackson
Bogota	Bogotá
لىما	Lima
Santiyago	Santiago de Chile
كىتو	Quito
سۇكرې	Sucre
ئاسۇنسىئون	Asunción
Öçke	Tamget
Héydélbérg	Heidelberg
كاتماندۇ	Katmandu
سان خوسې (كوستارىكا)	San José, Costa Rica
سان سالۋادور	San Salvador
Kanbérra	Canberra
Sidnéy	Sydney
يېشىل رەڭ	Grön
Mélburn	Melbourne
قىزىل رەڭ	Röd
ماناگۇئا	Managua
رابات	Rabat
قۇيرۇقلۇق يۇلتۇز	Komet
ئالجىر	Alger, Algeriet
تۇنىس شەھىرى	Tunis
ترىپولى	Tripoli
تېھران	Teheran
جاكارتا	Jakarta
Enqere	Ankara
رىياد	Riyadh
بېلگراد	Belgrad
ئادىگېيە	Adygeiska republiken
پرايا	Praia
دەمەشىق	Damaskus
يامۇسسۇكرو	Yamoussoukro
فرانسىيىگە قاراشلىق گۋىئانا	Franska Guyana
لومې	Lomé
ئاممان	Amman
بېيرۇت	Beirut
مۇسكات	Muskat
نىكوسىيە	Nicosia
دوھا	Doha
نايروبى	Nairobi
لۇساكا	Lusaka
ئامازون	Amazon.com
قۇياش تۇتۇلۇشى	Solförmörkelse
كامپالا	Kampala
Mektep	Skola
ھارارې	Harare
Prétoriye	Pretoria
Astiraxan	Astrachan
Tiktak top	Bordtennis
Wikipedia:Sandbox	Wikipedia:Sandlådan
قالماقىستان	Kalmuckien
Osasko	Osasco
Glasgow	Glasgow
Kuritiba	Curitiba
Orman	Skog
بوغاز كۆۋرۈكى	Bosporenbron
كۇڭزى	Konfucius
كوربين بيلو	Corbin Bleu
Surat	Surat
ياۋرۇ	Euro
ئامېرىكا دولىرى	Amerikansk dollar
يەر ئوتتۇرا دېڭىزى	Medelhavet
خاڭجۇ شەھىر	Hangzhou
مەسىھچىلىك	Kristendom
قېلىپ:ئاسىيا	Mall:Asien
Séatl	Seattle
Baltimor	Baltimore
ئادېلايدې	Adelaide
داغىستان	Dagestan
Monzón	Monzón
گۇجارات تىل	Gujarati
پورتۇگال تىلى	Portugisiska
مۇستاپا كامال	Mustafa Kemal Atatürk
چېچېنىيە	Tjetjenien
كۋېچۇئا تىلى	Quechua
ئىنگۇشېتىيە	Ingusjien
شىمالىي ئوسېتىيە	Nordossetien
كاباردىنو-بالقارىستان	Kabardinien-Balkarien
ئالماس	Diamant
ياپون تىلى	Japanska
Énsklopédiye	Uppslagsverk
ئۇيغۇرچە ۋىكىپىدىيە	Portal:Huvudsida
Latex	Latex (typsättningssystem)
كوندېنساتور	Kondensator
قاراچاي-چېركېسىيە	Karatjajen-Tjerkessien
موردوۋىيە	Mordvinien
ۋاسكېتبول	Basket
چاڭجياڭ دەرياسى	Yangtze
ئۇدمۇرتىيە	Udmurtien
مارى	Marij El
ھىمالايا تاغ تىزمىسى	Himalaya
ئاند تاغلىرى	Anderna
قىيىلىق تاغلار	Klippiga bergen
Kapétown	Kapstaden
چۇۋاشىيە	Tjuvasjien
تەڭرىتاغ	Tianshan
كاۋكاز تاغ تىزمىسى	Kaukasus
تاتارىستان	Tatarstan
1279-يىلى	1279
ۋېىنىست	Vincent van Gogh
باشقۇرتىستان	Basjkirien
Semerqend	Samarkand
Buxara	Buchara
بېتلېخېم	Betlehem
Andalusiye	Andalusien
كايمان تاقىم ئاراللىرى	Caymanöarna
Kordowa	Córdoba, Spanien
شىئەن شەھىرى	Xi'an
كابۇل	Kabul
لاسا شەھىرى	Lhasa
غىلاپ	Slida
تامىل تىلى	Tamil
پەلسەپە	Filosofi
ئالەم ئايرۇپىلانى	Rymdfart
ئالتاي تاغ تىزمىسى	Altaj
تۈر:Candidates for speedy deletion	Kategori:Snabbraderingar
ئالتاي	Altajrepubliken
پىئانىنو	Piano
Hebe Camargo	Hebe Camargo
Portland, Orégon	Portland, Oregon
ئانارخىزم	Anarkism
لىبېرالىزىم	Liberalism
فاشىسىت	Fascism
مىللەتچىلىك	Nationalism
غەربىي ساھارا	Västsahara
ھىلاري كلىنتون	Hillary Clinton
خاكاسىيە	Chakassien
Strasburg	Strasbourg
ياكۇتىيە	Sacha
كرودىيە تىلى	Kroatiska
گائۇس	Carl Friedrich Gauss
بۇرياتىيە	Burjatien
جامىس جويىس	James Joyce
كاتالان تىلى	Katalanska
Burχa	Buddha (titel)
دىنسىزلىق	Ateism
لى بەي	Li Bai
دۇنيا بانكىسى	Världsbanken
كونسېرۋاتىپ	Konservatism
شىمالىي ئاتلانتىك ئەھدى تەشكىلاتى	Nato
نوبېل مۇكاپاتى	Nobelpriset
چىن شىخۇاڭ	Qin Shi Huangdi
خەن سۇلالىسى	Handynastin
فېمىنىزم	Feminism
ئىدېئولوگىيە	Ideologi
پەي توپ	Badminton
يۈەن سۇلالىسى	Yuandynastin
كولۇمبو	Christofer Columbus
يەھۇدىلار	Judar
سېرىق دەريا	Gula floden
قۇلاق	Öra
بۇرۇن	Nos
كۆز	Öga
مۇسكۇل	Muskel
Töge	Kameler
چۈمۈلە	Myror
سۈي سۇلالىسى	Suidynastin
گوللاندىيە تىلى	Nederländska
ماگرىت ساچىر	Margaret Thatcher
دېئوكسىرىبونۇكلېئىك كىسلاتا	DNA
سۇڭ سۇلالىسى	Songdynastin
Çeyze	Aubergine
رۇس تىلى	Ryska
ساخالىن	Sachalin
نېفىت ئېكىسپورت قىلغۇچى دۆلەتلەر تەشكىلاتى (OPEC)	Opec
خەلقئارا پۇل فوندى تەشكىلاتى	Internationella valutafonden
دۇنيا سودا تەشكىلاتى	Världshandelsorganisationen
سۋاھىلىچە	Swahili
توكيو ئۇنىۋېرستېتى	Tokyos universitet
خەنزۇ تىلى	Kinesiska
ئۆپكە	Lunga
نەپەسلىنىش سىستېمى	Respirationssystemet
رۇمىنىيە تىلى	Rumänska
بۇلغارىيە تىلى	Bulgariska
يەر تەۋرەش	Jordbävning
ماگادان	Magadan
تەبىئىي پەن	Naturvetenskap
فرانكلىن روزۋېلت	Franklin D. Roosevelt
ﺋﯩﺒﯩﻦ ﺳﯩﻨﺎ	Avicenna
نىلسۇن ماندىلا	Nelson Mandela
مارتىن لوتىر كىڭ	Martin Luther King
Yanardag	Vulkan
ئىسسىق بەلباغ سىكلونى	Tropisk cyklon
تېلۇگۇ تىلى	Telugu
گرۇزىن تىلى	Georgiska
ئىقتىسادشۇناسلىق	Nationalekonomi
يېن	Yen
قىزىل تۈلكە	Rödräv
ئىسكىرىپكا	Violin
چوڭ ئىسكىروپكا	Cello
ئىسكەندەر زۇلقەرنەيىن	Alexander den store
ئۆمەر ئىبنى خەتتاب	Umar ibn al-Khattab
ئامۇ دەرياسى	Amu-Darja
سۈت	Mjölk
سۇن جۇڭشەن	Sun Yat-sen
شياڭگاڭ	Hongkong
Miami	Miami
كاراچى	Karachi
Rio dé Janéyro	Rio de Janeiro
سوغۇق ئۇرۇش	Kalla kriget
شاڭخەي شەھىرى	Shanghai
Bilbaw	Bilbao
Séwéliye	Sevilla
چىڭ سۇلالىسى	Qingdynastin
توماس ئىدىسون	Thomas Edison
ئالبان تىلى	Albanska
باسكى تىلى	Baskiska
ئاراگون تىلى	Aragonska
ئەرمەن تىلى	Armeniska
ئۇكرائىن تىلى	Ukrainska
Walénsiye	Valencia
Malaga	Málaga
شۋېتسىيە تىلى	Svenska
دانىش تىلى	Danska
نورۋېگىيە تىلى	Norska
ليۇكسېمبۇرگ تىلى	Luxemburgiska
چېخ تىلى	Tjeckiska
سلوۋاك تىلى	Slovakiska
كارل ماركىس	Karl Marx
سلوۋېن تىلى	Slovenska
ماجار تىلى	Ungerska
ۋولتىر	Voltaire
ئېستون تىلى	Estniska
لاتۋىيە تىلى	Lettiska
لىتۋا تىلى	Litauiska
ھىندى دىنى	Hinduism
بېلورۇس تىل	Vitryska
يېلىن	Kvinnobröst
ئاتوم	Atom
گرېك تىلى	Grekiska
ئرېلاندىيە تىلى	Iriska
مالتا تىلى	Maltesiska
پارس تىلى	Persiska
ئىسلام	Religion
كورىيەچە	Koreanska
Injilning birinchi tomi	Första Moseboken
كانتونچە	Kantonesiska
ئېكسودۇس	Andra Moseboken
ۋيېتنام تىلى	Vietnamesiska
كخمېر تىلى	Khmer (språk)
لائوس تىلى	Lao
تايلاندچە	Thai
بىرما تىلى	Burmesiska
مالاي تىلى	Malajiska
ھىندونېزىيە تىلى	Indonesiska
موڭغۇل تىلى	Mongoliska
Baku	Baku
قازاق تىلى	Kazakiska
قىرغىز تىلى	Kirgiziska
تاجىك تىلى	Tadzjikiska
ئۆزبېك تىلى	Uzbekiska
تۈركمەن تىلى	Turkmeniska
يەھۇدى دىنى	Judendom
تىمپۇ	Thimphu
باندار سەرى بەگاۋان	Bandar Seri Begawan
ئىبرانى تىلى	Hebreiska
ئەزەربەيجان تىلى	Azerbajdzjanska
ماكېدون تىلى	Makedonska
سېرب تىلى	Serbiska
سېربو-كرودىيىلىكلەر تىلى	Serbokroatiska
بوسنىيە تىلى	Bosniska
گالىسىيەچە	Galiciska
ۋېلش تىلى	Kymriska
دىلى	Dili
شوتلاندىيە گائېل تىلى	Skotsk gäliska
Wyéntyan	Vientiane
مالې	Malé
Bishkek	Bisjkek
Düshenbe	Dusjanbe
جىگەر	Lever
تلا	Mjälte
بۆرەك	Njure
دوۋساق	Urinblåsan
نېرۋا سىستىمېسى	Nervsystemet
ئوكيانىيە	Ocean
مۇھەممەد ئەلەيھىسسالام	Muhammed
ئىمام ئەلغازالىي	Mohammad Ghazali
رىچارد نىكسون	Richard Nixon
قورساق قىسم	Buken
داۋجياۋ دىنى	Taoism
سوپىزم (تەسەۋۋۇپ)	Sufism
ۋېنا تومۇرى	Ven (blodkärl)
بېنگال تىلى	Bengali
تىل	Tunga
پانكرېئاتىت	Bukspottkörtel
بويۇن	Hals
ئېغىز بوشلۇقى	Mun
بوغۇز	Struphuvud
فالكلاند تاقىم ئاراللىرى	Falklandsöarna
ئېلىزابېت II	Elizabeth II
تاڭ سۇلالىسى	Tangdynastin
كېننېدى	John F. Kennedy
تاڭ تەيزوڭ	Tang Taizong
بالزاك	Honoré de Balzac
مىڭ سۇلالىسى	Mingdynastin
جۇ يۈەنجاڭ	Zhu Yuanzhang
رېگان	Ronald Reagan
زۇلۇچە	Zulu (språk)
زازا تىلى	Zazaiska
پلازما	Plasma
رىم گىلادىئاتورلار مەيدانى	Colosseum
Saragossa	Zaragoza
Bélfast	Belfast
ئېلېمېنتلارنىڭ دەۋرىي جەەدۋىلى	Periodiska systemet
قۇرۇق ئۈزۈم	Druva
ھەسەل	Honung
شېكەر	Socker
روبوت	Robot
ماشىنىسازلىق	Maskin
ئايلىنىش سىستېمىسى	Hjärt- och kärlsystemet
ئىچكى ئاجراتما سىستېمىسى	Endokrina systemet
كىسلاتا	Syra
سارايېۋو	Sarajevo
تۇز	Salt
فۇنكسىيە	Funktion
مولېكۇلا	Molekyl
ئېنېرگىيە	Energi
ئىنفرا قىزىل نۇر	Infraröd strålning
ماسسا	Massa
مېتال	Metall
پولات	Stål
نانو تېخنىكىسى	Nanoteknik
ئەينەك	Glas
ۋاكۇئۇم	Vakuum
ئېلېكترون ئىلمى	Elektronik
.توك (توك ئېقىمى)	Elektrisk ström
ئىككى پۇتلۇق لامپا	Diod
ئامېرىكىغا قاراشلىق ۋىرگىن تاقىم ئاراللىرى	Amerikanska Jungfruöarna
شېنياڭ شەھىرى	Shenyang
چۇڭچىڭ شەھىرى	Chongqing
تيەنجىن شەھىرى	Tianjin
Lahor	Lahore
ۋۇخەن شەھىرى	Wuhan
نۆۋەتتىكى ھادىسە	Lista över självständiga stater
ناگويا	Nagoya
تاش قورال دەۋرى	Stenåldern
ئېيىق	Björnar
فوتوسىنتېز رولى	Fotosyntes
برېتون تىلى	Bretonska
پىرېنېي تاغلىرى	Pyrenéerna
Détroyt	Detroit
بۇرج دۇبەي	Burj Khalifa
Sedichin Sépili	Kinesiska muren
ئاياسوڧيا	Hagia Sofia
ئابباسىيلار خاندانلىقى	Abbasidkalifatet
سەلىپنىڭ شەرققە يۈرۈش قىلىشى	Korståg
موڭغۇل ئىمپېرىيىسى	Mongolväldet
ئوسمان ئىمپېرىيىسى	Osmanska riket
ئىسپانىيە-ئامېرىكا ئۇرۇشى	Spansk-amerikanska kriget
مىللى دارامەت	Bruttonationalprodukt
ئېلېكتر	Elektricitet
يادرو ئېنېرگىيىسى	Kärnenergi
ھور ماشىنىسى	Ångmaskin
Antwérp	Antwerpen
باش سۆڭىكى	Kranium
ئانار	Granatäpple
ئاپېلسىن	Apelsin
دۇنيا تىلى	Rätoromanska
جۇاڭزۇ تىلى	Zhuang (språk)
شىبە تىلى	Sibe (språk)
ئۇيغۇر تىلى	Uiguriska
سىنگال تىلى	Singalesiska
ناخۇئاتل تىلى	Nahuatl
مونتسەررات	Montserrat
خارۋارد ئۇنىۋېرسىتېتى	Harvard University
Pisa	Pisa
باشقۇرتچە	Basjkiriska
قېلىپ:Location map Earth	Mall:Kartposition Världen
باغلانغان ئۆردەك	Le Canard Enchaîné
ئەرەب تىلى	Arabiska
كيۇسيۇ ئارىلى	Kyushu
خونسيو ئارىلى	Honshu
شىكوكۇ	Shikoku
كورسىكا ئارىلى	Korsika
ئاڧرىقانچە	Afrikaans
بۆرە بورسۇق	Järv
ئاۋمېن	Macao
خۇ جىنتاۋ	Hu Jintao
شى جىنپىڭ	Xi Jinping
زىراپە	Giraff
شېنجېن شەھىرى	Shenzhen
گۇئاڭدوڭ ئۆلكىسى	Guangdong
گۇاڭشى جۇاڭزۇ ئاپتونۇم رايونى	Guangxi
سوۋېت ئىتتىپاقى	Sovjetunionen
شياڭگاڭ ئۇنىۋېرستېتى	University of Hong Kong
رۇبلى	Rubel
پۇت	Fot
دولا	Axel (kroppsdel)
قالقانبەز	Sköldkörtel
قېلىپ:Link FA	Mall:Link FA
Wikipedia:Tor Jamiyeti	Wikipedia:Bybrunnen
Wérmont Shitati	Vermont
San Diyégo	San Diego
San Xosé	San Jose, Kalifornien
Dénwér	Denver
Hyuston	Houston
Féniks	Phoenix
Dallas	Dallas
Austin	Austin
Mémfis, Ténnéssi	Memphis, Tennessee
Sharlot	Charlotte, North Carolina
Kolumbu, Oxéo	Columbus, Ohio
گۇاڭجۇ شەھىرى	Guangzhou
جىياڭ جىشى	Chiang Kai-shek
ۋېن جىياباۋ	Wen Jiabao
Guam Aril	Guam
ئامېرىكىغا قاراشلىق ساموئا	Amerikanska Samoa
شىمالىي مارىئانا فېدېراتسىيىسى	Nordmarianerna
نەنجىڭ شەھىرى	Nanjing
بېيجىڭ ئۇنىۋېرسىتېتى	Pekinguniversitetet
ئۈرۈمچى شەھىرى	Ürümqi
جياڭسۇ ئۆلكىسى	Jiangsu
جېجياڭ ئۆلكىسى	Zhejiang
گۇئادەلوپە	Guadeloupe
مارتىنىكا	Martinique
شىزاڭ ئاپتونوم رايونى	Autonoma regionen Tibet
دالاي لاما	Tenzin Gyatso
تۆگىقۇش	Struts
Sakraménto	Sacramento
چاۋشيەن	Korea
لى كېچياڭ	Li Keqiang
Manchéstér	Manchester
تۇركس ۋە كايكوس تاقىم ئاراللىرى	Turks- och Caicosöarna
ياۋروپا چىمپيونلۇق لوڭقىسى	Uefa Champions League
پالمىزارلىق ئىپار مۈشۈكى	Indisk palmmård
Pyongyang	Pyongyang
New Testament	Nya Testamentet
ئادالەت ۋە تەرەققىيات پارتىيىسى	Rättvise- och utvecklingspartiet
گۈللىنىش پارتىيىسى	Republikanska folkpartiet
مىللى دارامەت بويىچە دۆلەت تەرتىپى	Lista över länder efter BNP
خېيلوڭجياڭ ئۆلكىسى	Heilongjiang
ما يىنجىئۇ	Ma Ying-jeou
بۇخارېست	Bukarest
پوئىرتورىكان مۇستەقىللىق پارتىيىسى	Puertoricanska självständighetspartiet
Tirana	Tirana
ئېشەك	Åsna
سىچۈەن ئۆلكىسى	Sichuan
مۇھەممەر قەززافى	Muammar al-Gaddafi
بارس	Tiger
چۆپ ئاش	Vermicelli
سامسۇڭ گۇرۇھى	Samsung
شىمالىي ياۋروپا	Skandinavien
كىشىنېۋ	Chișinău
بیلگیسايار مۈھەندیسلیغی	Datavetenskap
Şalom	Şalom
ئارۇبا	Aruba
خېبېي ئۆلكىسى	Hebei
پرىنسېتون ئۇنىۋېرستېتى	Princeton University
نېفىت	Petroleum
پېنسىلۋانىيە نېمىس تىلى	Pennsylvaniatyska
پرژىۋالسكى ياۋا ئات	Przewalskis häst
قوي	Får
ئىرلاندىيە	Irland (ö)
Chéshir	Cheshire
Nortumbér Wilayiti	Northumberland
Staffordshir	Staffordshire
ﻟﯘﺷﯜﻥ	Lu Xun
Shimaliy Amptonshir	Northamptonshire
Bédfordshir	Bedfordshire
Kornwél	Cornwall
Bristol	Bristol
Déwonshir	Devon, England
خالتىلىق چاشقانلار ئائىلىسى	Kängurudjur
Nashwil	Nashville
Xampishir	Hampshire
Bérkshir	Berkshire
Bukkinxamshir	Buckinghamshire
Ésséks	Essex
Ként	Kent (grevskap)
Ulanbatur	Ulan Bator
ئېرنېست ھېمىڭۋاي	Ernest Hemingway
Idinburg	Edinburgh
ئاشخاباد	Asjchabad
پىياز	Lök (art)
پەمىدۇر	Tomat
جورج بۇش	George H.W. Bush
بالقانلار	Balkanhalvön
پروتېستانت دىنى	Protestantism
سەلەنا	Selena Quintanilla
Atlanta	Atlanta
بېرمۇدا	Bermuda
باش	Huvud
ۋېللىنگتون	Wellington
روبوتلارنىڭ ئۈچ قانۇنى	Robotikens lagar
ئالفېرد نوبىل	Alfred Nobel
لیلا چڑھاو	Lila Downs
907-يىلى	907
Wankuwér	Vancouver
Liwérpol	Liverpool
Brémén	Bremen
يېڭى نورۋېگىيە تىلى	Nynorska
پوند ستېرلىڭ	Brittiskt pund
ئانگۋىللا	Anguilla
فائېروس تىل	Färöiska
مۈشۈك ئائىلىسى	Kattdjur
تاتار تىلى	Tatariska
ئەنگلىيىگە قاراشلىق ۋىرگىن تاقىم ئاراللىرى	Brittiska Jungfruöarna
كىچىك سېسىق كۈزەنى	Vessla
فرىزانچە	Frisiska
ئاق ئاغمىخان	Hermelin
قارشىلىق	Resistans
ناۋاسسا ئاراللىرى	Navassaön
سېنت بارتھېلەمي ئاراللىرى	Saint-Barthélemy
شىمالىي گېرمانىيە دىئالېكتى	Lågtyska
ئاغمىخان ئائىلىسى	Mårddjur
ساينت مارتىن	Saint Martin
بۆكەن	Antiloper
قارا بۇلغۇن	Sobel
سۈنئىي ھەمراھ	Satellit
قوتاز	Jak
ب م ۋ	BMW
Kuk Taqim Aralliri	Cooköarna
رەشىدە داتى	Rachida Dati
شەرقىي ئاسىيا	Östasien
ئوتتۇرا ئاسىيا	Centralasien
ئاق تۆش بۇلغۇن	Stenmård
ياۋا ئات	Vildhäst
ئامخارا تىلى	Amhariska
Képinek	Fjärilar
چاچ	Hår
ھىجرىيە كالېندارى	Muslimska kalendern
جيامۇسى شەھىرى	Jiamusi
دىرىخلې	Johann Peter Gustav Lejeune Dirichlet
ئاستۇرىيە تىلى	Asturiska
خىتاي	Kina (region)
قاما	Utter
چېڭدۇ شەھىر	Chengdu
يىلپىز	Snöleopard
جېڭجۇ شەھىرى	Zhengzhou
تېرېسا ئانا	Moder Teresa
DELL شىركىتى	Dell
فرانسىيىگە قاراشلىق پولىنېزىيە	Franska Polynesien
618-يىلى	618
روژدېستۋو ئاراللىرى	Julön
Krakow	Kraków
بېيجىڭ پايتەخت ئايروپورتى	Pekings internationella flygplats
ۋېنىسىيە تىلى	Venetianska
جامى	Moské
كورسىكا تىلى	Korsikanska
فىلىپىنچە	Filipino
چۇۋاش تىلى	Tjuvasjiska
قرىم تاتار تىلى	Krimtatariska
ھايتى كرېئول تىلى	Haitisk kreol
قارا قالپاق تىلى	Karakalpakiska
ياۋا تىلى	Javanesiska
مۈشۈكئېيىق	Jättepanda
قالماق تىلى	Kalmuckiska
مانجۇ تىلى	Manchuiska
كانناداچە	Kannada
مۇڭغۇل تىللىرى	Mongolspråk
پوچېركا	Hand
دۇفۇ	Du Fu
يېڭى كالېدونىيە	Nya Kaledonien
ئورىياچە	Oriya
نېپال تىلى	Nepali
نېئاپول تىلى	Neapolitanska
نورمان تىلى	Normandiska
تېئودور روزېۋېلت	Theodore Roosevelt
تېلاۋىف	Tel Aviv
Nis	Nice
سىتسىلىيە تىلى	Sicilianska
ساردىنىيە تىلى	Sardiska
ژىيۇل ۋېرن	Jules Verne
سىندى تىلى	Sindhi
سۇندا تىلى	Sundanesiska
شونا تىلى	Shona
Niué Arili	Niue
تاگالوگ تىلى	Tagalog
تۈركى تىللار ئائىلىسى	Turkspråk
تونگاچە	Tonganska
ئۇرال تىللىرى	Uraliska språk
تىگرىنىيەچە	Tigrinska
Oksford	Oxford
تۇنگۇس مانجۇ تىللىرى	Tungusiska språk
زاڭزۇ تىلى	Tibetanska
ۋۇ تىلى	Wu (dialekt)
ۋىلسون	Woodrow Wilson
ياقۇت تىلى	Jakutiska
يورۇباچە	Yoruba (språk)
سېسوتوچە	Sesotho
Rottérdam	Rotterdam
Yéngi Orléan	New Orleans
فۇشەن شەھىر	Foshan
ئوكسفورد ئۇنىۋېرسىتېتى	Oxfords universitet
ئەھمىدى نىجات	Mahmoud Ahmadinejad
Saynt Xéléna Arili	Sankta Helena
ساينت پىئېر ئارىلى ۋە مىكېلون تاقىم ئاراللىرى	Saint-Pierre och Miquelon
ئون پەرھىز	De tio budorden
Yohannésburg	Johannesburg
قاپلان	Leopard
Saltzburg	Salzburg
X نۇرى	Röntgenstrålning
شىنجاڭ ئۇيغۇر ئاپتونوم رايونى	Xinjiang
Albukwér kwé	Albuquerque
Oklaxoma Shehiri	Oklahoma City
برىسبان	Brisbane
ئىسساك ئاسىموۋ	Isaac Asimov
جەنۇبىي گىئورگىيە ۋە ساندۋىچ ئاراللىرى	Sydgeorgien och Sydsandwichöarna
كۇۋائىت شەھىرى	Kuwait (stad)
ئەرەبلەر	Araber
سۇمېرلار	Sumer
كولومبو	Colombo
ئالمۇتا	Almaty
قانداغاي	Älg
ۋاللىس ۋە فۇتۇنا تاقىم ئاراللىرى	Wallis- och Futunaöarna
تاتار مىللىتى	Tatarer
خوككايدو ئارىلى	Hokkaido
ئۇرال تاغلىرى	Uralbergen
ماددا	Materia
ئوساكا	Osaka
كامبرىج ئۇنىۋېرستېتى	Universitetet i Cambridge
ئاكا-ئۇكا رايتلار	Bröderna Wright
گۇئارانچە	Guaraní
شور دېڭىز	Aralsjön
ئىستانبۇل بوغازى	Bosporen
Izmir	Izmir
كەئەلىڭ كوكوس تاقىم ئاراللىرى	Kokosöarna
مېرسېدېس - بېنز	Mercedes-Benz
كۋېنسلاند	Queensland
Minnéapolis	Minneapolis
دەرەخ خالتىلىق ئېيىقى	Koala
2011-يىلدىكى ياپونىيە يەر تەۋرەش ۋە دېڭىز تاشقىنى	Jordbävningen vid Tohoku 2011
لىنگالاچە	Lingala
مالايالامچە	Malayalam
يىپەك يولى	Sidenvägen
Kalgari	Calgary
ئوستىيىن	Jane Austen
قوڭۇر ئېيىق	Brunbjörn
كۇرد تىلى	Kurdiska
مولداۋىيە تىلى	Moldaviska
يېڭى تاش قۇرال دەۋرى	Neolitikum
مورېسبى پورتى	Port Moresby
خىمىيىلىك رېئاكسىيە	Kemisk reaktion
لاھەي	Haag
جۇاڭزۇ مىللىتى	Zhuang
ئوسمانلى تۈركچىسى	Osmanska
يۇھاننا بايان قىلغان خۇش خەۋەر	Johannesevangeliet
توكېلاۋ تاقىم ئاراللىرى	Tokelauöarna
چاغاتاي ئۇيغۇر يېزىقى	Tjagataiska
چېڭلۇڭ	Jackie Chan
توخار تىلى	Tokhariska språk
ئېلان	Reklam
Zeytun	Olivträd
ئاۋكلاند	Auckland
سەككىز دۆلەت گۇرۇھى (G8)	G8
ئاۋكادۇر	Avokado
قىزىل قان دانىچىلىرى	Röd blodkropp
ئوقۇتقۇچى	Lärare
تىز	Knä
ئۆرۈك	Aprikos
گلۇكوزا	Glukos
Sint-Truiden	Sint-Truiden
ئالتاي تىللىرى سىستېمىسى	Altaiska språk
ناتالىيە پورتمەن	Natalie Portman
Ran'gon	Rangoon
ناگاساكى	Nagasaki
يوكوخاما	Yokohama
ئادانا	Adana
لازېر نۇرى	Laser
Lyuju shehiri	Liuzhou
خەلق پۇلى يۈەنى	Renminbi
Ritis	Leeds
رەجەپ تاييىپ ئەردوغان	Recep Tayyip Erdoğan
قىزغۇچ سېرىق	Orange
شىمال بۇغىسى	Ren
لۇقا بايان قىلغان خۇش خەۋەر	Lukasevangeliet
كونا تاش قۇرال دەۋرى	Paleolitikum
ئانتاليا ۋىلايىتى	Antalya (provins)
ھەزرىتى ئەيسا ئەلچىلىرىنىڭ پائالىيەتلىرى	Apostlagärningarna
پەرۋەز مۇشەررەڧ	Pervez Musharraf
ئادانا ۋىلايىتى	Adana (provins)
تاشقا ئايلانغان جىسىم	Fossil
بۇرسا	Bursa (stad)
ئۇرۇق	Frö
ئەنخۇي ئۆلكىسى	Anhui
خەلقئارا ئولىمپىك كومىتىتى	Internationella olympiska kommittén
ماڭلاي	Panna (anatomi)
ئىچكى موڭغۇل ئاپتونوم رايونى	Inre Mongoliet
Nottingxam	Nottingham
راكېتا	Raket
كۇردىستان	Kurdistan
ستانفورد ئۇنىۋېرستېتى	Stanford University
فۇجيەن ئۆلكىسى	Fujian
Kanzas Shehiri, Missuri	Kansas City, Missouri
كىچىك مۈشۈكئېيىق	Kattbjörn
موڭغۇل مىللىتى	Mongoler
ۋەھىيلەر	Uppenbarelseboken
Sirtlan	Hyenor
كاسا	Stjärt
خەينەن ئۆلكىسى	Hainan
رىمان	Bernhard Riemann
گەنسۇ ئۆلكىسى	Gansu
ئاق قان ھۈجەيرىسى	Vit blodkropp
ئەنگلىيىلىكلەر	Engelsmän
ئاناتول فرانس	Anatole France
ئوتلاق ياۋا مۈشۈكى	Falbkatt
جەينەك	Armbågsled
سۇجۇ شەھىرى	Suzhou
جاڭگال مولۇنى	Djungelkatt
بېنگال مولۇنى تاغ مۈشۈكى	Leopardkatt
Wénju shehiri	Wenzhou
ۋۇشى شەھىرى	Wuxi
Shawshin shehiri	Shaoxing
خەنزۇ مىللىتى	Hankineser
نىڭبو شەھىرى	Ningbo
ئابدۇللاھ گۈل	Abdullah Gül
نېمىسلار	Tyskar
خاربىن شەھىرى	Harbin
Orkéstr	Orkester
تۈرك قەھۋەسى	Turkiskt kaffe
قىزىل ياقۇت	Rubin
كەشمىر	Kashmir
كەۋىن رۇد	Kevin Rudd
يۈننەن ئۆلكىسى	Yunnan
مالكولم X	Malcolm X
مەۋلانا جالالىددىن رۇمى	Jalal al-din Rumi
Plimowt	Plymouth
شەندۇڭ ئۆلكىسى	Shandong
قول	Arm
Dérbi	Derby, Storbritannien
ياقۇت رەڭلىك	Smaragd
كىرىستال	Kristall
خېنەن ئۆلكىسى	Henan
بۇرسا ۋىلايىتى	Bursa (provins)
ئارتۋىن ۋىلايىتى	Artvin (provins)
كىندىك	Navel
ئادىيامان ۋىلايىتى	Adıyaman (provins)
لياۋنىڭ ئۆلكىسى	Liaoning
خىمىيىلىك باغ	Kemisk bindning
GNU	GNU
توچىگى ناھىيىسى	Tochigi prefektur
سېمونت	Cement
جىلىن ئۆلكىسى	Jilin
ئافيون قاراھىسار ۋىلايىتى	Afyonkarahisar (provins)
بېربېرلار	Berber
ئېچىتقۇ	Jäst
خۇنەن ئۆلكىسى	Hunan
ھونلار	Hunner
چىڭخەي ئۆلكىسى	Qinghai
ئۇيغۇر مىللىتى	Uigurer
بىلەجىك ۋىلايىتى	Bilecik (provins)
خۇبېي ئۆلكىسى	Hubei
شەنشى ئۆلكىسى	Shanxi
يۈز	Kind
قوڭۇر رەڭلىك	Brun
گۇيلىن ئۆلكىسى	Guizhou
بالىكەسىر ۋىلايىتى	Balıkesir (provins)
كيوتو كىلىشىمنامىسى	Kyotoprotokollet
ئانىلار بايرىمى	Mors dag
خەلقئارا ئىسلام كېڭىشى تەشكىلاتى	Islamiska konferensorganisationen
چاناققالە ۋىلايىتى	Çanakkale (provins)
مىياگى ناھىيىسى	Miyagi prefektur
Luknow	Lucknow
شېنشى ئۆلكىسى	Shaanxi
رىملىقلارغا يېزىلغان خەت	Romarbrevet
مالىكىي مەزھىبى	Maliki
ئوقۇغۇچى	Student
Kobe	Kobe
ئىۋاتە ناھىيىسى	Iwate
كولۇمبىيە ئۇنىۋېرستېتى	Columbia University
بوستون ئۇنىۋېرستېتى	Boston University
يالې ئۇنىۋېرسىتېتى	Yale University
پېنسىلۋانىيە ئۇنىۋېرستېتى	University of Pennsylvania
Portland, Méané	Portland, Maine
نيۇيورك ئۇنىۋېرستېتى	New York University
ئىتاليانلار	Italienare
پارىژ مېتروسى	Paris metro
پىرىت	Pyrit
فىلىپىلىكلەرگە يېزىلغان خەت	Filipperbrevet
ئېگىزلىك گېرمان تىلى	Högtyska
قېلىپ:Taxobox	Mall:Taxobox
قارا ئېقىم	Kuroshio
خەلق گېزىتى	Folkets Dagblad
جياڭشى ئۆلكىسى	Jiangxi
ئىلھام ئالىيېۋ	Ilham Alijev
زاردارى	Asif Ali Zardari
نۇرسۇلتان نازاربايېۋ	Nursultan Nazarbajev
نىڭشيا خۇيزۇ ئاپتونۇم رايونى	Ningxia
ئىسلام كەرىموۋ	Islam Karimov
شۈجو شەھىرى	Xuzhou
Lyenyün'gang shehiri	Lianyungang
ساۋكات مىرزىيويەۋ	Sjavkat Mirzijajev
خۇەيئەن شەھىرى	Huai'an
Yangjo shehiri	Yangzhou
Teyju shehiri, Jyangsu	Taizhou, Jiangsu
Nentung shehiri	Nantong
جاڭجياڭ شەھىرى	Zhenjiang
چاڭجو شەھىر	Changzhou
ئەھمەد داۋۇد ئوغلۇ	Ahmet Davutoğlu
تەيجۇ شەھىرى	Taizhou, Zhejiang
جۇشەن شەھىرى	Zhoushan
شىجياجۇاڭ شەھىرى	Shijiazhuang
تاڭشەن شەھىرى	Tangshan
Chinxuangdaw shehiri	Qinhuangdao
خەندەن شەھىرى	Handan
Bawding shehiri	Baoding
پەنجاب تىلى	Punjabi
پاشتوچە	Pashto
ساڭجو شەھىرى	Cangzhou
Langfang shehiri	Langfang
Juxey shehiri	Zhuhai
شەنتۇ شەھىرى	Shantou
Xuyjo shehiri	Huizhou
Dongwen shehiri	Dongguan
Jongshen shehiri	Zhongshan
مىقدار سۆز	Räkneord
ئۆت خالتىسى	Gallblåsa
Jaypur	Jaipur
فۇجو شەھىرى	Fuzhou
Nenping shehiri	Nanping
Putyen shehiri	Putian
Senming shehiri	Sanming
Chüenju shehiri	Quanzhou
شيامېن شەھىرى	Xiamen
Jyangju shehiri	Zhangzhou
Longyen shehiri	Longyan
Ningdé shehiri	Ningde
Shining shehiri	Xining
تاغىل سېسىق كۈزەن	Tigeriller
خۇئاڭشى شەھىرى	Huangshi
ئائومورى ناھىيىسى	Aomori prefektur
فۇكۇشىما ناھىيىسى	Fukushima (prefektur)
تەييۈەن شەھىرى	Taiyuan
داتۇڭ شەھىر	Datong
داليەن شەھىرى	Dalian
ئەنشەن شەھىرى	Anshan, Liaoning
يىڭكۇ شەھىرى	Yingkou
لياۋياڭ شەھەر	Liaoyang
يوزگات ۋىلايىتى	Yozgat (provins)
چوڭ مېڭە پوستلاق ماددىسى	Hjärnbark
ئوڭچى	Politisk höger
كارل ۋون دونىتىز	Karl Dönitz
سۆسۈنە ياقۇت	Ametist
بىنگۆل ۋىلايىتى	Bingöl (provins)
تايغان بۇغا	Kronhjort
ئارداھان ۋىلايىتى	Ardahan (provins)
ئايدىن ۋىلايىتى	Aydın (provins)
ئاماسيا ۋىلايىتى	Amasya (provins)
قازاق مىللىتى	Kazaker
ئاغرى ۋىلايىتى	Ağrı (provins)
بۇردۇر ۋىلايىتى	Burdur (provins)
كورىنتلىقلارغا يېزىلغان بىرىنچى خەت	Första Korinthierbrevet
باتمان ۋىلايىتى	Batman (provins)
كۇرىل ئاراللىرى	Kurilerna
يېڭى يەر	Novaja Zemlja
Patna	Patna
سۇلتان ئاخمەت جامىي	Blå moskén, Istanbul
ۋان ۋىلايىتى	Van (provins)
كونيا ۋىلايىتى	Konya (provins)
ئاكىتا ناھىيىسى	Akita prefektur
سېگولەن رويال	Ségolène Royal
بولۇ ۋىلايىتى	Bolu (provins)
دېنىزلى ۋىلايىتى	Denizli (provins)
شافىئىي مەزھىپى	Shafi
گىپىس	Gips
ئېڭەك	Haka
ئامېرىكا ياۋا كالىسى	Bisonoxe
Léyséstér	Leicester
ساكاريا ۋىلايىتى	Sakarya (provins)
ئاقساراي ۋىلايىتى	Aksaray (provins)
قارس ۋىلايىتى	Kars (provins)
دىيارباقىر ۋىلايىتى	Diyarbakır (provins)
مور	Fruktkropp
تەيبېي 101	Taipei 101
ئەدىرنە ۋىلايىتى	Edirne (provins)
ظوسذث	Sallat
بىتلىس ۋىلايىتى	Bitlis (provins)
ئىباراكى ناھىيىسى	Ibaraki prefektur
ھاتاي ۋىلايىتى	Hatay
زىيا گۆكئالىپ	Ziya Gökalp
پان تۈركىزم	Panturkism
يۇگوسلاۋىيە سوتسىيالىست فېدېرال جۇمھۇرىيىتى	Socialistiska federativa republiken Jugoslavien
تۈرك	Turkfolk
بارتىن ۋىلايىتى	Bartın (provins)
باش بارماق	Tumme
كوجائەلى ۋىلايىتى	Kocaeli (provins)
سازاڭسىمان مەددە	Caenorhabditis elegans
چاڭچۈن شەھىرى	Changchun
جىلىن شەھىرى	Jilin (stad)
ئېمۇ قۇشى	Emu
خاككارى ۋىلايىتى	Hakkari (provins)
راۋالپىندى	Rawalpindi
Emir Kusturica	Emir Kusturica
ماشىنىىسازلىق ئىنژىنىرلىقى	Maskinteknik
ئاينۇ مىللىتى	Ainu
ئورانگوتان	Människoartade apor
يېشىل ياقۇت	Beryll
Markus bayan qilghan xush xewer	Markusevangeliet
ئازۇرىت	Azurit
بېلىز شەھىرى	Belize City
مارشال	Marskalk
Chuju shehiri	Chuzhou
Rékazé shehiri	Shigatse
قىرىم	Krimtatarer
كىلون تېخنىكىسى	Kloning
پروڧېسسور	Professor
كورىنتلىقلارغا يېزىلغان ئىككىنچى خەت	Andra Korinthierbrevet
مۇغلا ۋىلايىتى	Muğla (provins)
ئاسىيا قارا ئېيىق	Kragbjörn
گۈلچىلىك	Trädgårdsskötsel
ئىغدىر ۋىلايىتى	Iğdır (provins)
ياماگاتا ناھىيىسى	Yamagata prefektur
قاڭشارلىق بۆكەن	Saigaantilop
كۈتاھيا ۋىلايىتى	Kütahya (provins)
كۆك ياقۇت	Safir
كۈرەشچى ئايروپىلان	Jaktflygplan
ئېرتىش دەرياسى	Irtysj
ئىبرانىيلارغا يېزىلغان خەت	Hebreerbrevet
گالاتىيلىقلارغا يېزىلغان خەت	Galaterbrevet
شاڭ سۇلالىسى	Shangdynastin
كىلىس ۋىلايىتى	Kilis (provins)
تەكىرداغ ۋىلايىتى	Tekirdağ (provins)
سان	Lår
مانىسا ۋىلايىتى	Manisa (provins)
كىچىك مېڭە	Lillhjärnan
كولوسىلىقلارغا يېزىلغان خەت	Kolosserbrevet
ياقۇپ يازغان خەت	Jakobsbrevet
يۇھاننا يازغان بىرىنچى خەت	Första Johannesbrevet
فىلىمۇنغا يېزىلغان خەت	Filemonbrevet
سالونىكىلىقلارغا يېزىلغان ئىككىنچى خەت	Andra Thessalonikerbrevet
پاۋىل كرۇگمەنن	Paul Krugman
سالونىكىلىقلارغا يېزىلغان بىرىنچى خەت	Första Thessalonikerbrevet
پېترۇس يازغان بىرىنچى خەت	Första Petrusbrevet
پېترۇس يازغان ئىككىنچى خەت	Andra Petrusbrevet
تىموتىيغا يېزىلغان بىرىنچى خەت	Första Timotheosbrevet
ئېسكىموسلار	Eskimå
IMMAGINE&POESIA	Immagine & Poesia
چىكاگو ئۇنىۋېرستېتى	University of Chicago
ماردىن ۋىلايىتى	Mardin (provins)
مالاتيا ۋىلايىتى	Malatya (provins)
مۇش ۋىلايىتى	Muş (provins)
يۇھاننا يازغان ئىككىنچى خەت	Andra Johannesbrevet
يۇھاننا يازغان ئۈچىنچى خەت	Tredje Johannesbrevet
يەھۇدا يازغان خەت	Judasbrevet
تىموتىيغا يېزىلغان ئىككىنچى خەت	Andra Timotheosbrevet
تىتۇسغا يېزىلغان خەت	Titusbrevet
قىرقلارەلى ۋىلايىتى	Kırklareli (provins)
ئاليۇمىن ئوكسىدى	Korund
مەرسىن ۋىلايىتى	Mersin (provins)
ئوتتۇرا ئاسىيا ياۋا تۆگىسى	Kamel
بۇشەھر ۋىلايىتى	Bushehr (provins)
تەكلىماكان قۇملۇقى	Takla Makan
پاچاق	Ben (kroppsdel)
قاشقىئوغلاق	Mårdhund
ئاشمورە ۋە كارتىئەر ئاراللىرى	Ashmore- och Cartieröarna
قىرشەھەر ۋىلايىتى	Kırşehir (provins)
ئەردەبىل ۋىلايىتى	Ardabil (provins)
سىنوپ ۋىلايىتى	Sinop (provins)
Ajax	AJAX
ئاتىلار بايرىمى	Fars dag
شۆلگەي بېزى	Spottkörtel
سېرىق قاشتېشى	Topas
Teynen shehiri	Tainan
سۇلتان توغرۇلبەگ	Togrul Beg
Xéngyang shehiri	Hengyang
مالاي ئېيىقى	Malajbjörn
زامان گېزىتى	Zaman
مانجۇ مىللىتى	Manchuer
تېرەك	Asp (träd)
ھېيدېلبېرگ ئۇنىۋېرستېتى	Ruprecht-Karls-Universität Heidelberg
ۋەيران بولۇش	Konkurs
ج.ۋىللارد گىببس	Josiah Willard Gibbs
پۇت بارمىقى	Tå
ياغاچچى	Timmerman
نىغدە ۋىلايىتى	Niğde (provins)
لېيدېن ئۇنىۋېرستېتى	Universitetet i Leiden
مېڭە ئاستى بېزى	Hypofys
تۈر:سىياسىي جۇغراپىيە	Geopolitik
مۇرادئۈچ	Murad III
ئىدىنبۇرگ ئۇنىۋېرستېتى	Edinburghs universitet
فارابى	Al Farabi
كۆك قۇتان	Purpurhäger
گەۋدە	Torso
ياپونىيىلىك	Japaner
پامىر ئېگىزلىكى	Pamir
تولۇق كۇرس	Kandidatexamen
تۆش بېزى	Bräss
دۆڭچە مېڭىنىڭ ئاستى	Hypotalamus
ئېلېكتر سىغىمى	Kapacitans
يېشىل تاش	Malakit
سولچى	Politisk vänster
چاناق قەلئە ئۇرۇشى	Slaget vid Gallipoli
بىريۇزا(ياقۇت)	Turkos
ئەخمەت نەدجەت سەزەر	Ahmet Necdet Sezer
ۋيېنا ئۇنىۋېرسىتېتى	Wiens universitet
توشقانسىمان سۈلەيسۈن	Pallaskatt
ئافيون قاراھىسار	Afyonkarahisar
ئوتتۇرا بارماق	Långfinger
ئەبۇ مۇسا جابىر بىن ھەييام	Geber
ئوشۇق	Vrist
ئادىياما	Adıyaman
تاغ ئۆچكىسى	Stenbock
شىيا سۇلالىسى	Xiadynastin
باشكەنت ئۇنىۋېرستېتى	Başkents universitet
جىنەن شەھىرى	Jinan
يول بەلگىسى	Vägmärken
چىڭداۋ شەھىرى	Qingdao
كالسېدونىيە	Kalcedon
ئاسىيا تېنچ ئوكيان ئىقتىسادىي ھەمكارلىق تەشكىلاتى	Asia-Pacific Economic Cooperation
Glutséstér	Gloucester
قەشقەر شەھرى	Kashgar
ئىلام ۋىلايىتى	Ilam (provins)
نەنچاڭ شەھىرى	Nanchang
بېشىكتاش گىمناستىكا كۇلۇبى	Beşiktaş JK
تۈرك لىراسى	Turkisk lira
ئۆچكە	Getter
بورمودىلى	Bohrs atommodell
ھەزىم يولى	Matstrupe
چاڭشا شەھىر	Changsha
ئۆكچە	Häl
كېكىردەك	Svalg
ئۇيغقاشتېشى	Jade
ۋىتامىن D	Vitamin D
2010 دۇنيا لوڭقىسى	Världsmästerskapet i fotboll 2010
نەسىرىدىن ئەپەندى	Nasreddin hodja
سۇلايمانىيە جامىى	Süleymaniyemoskén
كاۋاپ	Kebab
Wéstminstér Shehiri	City of Westminster
نەننىڭ شەھىرى	Nanning
Durham	Durham
تۇرغۇت ئۆزال	Turgut Özal
ﮔﺎﮔﺎﯞﯗﺯ	Gagauzer
بادام بەز	Tonsill
مۇھەممەد خاتەمى	Mohammad Khatami
تورونتو ئۇنىۋېرستېتى	University of Toronto
ساردونىكس	Onyx
تروچكىزم	Trotskism
ياڭ جىننىڭ	Chen Ning Yang
Gawshyung	Kaohsiung
بىرىكمە ماتېرىيال	Komposit
مېڭە غولى	Hjärnstammen
تاموژنا	Tullmyndighet
كۈنمىڭ شەھىرى	Kunming
ۋىتامىنB	B-vitamin
ئىسمەت ئىنۆنۈ	İsmet İnönü
مارگارېت ئاتۋود	Margaret Atwood
خۇيزۇ مىللىتى	Hui (folk)
لەنجۇ شەھىرى	Lanzhou
Halva	Helva
لى جىڭداۋ	Tsung-Dao Lee
ماگىستىر	Master (anglosaxisk examen)
كۆرسەتكۈچ بارماق	Pekfinger
ئوتتۇرا مېڭە	Mitthjärnan
ئۇپسالا ئۇنىۋېرستېتى	Uppsala universitet
Multan	Multan
خېفېي شەھىر	Hefei
ھىيلە	Handled
ئىپار مۈشۈك ئائىلىسى	Viverrider
ئارقار	Argali
كوپېنھاگېن ئۇنىۋېرستېتى	Köpenhamns universitet
قارساق	Korsakräv
لوياڭ شەھىرى	Luoyang
كۇئېنلۇن تاغ تىزمىسى	Kunlun
تىبەت مىللىتى	Tibetaner
لوندون ئىمپېرىيە ئىنستېتۇت	Imperial College London
يىلىك	Medulla oblongata
گۇيلىن شەھىرى	Guilin
گېئوتىت	Goethit
Xeyko shehir	Haikou
مولتىمىتىر	Multimeter
چىپار بۇغا	Sikahjort
يۇگوسلاۋىيە پادىشاھلىقى	Kungariket Jugoslavien
ئېۋېنكى مىللىتى	Evenker
راھىبە	Nunna
سېرىق ياۋا مۈشۈك	Asiatisk guldkatt
گۇيياڭ شەھىرى	Guiyang
نامسىز بارماق	Ringfinger
لىمبىك سىستېما	Limbiska systemet
تۇرپان	Turpan
ئىلى دەرياسى	Ili (flod)
مېڭە كۆۋرۈكى	Hjärnbryggan
دەريا بۇغىسى	Vattenrådjur
ﺑﺎﻟﻘﺎﺭ ﻣﯩﻠﻠﯩﺘﻰ	Balkarer
ﻧﻮﻏﺎﻱ ﻣﯩﻠﻠﯩﺘﻰ	Nogajer
كالا گۆشى	Nötkött
گلاسگوۋ ئۇنىۋېرستېتى	University of Glasgow
توخارلار	Tokharer
ئابادە	Abadeh
ئىستانبۇل ئۇنىۋېرسىتېتى	Istanbuls universitet
Tuwa	Tuviner
بۇرما مۈڭگۈزلۈك بۆكەن	Takin
مىكروسكوپ	Mikroskop
كېمىنىڭ يان تىرەكلىرى	Revben
جاڭ خىڭ	Zhang Heng
جاڭ چيەن	Zhang Qian
Juko shehiri	Zhoukou
جۇگىلىياڭ	Zhuge Liang
زىبو شەھىرى	Zibo
سۇلتان ئالىپ ئارىسلان	Alp Arslan
مەن، ماشىنا ئادەم (كىنو)	I, Robot (film)
جۇڭخۇا خەلق جۇمھۇرىيىتىنىڭ ئاساسىي قانۇنى	Folkrepubliken Kinas konstitution
قاشتېشى	Jaspis
تگرین اعظم	Tigran II
كۆكمۇچ	Spanskpepparsläktet
چۆل مۈشۈكى	Kinesisk ökenkatt
جۇڭگو شىنخۇا ئاگېنتلىقى	Nya Kina
Lankastér	Lancaster, Lancashire
لىجياڭ شەھىرى	Lijiang
چىچىخار شەھىرى	Qiqihar
ئۇزۇن قۇيرۇق بۇغا	Davidshjort
سېرىق تەنلىكلەر	Mongolider
Keyféng shehiri	Kaifeng
پارىژ ئۇنىۋېرسىتىتى	Paris universitet
مياۋزۇ مىللىتى	Miao (folk)
بېيخەي شەھىرى	Beihai, Guangxi
يەنتەي شەھىرى	Yantai
ﻗﯘﻣﯩﻖ	Kumyker
يىنچۈئەن شەھىرى	Yinchuan
سەئىد قۇتوب	Sayyid Qutb
ئېيقسىمان ئىپار مۈشۈك	Binturong
ئامستېردام ئۇنىۋېرستېتى	Universiteit van Amsterdam
ماتېرىيال	Material
دۇڭزۇ مىللىتى	Dong (folkslag)
تارىم ئويمانلىقى	Tarimbäckenet
بۈيۈك ئويۇن	Det stora spelet
لازۇرىت	Lapis lazuli
قاراماي يۇقىر سۇرئەتلىك يولى	Karakoramvägen
ساكاريا دەرياسى	Sakarya
ﺭﺍﺩﯨﺸﺸﯧﯟ	Aleksandr Radisjtjev
ئوۋتېز	Joyce Carol Oates
مۇدەنجياڭ شەھىرى	Mudanjiang
ناشى مىللىتى	Nakhi
ۋاشىنگتون ئۇنىۋېرستېتى	University of Washington
زونگۇلداق ۋىلايىتى	Zonguldak (provins)
سېرىق بوغۇز بولغۇن	Gulstrupig mård
شىزاڭ ياۋا ئېشىكى	Kiang
بىرمىنگام ئۇنىۋېرستېتى	Universitetet i Birmingham
چىمەلتەك	Lillfinger
بىلەك	Underarm
ماتېرىيال ئىلمى	Materialvetenskap
ھەنبەلىي مەزھىبى	Hanafi
سەي لۇن	Cai Lun
قوڭۇر بۇغا	Sambarhjort
مىچىگان ئۇنىۋېرستېتى	University of Michigan
ﺋﺎﻗﺴﺎﻱ ﭼﯩﻦ	Aksai Chin
مانچېستېر ئۇنىۋېرستېتى	University of Manchester
تارپان	Tarpan
امينة ساندال	Emina Jahović
ئاق تەنلىكلەر	Vit (hudfärg)
تارىم دەرياسى	Tarim
مىننېسوتا ئۇنىۋېرستېتى	University of Minnesota
ئورخان پامۇك	Orhan Pamuk
ﻗﺎﺭﺍ ﭼﺎﻱ ﻣﯩﻠﻠﯩﺘﻰ	Karatjajer
نەجمەتتىن ئەرباقان	Necmettin Erbakan
ﺋﺎﻟﺘﺎﻱ مىللىتى	Altajer
Teyjong shehiri	Taichung
ﻛﺎﺷﻜﺎﻱ	Qashqai
مىللەتچى ھەركەت پارتىيىسى	Nationella aktionspartiet (Turkiet)
ﭼﯘﯞﺍﺵ ﻣﯩﻠﻠﯩﺘﻰ	Tjuvasjer
گيېموسخۇس بۇغىسى	Vattenmyskdjur
ئىسپارتا ۋىلايىتى	Isparta (provins)
قوڭۇر يىلپىز	Trädleoparder
چىقچىق	Mindre sumphöna
سېرىق ئاغمىخان	Sibirisk eldmård
شىزاڭ بۆكىن	Chiru
چانقىرى ۋىلايىتى	Çankırı (provins)
چورۇم ۋىلايىتى	Çorum (provins)
ئىران ئەزەربەيجان	Iranska Azarbaijan
تۈركىيە بۈيۈك مىللەت مەجلىسى	Turkiets nationalförsamling
بەيزۇ مىللىتى	Bai (folk)
ئوسمانىيە ۋىلايىتى	Osmaniye (provins)
رابىيە قادىر	Rebiya Kadeer
سەزەن ئاقسۇ	Sezen Aksu
جاندان ارچتین	Candan Erçetin
ۋەن مارۋىجىك	Bert van Marwijk
Hidayet Türkoghli	Hidayet Türkoğlu
داچىڭ شەھىر	Daqing
مەھمەت ئەلىي تالات	Mehmet Ali Talat
ئابدۇراخمان جامى	Abd al-Rahman Jami
مېلبۇرن ئۇنىۋېرستېتى	University of Melbourne
Dünxuang Shehiri	Dunhuang
لوپنۇر	Lop Nor
Senya shehiri	Sanya
Dostum	Abdul Rashid Dostum
مۇستاپا ساندال	Mustafa Sandal
تاغ بورسۇقى	Melogale moschata
كيوتو ئۇنىۋېرستېتى	Kyoto universitet
بادام؛بادام؛بادام	Amygdala
ئىزمىر ۋىلايىتى	İzmir (provins)
بۇغدىيەك	Adamsäpple
بېڭبۇ شەھەرى	Bengbu
خۇەينەن شەھىرى	Huainan
مائەنشەن شەھىرى	Ma'anshan
ئەنچىڭ شەھىرى	Anqing
ئەرزۇرۇم ۋىلايىتى	Erzurum (provins)
روبوتلار ۋە ئىمپىرىيە	Den okända lagen
پرژىۋالسكى بۆكىنى	Procapra przewalskii
شانلى ئۇرفا ۋىلايىتى	Şanlıurfa (provins)
شهرزاد	Şehrazat
ترابزون ۋىلايىتى	Trabzon (provins)
برىتانى كولۇمبىيە ئۇنىۋېرستېتى	University of British Columbia
Metta bayan qilghan xush xewer	Matteusevangeliet
ئەلبورز ۋىلايىتى	Alborz (provins)
Tekshi choqqiliq tagh shehiri	Pingdingshan
شىنشياڭ شەھىرى	Xinxiang
Nenyang shehiri	Nanyang
Shinyang shehiri	Xinyang
ئەفەسلىكلەرگە يېزىلغان خەت	Efesierbrevet
ﺋﯩﻜﻜﯩﻨﭽﻰ ﻗﯩﺘﯩﻤﻠﯩﻖ ﯬﭘﻴﯘﻥ ﯰﺭﯗﺷﻰ	Andra opiumkriget
ئاقسۇ ۋىلايىتى	Aksu, Xinjiang
ئاقسۇ شەھىرى	Aksu
ئاقسۇ دەرياسى	Aksufloden
تېتراپىررول	Tetrapyrrol
ميەنياڭ شەھىرى	Mianyang
ھلا رەڭ	Rosa (färg)
نەۋشەھەر ۋىلايىتى	Nevşehir (provins)
نازارې	Nasaret
سۇماترا بۆكىنى	Sydlig serov
دۈزجە ۋىلايىتى	Düzce (provins)
ئالتاي شەھىرى	Altay
سۈبھىدىكى روبوتلار	Död robot
قۇندۇز ئۇرۇقدىشى	Lutra
بەشىكتاش	Beşiktaş
برىستول ئۇنىۋېرستېتى	Universitetet i Bristol
ئاق بوغۇز بۆكەن	Krävgasell
يىزۇ مىللىتى	Yi (folk)
روزا ھېيت	Eid al-fitr
كۆكمەت	Blåfår
شېڭ شىسەي	Sheng Shicai
يالىڭاچ قۇياش	Den nakna solen
تايلاندلىقلار	Thai (etnisk grupp)
تۈركىيە جۇمھۇريىتى باش مىنىستىرى	Lista över Turkiets premiärministrar
نەمەنگان ۋىلايىتى	Namangan (provins)
ھانى مىللىتى	Hanifolket
پولات قەلئەلەر	Stålgrottorna
گىرەسۇن ۋىلايىتى	Giresun (provins)
گۈمۈشخانە ۋىلايىتى	Gümüşhane (provins)
سىئىرت ۋىلايىتى	Siirt (provins)
قاھرامان ماراش ۋىلايىتى	Kahramanmaraş (provins)
ئومۇرتقا	Ryggrad
قارامان ۋىلايىتى	Karaman (provins)
سامسۇن ۋىلايىتى	Samsun (provins)
ئۆزبېك مىللىتى	Uzbeker
ئەسكىشەھەر ۋىلايىتى	Eskişehir (provins)
بايبۇرت ۋىلايىتى	Bayburt (provins)
ئۇشاق ۋىلايىتى	Uşak (provins)
يالوۋا ۋىلايىتى	Yalova (provins)
ئەلازىغ ۋىلايىتى	Elazığ (provins)
سىۋاس ۋىلايىتى	Sivas (provins)
غازى ئانتەپ ۋىلايىتى	Gaziantep (provins)
قارابۈك ۋىلايىتى	Karabük (provins)
ئەرزىنجان ۋىلايىتى	Erzincan (provins)
ئوردۇ ۋىلايىتى	Ordu (provins)
كاستامونۇ ۋىلايىتى	Kastamonu (provins)
توقات ۋىلايىتى	Tokat (provins)
نورۇز بايرىمى	Nouruz
كايسەرى ۋىلايىتى	Kayseri (provins)
رىزە ۋىلايىتى	Rize (provins)
تاجىك مىللىتى	Tadzjiker
مۇھەممەد ئىقبال	Mohammad Iqbal
پارسلار	Perser
قاراقالپاقىستان	Karakalpakstan
قىرىققالە ۋىلايىتى	Kırıkkale (provins)
قىرغىز مىللىتى	Kirgizer
شاڭخەي ھەمكارلىق تەشكىلاتى	Shanghai Co-operation Organisation
تۈركىيە دەرىجىدىن تاشقىرى ئايلانمىسى	Süper Lig
تاركان	Tarkan
فەرغانە ئويمانلىقى	Ferganadalen
فەرغانە	Fergana
Kanzas Shehiri, Kanzas	Kansas City, Kansas
پەرغانە ۋىلايىتى	Fergana (provins)
بۇخارا ۋىلايىتى	Buchara (provins)
ئەنجان ۋىلايىتى	Andizjan (provins)
سەمەرقەنت ۋىلايىتى	Samarkand (provins)
سۇرخاندەريا ۋىلايىتى	Surchondarja (provins)
چاغاتاي خان	Chagatai Khan
سىردەريا ۋىلايىتى	Syr-Darja (provins)
سىدنېي ئۇنىۋېرستېتى	University of Sydney
خارەزىم ۋىلايىتى	Khwarezm (provins)
نەۋايى ۋىلايىتى	Navoi (provins)
قاشقادەريا ۋىلايىتى	Qasjqadarja (provins)
تاشكەنت ۋىلايىتى	Tasjkent (provins)
جىزاق ۋىلايىتى	Dzjizzach (provins)
چىپار بۆكەن	Goral (getdjur)
ئوغۇزلار	Oghuzer
كۆمۈرچەك	Brosk
ئەلشىر ناۋائى	Mir Ali Schir Navaji
تارىم توشقىنى	Yarkandhare
Openoffice	Openoffice.org
قۇربان ھېيت	Eid Al-Adha
تىمساھ	Alligatorer
ئىستانبۇل ۋىلايىتى	İstanbul (provins)
Kökxot shehiri	Hohhot
بەزگە مۇناسىۋەتلىك	Adenoid
ياقۇب بەگ	Yaqub Beg
يەكەن دەرياسى	Yarkandfloden
باۋتۇ شەھىر	Baotou
رومبىسىمان كرىستال كاتەكچىسى	Trigonala kristallsystemet
تۇجيا مىللىتى	Tujia
تېھران ۋىلايىتى	Teheran (provins)
موناش ئۇنىۋېرستېتى	Monash University
كىچىك مونتياك	Muntiacus crinifrons
بوکان	Bukan
رېگان ئىقتىسادشۇناسلىقى	Reaganomics
ئۆركەش دۆلەت	Wuerkaixi
تۇنجەلى ۋىلايىتى	Tunceli (provins)
ئارال شەھرى	Aral, Xinjiang
خوتەن دەرياسى	Khotanfloden
چىپار يۈز قوڭغارچا	Maskpalmmård
ئالبېرتا ئۇنىۋېرستېتى	University of Alberta
قوي گۆشى	Lamm- och fårkött
تارباغاتاي ۋىلايىتى	Tarbagatay
خەينە بۇغىسى	Lyrhjort
شىرناق ۋىلايىتى	Şırnak (provins)
چۆچەك شەھىرى	Chöchek
قالقانسىمان يان بەز	Bisköldkörtel
قۇمۇل شەھىرى	Hami
قاراماي شەھىرى	Karamay
ئاتۇش شەھىرى	Atush
سۈلەيسۈن	Lodjur (släkte)
نان	Naan
سېرىق مۇنتجاك بۇغىسى	Muntiacus reevesi
بۆرەك ئۈستى بېزى	Binjure
لىمفا ئىشلەپچىقىرىدىغان	Lymfatiska systemet
يانپاش	Bäcken
تەيۋەن بۆكىنى	Formosaserov
جاڭ چۈنشيەن	Zhang Chunxian
ۋاڭ لېچۈەن	Wang Lequan
يۇڭ تاجلىق بۇغا	Tofshjort
ھىمالايا چۇپۇرلۇق قويى	Himalayatahr
ئاق تۇمشۇق بۇغا	Vitläppad hjort
ئۇرال - ئالتاي تىللىرى سېستىمىسى	Ural-altaiska språk
شېزۇ مىللىتى	She (folk)
قەشقەر ۋىلايىتى	Kashgar, Xinjiang
نەي	Ney
تىن تىننىڭ سەرگۈزەشتىلىرى	Tintins äventyr
دۇڭشياڭ مىللىتى	Dongxiang
قارىقۇيرۇق	Procapra gutturosa
چوڭ ئىپار مۈشۈك	Indisk sibetkatt
ئالتاي ۋىلايىتى	Altay, Xinjiang
ۋۇجياچۈ شەھىرى	Wujiaqu
ئايدىڭكۆل	Aydingkol
بابۇر	Babur
باركۆل قازاق ئاپتونوم ناھىيىسى	Barköl
بايىنغولىن موڭغۇل ئاپتونوم ئوبلاستى	Bayingolin
قارا تەنلىكلەر	Svart (hudfärg)
كورلا شەھىرى	Korla
شەرقىي تۈركىستان	Östturkestan
چياڭزۇ مىللىتى	Qiang
5-ئىيۇل ۋەقەسى	Upploppen i Ürümqi juli 2009
ئىلى قازاق ئاپتونوم ۋىلايىتى	Ili
قىز مۇنارى	Leandertornet
شىخەنزە شەھىرى	Shihezi
ئېگىز تاغ بۆكىنى	Tibetansk getgasell
يەكەن ناھىيىسى	Yarkant
QQ	QQ
قىزىلسۇ قىرغىز ئاپتونوم ئوبلاستى	Kizilsu
كۋېنسلاند ئۇنىۋېرستېتى	University of Queensland
غۇلجا شەھىرى	Yining
نۇزۇ مىللىتى	Nufolket
تۇرپان ۋىلايىتى	Turpan, Xinjiang
Néwkastl Undérlim	Newcastle-under-Lyme
بورتالا موڭغۇل ئاپتونوم ئوبلاستى	Börtala, Xinjiang
ﺷﻮﺭ ﻣﯩﻠﻠﯩﺘﻰ	Sjorer
بورتالا شەھىرى	Börtala
قىزىل بۆكەن	Röd goral
ياردەم:ياردەم	Wikipedia:Hjälp
لوپ ناھىيىسى	Lop
تۇمشۇق شەھىرى	Tumshuq
بۈيۈك ئارال	Büyükada
خوتەن ۋىلايىتى	Hotan, Xinjiang
قۇمۇل ۋىلايىتى	Hami, Xinjiang
سانجى خۇيزۇ ئاپتونوم ئوبلاستى	Changji, Xinjiang
چاپچال شىبە ئاپتونوم يېزىسى	Qapqal
فارس ۋىلايىتى	Fars (provins)
كوكتوقاي ناھىيىسى	Koktokay
قاغىلىق ناھىيىسى	Kargilik
ئاشقازان	Magsäck
ئېلىك	Capreolus
شىبە مىللىتى	Sibe (folk)
كروران قەدىمكى شەهىرى	Loulan
پېشاۋار	Peshawar
دۇتار	Dotar
كونا تاڭنامە	Tangshu
سۈينامە	Suishu
تۇخۇم نەيچىسى	Äggledare
شىنجاڭ ئىشلەپچىقىرىش - قۇرۇلۇش بىڭتۇەنى	Produktions- och konstruktionskåren i Xinjiang
شياڭگاڭ پەن ـ تېخنىكا ئۇنىۋېرسىتېتى	Hong Kong University of Science and Technology
كونا بەش دەۋر تارىخى	Jiu Wudaishi
ﻣﯧﯔ ﺟىيەنﺠﯘ	Meng Jianzhu
ئېسفەھان ۋىلايىتى	Esfahan (provins)
تۈر:تۈركىيە	Kategori:Turkiet
تۈر:ئۆسۈملۈك	Kategori:Växter
تۈر:فىزىكا	Kategori:Fysik
تۈر:تەبىئىي پەن	Kategori:Naturvetenskap
تۈر:Geografia	Kategori:Geografi
ھاجەتتەپە ئۇنىۋرېستېتى	Hacettepe universitet
خۇيزۇ	Hui
سائادەت پارتىيىسى	Lycksalighetspartiet
دوگانا	Dogana
ماخۇاتېڭ	Ma Huateng
قۇتادغۇبىلىك	Qutadghu bilig
تۈر:خرىستىئان دىنى	Kategori:Kristendom
قەدىمكى ئۇيغۇر يېزىقى	Uigurisk skrift
ئەنقەرە ۋىلايىتى	Ankara (provins)
جۇڭغار قۇلانى	Dziggetai
ئىراق ۋە شام ئىسلام دۆلىتى	Islamiska staten
پوزىترونىك مىڭە	Positronisk
پۇشتۇ مىللىتى	Pashtuner
ئەخمەتجان ﻗﺎﺳﯩﻤﻰ	Ehmetjan Qasim
گېئورگى بۇچنېر ئەدەبىيات مۇكاپاتى	Georg Büchners pris
كېسەل	Vaden
نۇر بەكرى	Nur Bekri
ﺩﯨﻠﺒﻪﺭ ﻳﯘﻧﯘﺱ	Dilber Yunus
بىنەپشە رەڭ	Purpur
سەيپىدىن ئەزىزى	Säypidin Äzizi
تەمبۈر	Tembûr
قېلىپ:Tl	Mall:Mall
قېلىپ:Userbox	Mall:Användarbox
Wikipedia:Administrators	Wikipedia:Administratörer
مىسىر	Egypten
قېلىپ:Bot	Mall:Bot
كانادا	Kanada
Wikipedia:ھەققىدە	Wikipedia:Om
قېلىپ:Flagicon	Mall:Flaggbild
قېلىپ:Documentation	Mall:Dokumentation
قېلىپ:Softredirect	Mall:Mjuk omdirigering
قېلىپ:Delete	Mall:Radera
تۈر:تىل	Kategori:Språk
Wikipedia:General disclaimer	Wikipedia:Allmänt förbehåll
قېلىپ:Navbox	Mall:Navbox
ئورقۇن-يېنسەي يېزىقى	Orchonskrift
خالتىلىق چاشقان	Känguru
قېلىپ:!	Mall:!
قېلىپ:Tnavbar	Mall:Navbar
قېلىپ:Babel	Mall:Babel
قېلىپ:Commons	Mall:Commons
قېلىپ:Stub	Mall:Stub
قېلىپ:User az	Mall:Användare az
قېلىپ:User de	Mall:Användare de
قېلىپ:User de-1	Mall:Användare de-1
قېلىپ:User es	Mall:Användare es
قېلىپ:User de-3	Mall:Användare de-3
قېلىپ:User en-3	Mall:Användare en-3
قېلىپ:User en-1	Mall:Användare en-1
قېلىپ:User en-2	Mall:Användare en-2
قېلىپ:User en-4	Mall:Användare en-4
قېلىپ:User en	Mall:Användare en
قېلىپ:User de-2	Mall:Användare de-2
قېلىپ:User es-1	Mall:Användare es-1
قېلىپ:User fr-1	Mall:Användare fr-1
قېلىپ:User ja-4	Mall:Användare ja-4
قېلىپ:User sk	Mall:Användare sk
قېلىپ:User tr-2	Mall:Användare tr-2
قېلىپ:User tr	Mall:Användare tr
قېلىپ:User ja	Mall:Användare ja
قېلىپ:User ja-1	Mall:Användare ja-1
قېلىپ:User fr	Mall:Användare fr
قېلىپ:Location map/Info	Mall:Kartposition/Info
قېلىپ:Mod	Mall:Mod
قېلىپ:Welcome	Mall:Nybörjare
تۈر:كىشلىك ئالاقە	Kategori:Mänsklig kommunikation
تۈر:User fr-1	Kategori:Användare fr-1
قېلىپ:Country showdata	Mall:Land showdata
قېلىپ:ئافرىقا	Mall:Afrika
قېلىپ:Country data NEP	Mall:Landsdata Nepal
تۈر:User en-4	Kategori:Användare en-4
تۈر:User en	Kategori:Användare en
تۈر:User zh	Kategori:Användare zh
تۈر:User zh-N	Kategori:Användare zh-N
تۈر:User en-2	Kategori:Användare en-2
قېلىپ:Infobox	Mall:Faktamall
قېلىپ:ئىراننىڭ ۋىلايەتلىرى	Mall:Irans provinser
قېلىپ:User zh	Mall:Användare zh
قېلىپ:Protected title	Mall:Skyddad sida
قېلىپ:Legend	Mall:Legend
قېلىپ:Country data	Mall:Landsdata
قېلىپ:User ru	Mall:Användare ru
قېلىپ:IPA	Mall:IPA
قېلىپ:ئوكيانىيە	Mall:Oceanien
Wikipedia:Nospam	Wikipedia:Skyddade sidnamn
قېلىپ:جۇڭخۇا خەلق جۇمھۇرىيىتى	Mall:Kina
قېلىپ:Provinces of Uzbekistan	Mall:Uzbekistans provinser
تۈر:User ja-N	Kategori:Användare ja-N
قېلىپ:Tick	Mall:J
قېلىپ:رۇسىيە	Mall:Ryssland
قېلىپ:Infobox person	Mall:Infobox biografi
قېلىپ:ياۋروپا	Mall:Europa
تۈر:User az	Kategori:Användare az
تۈر:User sk	Kategori:Användare sk
تۈر:User fr	Kategori:Användare fr
تۈر:User ja	Kategori:Användare ja
تۈر:User fr-3	Kategori:Användare fr-3
تۈر:User ja-3	Kategori:Användare ja-3
تۈر:User tr-3	Kategori:Användare tr-3
تۈر:User tr-1	Kategori:Användare tr-1
تۈر:User fr-4	Kategori:Användare fr-4
تۈر:User fr-2	Kategori:Användare fr-2
تۈر:User ja-2	Kategori:Användare ja-2
تۈر:User tr-2	Kategori:Användare tr-2
تۈر:User ko-N	Kategori:Användare ko-N
تۈر:User fr-N	Kategori:Användare fr-N
تۈر:User ru-N	Kategori:Användare ru-N
تۈر:User az-2	Kategori:Användare az-2
تۈر:User az-N	Kategori:Användare az-N
تۈر:User sk-N	Kategori:Användare sk-N
تۈر:User de	Kategori:Användare de
تۈر:User de-2	Kategori:Användare de-2
تۈر:User de-3	Kategori:Användare de-3
تۈر:User de-4	Kategori:Användare de-4
تۈر:User de-N	Kategori:Användare de-N
شىراز	Shiraz
تۈر:User en-3	Kategori:Användare en-3
تۈر:User en-N	Kategori:Användare en-N
تۈر:User es	Kategori:Användare es
تۈر:User es-1	Kategori:Användare es-1
تۈر:User es-N	Kategori:Användare es-N
تۈر:User ja-1	Kategori:Användare ja-1
تۈر:User kk	Kategori:Användare kk
تۈر:User ko	Kategori:Användare ko
تۈر:User ko-3	Kategori:Användare ko-3
تۈر:User ru-1	Kategori:Användare ru-1
قېلىپ:Table Greekletters	Mall:Grekiska bokstäver
تۈر:ئىقتىساد	Kategori:Ekonomi
باشقۇرغۇچى مەشغۇلات قوللانمىسى	Wikipedia:Manual för administratörer
قېلىپ:Sockpuppet	Mall:Marionett
قېلىپ:User ru-2	Mall:Användare ru-2
تۈر:User ru	Kategori:Användare ru
تۈر:User tr	Kategori:Användare tr
تۈر:User tr-4	Kategori:Användare tr-4
تۈر:User tr-N	Kategori:Användare tr-N
تۈر:User uz	Kategori:Användare uz
ۋىكىپېدىيە:ھۆججەت ئىشلىتىش پىرىنسىپى	Wikipedia:Illustrationer
قېلىپ:Infobox City Japan	Mall:Infobox japansk stad
تۈر:ۋىتامىنلار	Kategori:Vitaminer
قېلىپ:User ru-1	Mall:Användare ru-1
تۈر:User zh-1	Kategori:Användare zh-1
تۈر:User zh-4	Kategori:Användare zh-4
تۈر:User zh-3	Kategori:Användare zh-3
تۈر:User zh-2	Kategori:Användare zh-2
تۈر:خىمىيىۋى ئېلېمېنت	Kategori:Grundämnen
تۈر:لېكسىكولوگىيە	Kategori:Lexikologi
تۈر:ئۆزبېكىستان	Kategori:Uzbekistan
تۈر:ئاتوم يادرو فىزىكىسى	Kategori:Kärnfysik
سەۋزە	Morot
قېلىپ:Flag	Mall:Flagga
قېلىپ:جۇڭگودىكى مىللەتلەر	Mall:Kinas nationaliteter
تۈر:بىيولوگ	Kategori:Biologer
تراگۇلۇس بۇغىسى	Mushjortar
تۈر:User en-1	Kategori:Användare en-1
تۈر:User de-1	Kategori:Användare de-1
خوتەن شەھىرى	Khotan
ئالاھىدە:RecentChanges	Special:Senaste ändringar
تۈر:User ja-4	Kategori:Användare ja-4
