אפריקע	Afrika
יאפאן	Japan
דרום אמעריקע	Sydamerika
נארוועגיע	Norge
ענגלאנד	England
סקאטלאנד	Skottland
וויילס	Wales
צפון אירלאנד	Nordirland
אירלאנד	Irland
אונגארן	Ungern
שפאניע	Spanien
פאראייניקטע שטאטן פון אמעריקע	USA
בעלגיע	Belgien
לוקסעמבורג	Luxemburg
אוניווערס	Universum
ערד-פלאנעט	Jorden
לעבן	Liv
טויט	Döden
מענטש	Människa
פרייד	Lycka
דזשארזש וואשינגטאן	George Washington
טים בערנערס-לי	Tim Berners-Lee
סטענלי קובריק	Stanley Kubrick
פינלאנד	Finland
שוועדן	Sverige
דענמארק	Danmark
פוילן	Polen
ליטע	Litauen
איטאליע	Italien
שווייץ	Schweiz
עסטרייך	Österrike
גריכנלאנד	Grekland
טערקיי	Turkiet
ביר	Öl
פארטוגאל	Portugal
אייראפע	Europa
אזיע	Asien
צפון אמעריקע	Nordamerika
אנטארקטיקע	Antarktis
וויקיפעדיע	Wikipedia
האלאנד	Nederländerna
פעניס	Penis
PHP	PHP
ניו יארק (שטאט)	New York
וואשינגטאן די סי	Washington, D.C.
סאן פראנציסקא	San Francisco
בערלין	Berlin
לאס אנדזשעלעס	Los Angeles
באואינג	Boeing
ערבוס	Airbus
קאמפיוטער	Dator
בערן	Bern
גענף	Genève
ציריך	Zürich
אינטערנעץ	Internet
באראק אבאמא	Barack Obama
אורוגוויי	Uruguay
באזעל	Basel
דרוקער	Skrivare
מעדיעוויקי	Mediawiki
לאנדאן	London
קיירא	Kairo
קאפוויי	Huvudvärk
אלעקסאנדריע	Alexandria
עפל	Äpple
פאריז	Paris
אברהם לינקאלן	Abraham Lincoln
גוגל	Google
מעקסיקא	Mexiko
אטלאנטישער אקעאן	Atlanten
פאציפישער אקעאן	Stilla havet
קאליפארניע	Kalifornien
באסטאן	Boston
מאנטיק	Måndag
געשפרייט	Rum (fysik)
יאנואר	Januari
פעברואר	Februari
מערץ	Mars (månad)
מאדים	Mars (planet)
קעניע	Kenya
עטיאפיע	Etiopien
מאנארך	Monark
גהאנע	Ghana
אפריל	April
מיי	Maj
יוני	Juni
יולי	Juli
אויגוסט	Augusti
סעפטעמבער	September
אקטאבער	Oktober
נאוועמבער	November
דעצעמבער	December
דינסטיק	Tisdag
מיטוואך	Onsdag
דאנערשטיק	Torsdag
פרייטיק	Fredag
זונטיק	Söndag
לייב	Lejon
פראנקרייך	Frankrike
עספעראנטא	Esperanto
הונט	Hund
פאראייניגטע קעניגרייך	Storbritannien
קאץ	Katt
כינע	Kina
פראנצויזיש	Franska
וויקיווערטערבוך	Wiktionary
פיש	Fiskar
עטאנאל	Etanol
אלקאהאליש געטראנק	Alkoholdryck
בראזיל	Brasilien
אלקאהאל	Alkoholer
פראנצווא האלאנד	François Hollande
רוסלאנד	Ryssland
וואלפיש	Valar
אפטישע פיברע	Fiberoptik
קוואדראט	Kvadrat
ים	Hav
שווארצער ים	Svarta havet
פי	Pi
פי (אות)	Pi (bokstav)
וויקי	Wiki
טאראנטא	Toronto
אלאבאמא	Alabama
סאו פאולא	São Paulo
קוויבעק	Québec
פיצא	Pizza
וויקימעדיע פונדאציע	Wikimedia Foundation
זשימי וויילס	Jimmy Wales
דייטשלאנד	Tyskland
בעלארוס	Vitryssland
דייטשיש	Tyska
איסלאנד	Island
גאט	Gud
עסטלאנד	Estland
דייוויד קאמעראן	David Cameron
סאטורן	Saturnus
שאקאלאד	Choklad
עראפלאן	Flygplan
מלחמה	Krig
1 (נומער)	1 (tal)
2 (נומער)	2 (tal)
3 (נומער)	3 (tal)
4 (נומער)	4 (tal)
5 (נומער)	5 (tal)
0 (נומער)	0 (tal)
אומענדלעכקייט	Oändlighet
סטיוון הארפער	Stephen Harper
דזשארדזש וו. בוש	George W. Bush
גראדעק	Rektangel
לעטלאנד	Lettland
אוקראינע	Ukraina
טשעכיי	Tjeckien
סלאוואקיי	Slovakien
סלאוועניע	Slovenien
ווילנע	Vilnius
מאלדאווע	Moldavien
רומעניע	Rumänien
בולגאריע	Bulgarien
רוים	Rom
מאקעדאניע	Makedonien
אלבאניע	Albanien
גרינלאנד	Grönland
קראאטיע	Kroatien
באסניע און הערצעגאווינע	Bosnien och Hercegovina
אזערביידזשאן	Azerbajdzjan
אנדארע	Andorra
ציפערן	Cypern
גרוזיע	Georgien
וואלאניע	Vallonien
קאזאכסטאן	Kazakstan
מאלטא	Malta
פלאנדערן	Flandern
מאנאקא	Monaco
מאנטענעגרא	Montenegro
וואטיקאן	Vatikanstaten
סאן מארינא	San Marino
בריסל	Bryssel (kommun)
בריסל ראיאן	Bryssel (region)
קובא	Kuba
בעליז	Belize
אייפל טורעם	Eiffeltornet
קלאוויאטור	Tangentbord
אינדאנעזיע	Indonesien
וואלפגאנג אמאדעוס מאצארט	Wolfgang Amadeus Mozart
לודוויג וואן בעטהאוון	Ludwig van Beethoven
טערקיש	Turkiska
דרום אפריקע	Sydafrika
אלזשיר	Algeriet
וויקיביבליאטעק	Wikisource
הוראגאן סענדי	Orkanen Sandy
אוזבעקיסטאן	Uzbekistan
פויזן	Poznań
טאשקענט	Tasjkent
ווארשע	Warszawa
וויסקי	Whisky
וויין	Vin
וואסער	Vatten
קאניאק	Cognac, Charente
האלץ	Trä
טעלעוויזיע	Television
געשלעכט	Kön
פארנאגראפיע	Pornografi
קלאד מאנע	Claude Monet
דיעגא וועלאזקעז	Diego Velázquez
טשילע	Chile
יעזוס	Jesus
עלוויס פרעסלי	Elvis Presley
סעוואסטיאן פיניערא	Sebastián Piñera
גאלילעא גאלילעי	Galileo Galilei
מערקור	Merkurius
היסטאריע	Historia
עפל (פירמע)	Apple Inc.
ווענוס	Venus
שפראך	Språk
ליבע	Kärlek
דיקטאטור	Diktatur
גאלאקסיע	Galax
יופיטער	Jupiter
מיטשעל באטשעלעט	Michelle Bachelet
מילכיגער וועג	Vintergatan
ביג בענג	Big Bang
אוראנוס	Uranus
ענגלישע וויקיפעדיע	Engelskspråkiga Wikipedia
ניקאלא סארקאזי	Nicolas Sarkozy
נעפטון	Neptunus
אסטראנאמיע	Astronomi
סינגאפור	Singapore
וויסנשאפט	Vetenskap
קאסמאלאגיע	Kosmologi
פלוטאן	Pluto
מאנטרעאל	Montréal
ליכטנשטיין	Liechtenstein
ספארט	Sport
אדאלף היטלער	Adolf Hitler
פייסבוק	Facebook
ערשטע וועלט מלחמה	Första världskriget
צווייטע וועלט-מלחמה	Andra världskriget
קעלן	Köln
וויקיביכער	Wikibooks
וואדקע	Vodka
זייגער	Ur
אובונטו	Ubuntu
סקאפיע	Skopje
לינוקס	Linux
שטעטין	Szczecin
מאטעמאטיק	Matematik
לאטיין	Latin
באכריין	Bahrain
ארמעניע	Armenien
סערביע	Serbien
לבנה	Månen
סטאמבול	Istanbul
אויסטראליע	Australien
פיזיק	Fysik
ארגענטינע	Argentina
טעלעקאמוניקאציע	Telekommunikation
פערו	Peru
ביאלאגיע	Biologi
אומאידענטיפיצירטער פליענדער אביעקט	Ufo
צפון קארעע	Nordkorea
קאמבאדיע	Kambodja
קאראן	Koranen
דינאזאווער	Dinosaurier
זאאלאגיע	Zoologi
איסלאם	Islam
באטאניק	Botanik
לעך וואלענסא	Lech Wałęsa
ראד	Hjul
שכל	Psyke
פרידן	Fred
ליאן	Lyon
אייראפעישער פארבאנד	Europeiska unionen
פלאוודיוו	Plovdiv
World Wide Web	World Wide Web
פרוי	Kvinna
סאפיע	Sofia
דאן קיכאטע	Don Quijote
דיכטונג	Poesi
פוילקייט	Indolens
קאמפיוטער ווירוס	Datorvirus
שמייכל	Leende
ביל מאהער	Bill Maher
מילאן	Milano
פריינטשאפט	Vänskap
זכרון	Minne
טורין	Turin
צואה	Avföring
לימענע	Citron
באנאן	Banan
בלום	Blomma
גוגאל	Googol
וולאדימיר וויסאצקי	Vladimir Vysotskij
עווערעסט	Mount Everest
אנאטאמיע	Anatomi
שטאט	Stad
נאפאלעאן באנאפארטע	Napoleon I
פיזיאלאגיע	Fysiologi
שטערן	Stjärna
זון	Solen
הימל	Himmel
לואי פאסטער	Louis Pasteur
ליכט יאר	Ljusår
דארף	By
וויקטאר הוגא	Victor Hugo
אקעאניע	Oceanien
אטלעטיק	Friidrott
צענזור	Censur
זון סיסטעם	Solsystemet
באלטישער ים	Östersjön
ווייסל	Wisła
שאמס עליזע	Champs-Élysées
הידראגען	Väte
העליום	Helium
וויקיקאמאנס	Wikimedia Commons
אנגעלא מערקל	Angela Merkel
ליטיום	Litium
בעריליום	Beryllium
בוך	Bok
טאג	Dygn
מזרח טימאר	Östtimor
נאכט	Natt
יאר	År
יארהונדערט	Sekel
לאדזש	Łódź
מאן בלאנק	Mont Blanc
ריין (טייך)	Rhen
אסלא	Oslo
באן, דייטשלאנד	Bonn
קאטאוויץ	Katowice
שווארצע לאך	Svart hål
צערעס	Ceres (dvärgplanet)
ליסבאן	Lissabon
ריישע	Rzeszów
איטשירא סוזוקי	Ichiro Suzuki
מייקל בלומבערג	Michael Bloomberg
סעקס	Sex (aktivitet)
דוביי	Dubai
ליאנעל מעסי	Lionel Messi
באר (עלעמענט)	Bor
ניקאליי קאפערניק	Nicolaus Copernicus
ווערסיי	Versailles
קוילנשטאף	Kol
וואלגא	Volga
אזאט	Kväve
זויערשטאף	Syre
פלאנעט	Planet
מוזיק	Musik
ווענעציע	Venedig
שארם אל שייך	Sharm el-Sheikh
נעווא טייך	Neva
ליל	Lille
מאסקווע	Moskva
פלואר	Fluor
איטאליעניש	Italienska
נעאן	Neon
פעטערבורג	Sankt Petersburg
טשאד (לאנד)	Tchad
נאטריום	Natrium
צפון	Norr
מאגנעזיום	Magnesium
אלומיניום	Aluminium
ניו זילאנד	Nya Zeeland
דרום	Söder
אינדיע	Indien
סיליציום	Kisel
פאספאר	Fosfor
פראזע (ליטעראטור)	Prosa
אייזן	Järn
מערב	Väster
שוועבל	Svavel
מיזרח	Öster
סאלאמאן אינזלען	Salomonöarna
מאליער	Molière
כלאר	Klor
דעלפט	Delft
וויליאם שייקספיר	William Shakespeare
משל	Fabel
ארגאן (עלעמענט)	Argon
Mozilla Firefox	Mozilla Firefox
קאליום	Kalium
קאלציום	Kalcium
בליי	Bly
מאנגאליי	Mongoliet
פידזשי	Fiji
סקאנדיום	Skandium
טיטאניום	Titan
ווענעזועלע	Venezuela
שאך (שפיל)	Schack
דזשינגיס כאן	Djingis khan
וואנאדיום	Vanadin
מעין	Maine
כראם	Krom
פערד	Häst
אמסטערדאם	Amsterdam
געווער	Vapen
בעלי חיים	Djur
סורינאם	Surinam
מאנגאן	Mangan
פאראגוויי	Paraguay
גויאנע	Guyana
קונסט	Konst
עקוואדאר	Ecuador
רעניום	Rhenium
קאלאמביע	Colombia
קאבאלט	Kobolt
וואלפראם	Volfram
ניקל	Nickel
טרוסקאווקע	Smultronsläktet
בודהיזם	Buddhism
באליוויע	Bolivia
אסמיום	Osmium
קופער	Koppar
פלאנץ	Växt
צינק	Zink
ניו העמפשער	New Hampshire
ביאליסטאק	Białystok
לעאנארדא דא ווינטשי	Leonardo da Vinci
שוואם	Svampar
דזשאמייקע	Jamaica
מאסאטשוסעטס	Massachusetts
גוואטעמאלע	Guatemala
גוגל כראם	Google Chrome
באהאמאס	Bahamas
קאנעטיקעט	Connecticut
האן	Tamhöna
האוואי	Hawaii
האנדוראס	Honduras
דאמיניקאנישע רעפובליק	Dominikanska republiken
חזיר	Gris
ארקטישער אקעאן	Norra ishavet
האיטי	Haiti
על סאלוואדאר	El Salvador
איראן	Iran
איראק	Irak
אלאסקע	Alaska
קלוגשאפט	Visdom
קאסטא ריקא	Costa Rica
ישראל	Israel
צאנז	Nowy Sącz
פאנאמא	Panama
תימן	Jemen
ווירוס	Virus
פויליש	Polska
יארדאניע	Jordanien
ניקאראגוא	Nicaragua
פלארידע	Florida
קירגיזסטאן	Kirgizistan
אריזאנע	Arizona
קואווייט	Kuwait
לאאס	Laos
לבנון	Libanon
ארעגאן	Oregon
מאלדיוון	Maldiverna
אמעריקע	Amerika
יוטא	Utah
אקס	Nötkreatur
מאלייזיע	Malaysia
מיאנמאר	Burma
נעפאל	Nepal
אמאן	Oman
פאקיסטאן	Pakistan
דזשעימס באנד	James Bond
קאטאר	Qatar
טעניס	Tennis
סאודי אראביע	Saudiarabien
סרי לאנקא	Sri Lanka
יאזעף סטאלין	Josef Stalin
סיריע	Syrien
פלאטאן	Platon
גאליום	Gallium
טאדזשיקיסטאן	Tadzjikistan
רעפובליק פון כינע	Taiwan
יוטוב	Youtube
גערמאניום	Germanium
אריסטו	Aristoteles
טיילאנד	Thailand
באן	Tåg
ארסעניק	Arsenik
ראדיא	Radio
טורקמעניסטאן	Turkmenistan
סעלעניום	Selen
אירידיום	Iridium
פאראייניגטע אראבישע עמיראטן	Förenade Arabemiraten
בראם	Brom
פלאטין	Platina
וויעטנאם	Vietnam
טשארלי טשאפלין	Charlie Chaplin
דרום קארעע	Sydkorea
די סימפסאנס	Simpsons
קריפטאן	Krypton
אפגאניסטאן	Afghanistan
רובידיום	Rubidium
גאלד	Guld
סועץ קאנאל	Suezkanalen
באנגלאדעש	Bangladesh
פראנץ קאפקא	Franz Kafka
טשעליאבינסק	Tjeljabinsk
כארכע לויס בארכעס	Jorge Luis Borges
מאלי	Mali
סאקראטעס	Sokrates
אנגאלא	Angola
בהוטאן	Bhutan
טוויטער	Twitter
ברוניי	Brunei
טאנזאניע	Tanzania
קוועקזילבער	Kvicksilver
ראאלד אמונדסען	Roald Amundsen
הארי מוליש	Harry Mulisch
פיליפינען	Filippinerna
צענטראל-אפריקאנישע רעפובליק	Centralafrikanska republiken
טאליום	Tallium
דרום פאלוס	Sydpolen
צפון פאלוס	Nordpolen
אייזיק ניוטאן	Isaac Newton
אלבערט איינשטיין	Albert Einstein
סטראנטיום	Strontium
איטריום	Yttrium
ביסמוט	Vismut
געל	Gul
קוואנטן-מעכאניק	Kvantmekanik
טאגא	Togo
טוניסיע	Tunisien
זאמביע	Zambia
זימבאבווע	Zimbabwe
בייזשינג	Peking
דרום סודאן	Sydsudan
וולאדיוואסטאק	Vladivostok
בענין	Benin
באצוואנע	Botswana
וויקינייעס	Wikinews
בורקינע פאסא	Burkina Faso
בורונדי	Burundi
קאמאראס	Komorerna
רעפובליק פון קאנגא	Kongo-Brazzaville
דעמאקראטישע רעפובליק פון קאנגא	Kongo-Kinshasa
סאן אנטאניא	San Antonio
דזשיבוטי	Djibouti
פאלאניום	Polonium
בייערן	Bayern
עקוואטארישע גינע	Ekvatorialguinea
באדן-ווירטמבורג	Baden-Württemberg
עריטרעא	Eritrea
ניי דעלי	New Delhi
פיאדאר דאסטאיעווסקי	Fjodor Dostojevskij
טביליסי	Tbilisi
אנדריי סאכאראוו	Andrej Sacharov
עופעלע	Spädbarn
גאבאן	Gabon
מאהענדאס קערעמטשענד גאנדי	Mahatma Gandhi
קאמיקס	Tecknad serie
די גאמביע	Gambia
גינע	Guinea
גינע-ביסאו	Guinea-Bissau
בארטן פון העלפאנדביין	Elfenbenskusten
קאמערון	Kamerun
קאפווערדישע אינזלען	Kap Verde
לעסאטא	Lesotho
ליבעריע	Liberia
ליביע	Libyen
מאדאגאסקאר	Madagaskar
מאלאווי	Malawi
שטוטגארט	Stuttgart
מאריטאניע	Mauretanien
מאריציוס	Mauritius
מאראקא	Marocko
מאזאמביק	Moçambique
נאמיביע	Namibia
ניזשער	Niger
ניגעריע	Nigeria
טשארלס דארווין	Charles Darwin
אוגאנדע	Uganda
רוואנדע	Rwanda
צירקאניום	Zirkonium
סאא טאמע און פרינסיפע	São Tomé och Príncipe
קארלסרוע	Karlsruhe
סענעגאל	Senegal
סיישעל	Seychellerna
קארל פאן לינע	Carl von Linné
סיערע לעאנע	Sierra Leone
סאמאליע	Somalia
דזשאווארהארלאל נעהרו	Jawaharlal Nehru
יוליוס קייסער	Julius Caesar
סודאן	Sudan
סוואזילאנד	Swaziland
רעגנבויגן	Regnbåge
האמבורג	Hamburg
מעטאבאליזם	Metabolism
נארענדרא מאדי	Narendra Modi
אימון-סיסטעם	Immunförsvar
גודזשאראט	Gujarat
עוואלוציע	Evolution
פאראייניגטע פעלקער	Förenta nationerna
דאנטע אליגערי	Dante Alighieri
געאלאגיע	Geologi
געאגראפיע	Geografi
הארץ	Hjärta
מוח	Hjärna
הויט	Hud
קאליר	Färg
סובסטאנטיוו	Substantiv
פראג	Prag
רוטעניום	Rutenium
רהאדיום	Rodium
בלוי	Blå
פאלאדיום	Palladium
זילבער	Silver
קאדמיום	Kadmium
שטערן רייזע	Star Trek
אינדיום	Indium
צין	Tenn
אוראניום	Uran
שפיזגלאז	Antimon
טעלור	Tellur
פלוטאניום	Plutonium
יאד	Jod
קסענאן	Xenon
אנימע	Anime
צעז	Cesium
באריום	Barium
טאנטאלום	Tantal
ביל קלינטאן	Bill Clinton
ראדיום	Radium
ראדאן	Radon
לאטארינגיע	Lorraine
עלזאס	Alsace
העקטאר בערליאז	Hector Berlioz
מומביי	Bombay
אנדרא פראדעש	Andhra Pradesh
ארונאטשאל פראדעש	Arunachal Pradesh
אסאם	Assam
מישיגן	Michigan
טשאטיסגארה	Chhattisgarh
האריאנא	Haryana
אקוויטאניע	Aquitaine
דזשארקהאנד	Jharkhand
קארנאטאקא	Karnataka
קעראלא	Kerala
מאדהיא פראדעש	Madhya Pradesh
מאהאראשטרא	Maharashtra
מעקלענבורג-מערב פאמעראניע	Mecklenburg-Vorpommern
אונטער-זאקסן	Niedersachsen
נארד ריין-וועסטפאליע	Nordrhein-Westfalen
העסע	Hessen
ריינלאנד-פאלץ	Rheinland-Pfalz
זאקסן	Sachsen
אילינוי	Illinois
טורינגיע	Thüringen
זאקסן-אנהאלט	Sachsen-Anhalt
צפון דעקאטע	North Dakota
בראנדנבורג	Brandenburg
דרום דעקאטע	South Dakota
מאנטענע	Montana
וויאמינג	Wyoming
ירושלים	Jerusalem
איידעהא	Idaho
וואשינגטאן	Washington (delstat)
נעוואדא	Nevada
אינדישער אקעאן	Indiska oceanen
קאראיבישער ים	Karibiska havet
קורט וואלדהיים	Kurt Waldheim
קאלאראדא	Colorado
פרעדעריק שאפען	Frédéric Chopin
לענארד כהן	Leonard Cohen
קאַטעגאָריע:אינהאלט	Kategori:Topp
אלפן	Alperna
קארפאטן בערג	Karpaterna
גרענאבלע	Grenoble
שיקאגא	Chicago
די ביטלס	The Beatles
ווינטער	Vinter
פרילינג	Vår
זומער	Sommar
הארבסט	Höst
סאדאם כוסעין	Saddam Hussein
אסאמא בין לאדען	Usama bin Ladin
שפאניש	Spanska
מאנטעווידעא	Montevideo
יאהאן זעבאסטיאן באך	Johann Sebastian Bach
אנטאניא וויוואלדי	Antonio Vivaldi
פיטסבורג	Pittsburgh
אפערע	Opera
פילאדעלפיע	Philadelphia
קאלקאטא	Calcutta
דעלהי	Delhi
דאקא	Dhaka
שפין	Spindlar
ארטראפאד	Leddjur
איסלאמאבאד	Islamabad
פרוכט	Frukt
געלט	Pengar
ווירדזשיניע	Virginia
וועסט ווירדזשיניע	West Virginia
מאטערהארן	Matterhorn
ניו יארק	New York (delstat)
ראוד איילענד	Rhode Island
אינסעקט	Insekter
מארילאנד	Maryland
דעלעווער	Delaware
וולאדימיר לענין	Vladimir Lenin
אהאיא	Ohio
ווערגיל	Vergilius
ניקאלא מאקיאוועלי	Niccolò Machiavelli
פענסילוועניע	Pennsylvania
איטערזען	Uetersen
אויגוסטוס	Augustus
Windows	Microsoft Windows
ניו זשערסי	New Jersey
גיבראלטאר	Gibraltar
פיניש	Finska
אינדיאנע	Indiana
אויטאמאביל	Bil
טריאנוס	Trajanus
דזשארדזיע	Georgia
זאגרעב	Zagreb
ראדזשאסטהאן	Rajasthan
טעקסאס	Texas
טאמיל נאדו	Tamil Nadu
יאנאווע (איטאליע)	Genua
ברונא מארס	Bruno Mars
צפון קאראליינע	North Carolina
דרום קאראליינע	South Carolina
סיציליע	Sicilien
מאנילא	Manila
סארדיניע	Sardinien
סעבו	Cebu City
בארדא	Bordeaux
קארי אקינא	Corazon Aquino
בוענאס איירעס	Buenos Aires
העקער	Hackare
מעקסיקא שטאט	Mexico City
טאקיא	Tokyo prefektur
לא פאז	La Paz
בארצעלאנע	Barcelona
אנאנאס	Ananas
מיסיסיפי	Mississippi
פערדינאנד מאגעלאן	Ferdinand Magellan
מיסיסיפי טייך	Mississippifloden
אוטאר פראדעש	Uttar Pradesh
אוטאראקהאנד	Uttarakhand
שווים באסיין	Bassäng
טענעסי	Tennessee
ריכארד וואגנער	Richard Wagner
אבידזשאן	Abidjan
אסטאנא	Astana
ניו מעקסיקא	New Mexico
אטען	Aten
מינעסאטע	Minnesota
באגדאד	Bagdad
קאראקאס	Caracas
וויסקאנסין	Wisconsin
אייאווע	Iowa
נעבראסקא	Nebraska
גוואטעמאלע שטאט	Guatemala City
קענזעס	Kansas
האוואנע	Havanna
טאבאק	Tobak
אינטערנעט עקספלארער	Internet Explorer
ציגאר	Cigarr
פאפיראס	Cigarett
מיזורי	Missouri
לואיזיאנא	Louisiana
קענטאקי	Kentucky
ארקענסא	Arkansas
ניל ארמסטראנג	Neil Armstrong
אורדו	Urdu
עדיט פיאף	Édith Piaf
אקלעהאמע	Oklahoma
דוניי	Donau
צפון ים	Nordsjön
האנאווער	Hannover
מיינץ	Mainz
וויסבאדן	Wiesbaden
ראגוזא	Dubrovnik
זארבריקן	Saarbrücken
מינכן	München
ערפורט	Erfurt
דרעזדן	Dresden
וויען	Wien
מאדאנא	Madonna (artist)
קאפנהאגן	Köpenhamn
קאלינינגראד אבלאסט	Kaliningrad oblast
שטאקהאלם	Stockholm
העלסינקי	Helsingfors
דובלין	Dublin
רעקיאוויק	Reykjavik
טאלין	Tallinn
ריגע	Riga
לואי ארמסטראנג	Louis Armstrong
בראטיסלאווא	Bratislava
בודאפעשט	Budapest
דאנציג	Gdańsk
פראנקפורט	Frankfurt am Main
ברעסלוי	Wrocław
קאטאליציזם	Katolicism
ביבל	Bibeln
הא טשי מין שטאט	Ho Chi Minh-staden
האנוי	Hanoi
ישוס ריכטיגע קירכע	The True Jesus Church
ענגליש	Engelska
באנגקאק	Bangkok
אדעס	Odessa
קאנסעפסיאן	Concepción, Chile
דיפלאמאטיע	Diplomati
קיעוו	Kiev
אנטעריא	Ontario
אטאווא	Ottawa
דזשובא	Juba
מאניטאבא	Manitoba
אלבערטא	Alberta
נאווע סקאשע	Nova Scotia
יערעוואן	Jerevan
קאנסקאוואלע	Końskowola
דאר עס סאלאאם	Dar es-Salaam
ניו בראנזוויק	New Brunswick
בריטישע קאלומביע	British Columbia
2000	2000
2003	2003
2002	2002
2001	2001
סאסקאטשעווען	Saskatchewan
2012	2012
2011	2011
2010	2010
2009	2009
קוילן זייערס	Koldioxid
2013	2013
2014	2014
2015	2015
נייפונדלאנד און לאבראדאר	Newfoundland och Labrador
2008	2008
נארדוועסט טעריטאריעס	Northwest Territories
יוקאן	Yukon
2004	2004
וויקיטרעוול	Wikitravel
2005	2005
2006	2006
2007	2007
1900	1900
1901	1901
שארל דע גאל	Charles de Gaulle
1902	1902
פירענצע	Florens
1903	1903
1904	1904
1905	1905
1907	1907
1906	1906
1908	1908
1909	1909
1992	1992
1991	1991
1990	1990
1993	1993
1994	1994
1995	1995
1996	1996
1910	1910
1911	1911
1912	1912
1913	1913
1914	1914
1915	1915
1916	1916
1997	1997
1998	1998
נירנבערג	Nürnberg
1999	1999
1917	1917
1918	1918
עסנווארג	Mat
דיסבורג	Duisburg
שלאנג	Ormar
זשאק שיראק	Jacques Chirac
גיך פון ליכט	Ljusets hastighet
ארעל סעקס	Oralsex
1טן יאנואר	1 januari
2טן יאנואר	2 januari
1920	1920
3טן יאנואר	3 januari
1919	1919
1921	1921
1922	1922
4טן יאנואר	4 januari
1923	1923
ביאביא ראיאן	Región del Biobío
1924	1924
קארליק פלאנעט	Dvärgplanet
5טן יאנואר	5 januari
אריקא	Arica
מאלמע	Malmö
6טן יאנואר	6 januari
עלעקטראן	Elektron
7טן יאנואר	7 januari
8טן יאנואר	8 januari
9טן יאנואר	9 januari
10טן יאנואר	10 januari
11טן יאנואר	11 januari
12טן יאנואר	12 januari
13טן יאנואר	13 januari
בירמינגהאם	Birmingham
14טן יאנואר	14 januari
15טן יאנואר	15 januari
16טן יאנואר	16 januari
17טן יאנואר	17 januari
18טן יאנואר	18 januari
19טן יאנואר	19 januari
20סטן יאנואר	20 januari
אינדוסטריעלע רעוואלוציע	Industriella revolutionen
21סטן יאנואר	21 januari
22סטן יאנואר	22 januari
23סטן יאנואר	23 januari
רוימישע אימפעריע	Romerska kejsardömet
24סטן יאנואר	24 januari
25סטן יאנואר	25 januari
מינסק	Minsk
26סטן יאנואר	26 januari
מייקראסאפט	Microsoft
27סטן יאנואר	27 januari
28סטן יאנואר	28 januari
29סטן יאנואר	29 januari
30סטן יאנואר	30 januari
31סטן יאנואר	31 januari
פראטאן	Proton
2טן דעצעמבער	2 december
1טן דעצעמבער	1 december
3טן דעצעמבער	3 december
7טן דעצעמבער	7 december
5טן דעצעמבער	5 december
8טן דעצעמבער	8 december
10טן דעצעמבער	10 december
6טן דעצעמבער	6 december
9טן דעצעמבער	9 december
פינק פלויד	Pink Floyd
4טן דעצעמבער	4 december
1טן פעברואר	1 februari
2טן פעברואר	2 februari
3טן פעברואר	3 februari
קאריוו	Kurów
4טן פעברואר	4 februari
5טן פעברואר	5 februari
6טן פעברואר	6 februari
7טן פעברואר	7 februari
8טן פעברואר	8 februari
9טן פעברואר	9 februari
10טן פעברואר	10 februari
כעמיע	Kemi
14טן פעברואר	14 februari
13טן פעברואר	13 februari
15טן פעברואר	15 februari
11טן פעברואר	11 februari
12טן פעברואר	12 februari
סמאלענסק	Smolensk
19טן פעברואר	19 februari
17טן פעברואר	17 februari
16טן פעברואר	16 februari
18טן פעברואר	18 februari
20סטן פעברואר	20 februari
אנאליטישע כעמיע	Analytisk kemi
נייטראן	Neutron
21סטן פעברואר	21 februari
22סטן פעברואר	22 februari
23סטן פעברואר	23 februari
24סטן פעברואר	24 februari
25סטן פעברואר	25 februari
26סטן פעברואר	26 februari
27	27
27סטן פעברואר	27 februari
28סטן פעברואר	28 februari
11טן דעצעמבער	11 december
29סטן פעברואר	29 februari
12טן דעצעמבער	12 december
וויזועל בייסיק	Visual Basic
13טן דעצעמבער	13 december
14טן דעצעמבער	14 december
15טן דעצעמבער	15 december
2טן מערץ	2 mars
3טן מערץ	3 mars
5טן מערץ	5 mars
1טן מערץ	1 mars
7טן מערץ	7 mars
8טן מערץ	8 mars
4טן מערץ	4 mars
10טן מערץ	10 mars
11טן מערץ	11 mars
6טן מערץ	6 mars
13טן מערץ	13 mars
9טן מערץ	9 mars
12טן מערץ	12 mars
15טן מערץ	15 mars
14טן מערץ	14 mars
++C	C++
16טן דעצעמבער	16 december
17טן דעצעמבער	17 december
16טן מערץ	16 mars
17טן מערץ	17 mars
18טן מערץ	18 mars
19טן מערץ	19 mars
1989	1989
1988	1988
20סטן מערץ	20 mars
1987	1987
1986	1986
1985	1985
1984	1984
21סטן מערץ	21 mars
1983	1983
22סטן מערץ	22 mars
1982	1982
1981	1981
18טן דעצעמבער	18 december
1980	1980
23סטן מערץ	23 mars
מאגאדישו	Mogadishu
19טן דעצעמבער	19 december
24סטן מערץ	24 mars
25סטן מערץ	25 mars
20סטן דעצעמבער	20 december
26סטן מערץ	26 mars
27סטן מערץ	27 mars
28סטן מערץ	28 mars
29סטן מערץ	29 mars
30סטן מערץ	30 mars
31סטן מערץ	31 mars
סאנא	Sanaa
1970	1970
1971	1971
1972	1972
1973	1973
1974	1974
1975	1975
1976	1976
1977	1977
1978	1978
1979	1979
1969	1969
דרייסיג יעריגער קריג	Trettioåriga kriget
קאנראד אדענאער	Konrad Adenauer
15טן אפריל	15 april
13טן אפריל	13 april
12טן אפריל	12 april
14טן אפריל	14 april
11טן אפריל	11 april
10טן אפריל	10 april
8טן אפריל	8 april
9טן אפריל	9 april
7טן אפריל	7 april
6טן אפריל	6 april
5טן אפריל	5 april
4טן אפריל	4 april
3טן אפריל	3 april
1טן אפריל	1 april
2טן אפריל	2 april
16טן אפריל	16 april
17טן אפריל	17 april
18טן אפריל	18 april
19טן אפריל	19 april
20סטן אפריל	20 april
21סטן אפריל	21 april
22סטן אפריל	22 april
23סטן אפריל	23 april
24סטן אפריל	24 april
25סטן אפריל	25 april
26סטן אפריל	26 april
27סטן אפריל	27 april
28סטן אפריל	28 april
29סטן אפריל	29 april
30סטן אפריל	30 april
1טן מיי	1 maj
2טן מיי	2 maj
3טן מיי	3 maj
4טן מיי	4 maj
5טן מיי	5 maj
6טן מיי	6 maj
7טן מיי	7 maj
8טן מיי	8 maj
9טן מיי	9 maj
10טן מיי	10 maj
11טן מיי	11 maj
12טן מיי	12 maj
13טן מיי	13 maj
14טן מיי	14 maj
15טן מיי	15 maj
16טן מיי	16 maj
17טן מיי	17 maj
18טן מיי	18 maj
19טן מיי	19 maj
20סטן מיי	20 maj
21סטן מיי	21 maj
22סטן מיי	22 maj
23סטן מיי	23 maj
24סטן מיי	24 maj
25סטן מיי	25 maj
26סטן מיי	26 maj
27סטן מיי	27 maj
28סטן מיי	28 maj
29סטן מיי	29 maj
30סטן מיי	30 maj
31סטן מיי	31 maj
21סטן דעצעמבער	21 december
14טן יוני	14 juni
15טן יוני	15 juni
13טן יוני	13 juni
10טן יוני	10 juni
7טן יוני	7 juni
11טן יוני	11 juni
9טן יוני	9 juni
12טן יוני	12 juni
6טן יוני	6 juni
8טן יוני	8 juni
5טן יוני	5 juni
3טן יוני	3 juni
2טן יוני	2 juni
1טן יוני	1 juni
4טן יוני	4 juni
נאפאלי	Neapel
22סטן דעצעמבער	22 december
1968	1968
1967	1967
1966	1966
1965	1965
1964	1964
16טן יוני	16 juni
פאלערמא	Palermo
30סטן יוני	30 juni
29סטן יוני	29 juni
28סטן יוני	28 juni
26סטן יוני	26 juni
25סטן יוני	25 juni
22סטן יוני	22 juni
27סטן יוני	27 juni
24סטן יוני	24 juni
20סטן יוני	20 juni
23סטן יוני	23 juni
19טן יוני	19 juni
18טן יוני	18 juni
21סטן יוני	21 juni
17טן יוני	17 juni
23סטן דעצעמבער	23 december
ברוס וויליס	Bruce Willis
ארנאלד שווארצענעגער	Arnold Schwarzenegger
15טן יולי	15 juli
13טן יולי	13 juli
12טן יולי	12 juli
10טן יולי	10 juli
9טן יולי	9 juli
14טן יולי	14 juli
8טן יולי	8 juli
7טן יולי	7 juli
6טן יולי	6 juli
5טן יולי	5 juli
2טן יולי	2 juli
4טן יולי	4 juli
3טן יולי	3 juli
1טן יולי	1 juli
11טן יולי	11 juli
24סטן דעצעמבער	24 december
31סטן יולי	31 juli
30סטן יולי	30 juli
29סטן יולי	29 juli
28סטן יולי	28 juli
27סטן יולי	27 juli
25סטן יולי	25 juli
24סטן יולי	24 juli
23סטן יולי	23 juli
26סטן יולי	26 juli
22סטן יולי	22 juli
19טן יולי	19 juli
21סטן יולי	21 juli
20סטן יולי	20 juli
17טן יולי	17 juli
18טן יולי	18 juli
16טן יולי	16 juli
פוטבאל	Fotboll
25סטן דעצעמבער	25 december
1963	1963
26סטן דעצעמבער	26 december
חורבן אייראפע	Förintelsen
1962	1962
IPhone	Iphone
14טן אויגוסט	14 augusti
15טן אויגוסט	15 augusti
13טן אויגוסט	13 augusti
12טן אויגוסט	12 augusti
11טן אויגוסט	11 augusti
10טן אויגוסט	10 augusti
8טן אויגוסט	8 augusti
7טן אויגוסט	7 augusti
9טן אויגוסט	9 augusti
5טן אויגוסט	5 augusti
4טן אויגוסט	4 augusti
2טן אויגוסט	2 augusti
3טן אויגוסט	3 augusti
6טן אויגוסט	6 augusti
1טן אויגוסט	1 augusti
קעמניץ	Chemnitz
27סטן דעצעמבער	27 december
מאדריד	Madrid
סובמארין	Ubåt
16טן אויגוסט	16 augusti
קאקא קאלע	Coca-Cola
29סטן אויגוסט	29 augusti
28סטן אויגוסט	28 augusti
30סטן אויגוסט	30 augusti
25סטן אויגוסט	25 augusti
26סטן אויגוסט	26 augusti
23סטן אויגוסט	23 augusti
27סטן אויגוסט	27 augusti
21סטן אויגוסט	21 augusti
20סטן אויגוסט	20 augusti
24סטן אויגוסט	24 augusti
18טן אויגוסט	18 augusti
17טן אויגוסט	17 augusti
22סטן אויגוסט	22 augusti
19טן אויגוסט	19 augusti
31סטן אויגוסט	31 augusti
מייקל זשעקסאן	Michael Jackson
28סטן דעצעמבער	28 december
גריפע	Influensa
באגאטא	Bogotá
בראזיליא	Brasília
15טן סעפטעמבער	15 september
14טן סעפטעמבער	14 september
13טן סעפטעמבער	13 september
12טן סעפטעמבער	12 september
8טן סעפטעמבער	8 september
11טן סעפטעמבער	11 september
7טן סעפטעמבער	7 september
10טן סעפטעמבער	10 september
5טן סעפטעמבער	5 september
4טן סעפטעמבער	4 september
9טן סעפטעמבער	9 september
2טן סעפטעמבער	2 september
6טן סעפטעמבער	6 september
1טן סעפטעמבער	1 september
3טן סעפטעמבער	3 september
29סטן דעצעמבער	29 december
לימא	Lima
30סטן סעפטעמבער	30 september
29סטן סעפטעמבער	29 september
28סטן סעפטעמבער	28 september
27סטן סעפטעמבער	27 september
26סטן סעפטעמבער	26 september
25סטן סעפטעמבער	25 september
סאנטיאגא	Santiago de Chile
23סטן סעפטעמבער	23 september
22סטן סעפטעמבער	22 september
24סטן סעפטעמבער	24 september
21סטן סעפטעמבער	21 september
20סטן סעפטעמבער	20 september
18טן סעפטעמבער	18 september
17טן סעפטעמבער	17 september
19טן סעפטעמבער	19 september
16טן סעפטעמבער	16 september
קיטא	Quito
30סטן דעצעמבער	30 december
31סטן דעצעמבער	31 december
1טן אקטאבער	1 oktober
15טן אקטאבער	15 oktober
12טן אקטאבער	12 oktober
10טן אקטאבער	10 oktober
14טן אקטאבער	14 oktober
9טן אקטאבער	9 oktober
8טן אקטאבער	8 oktober
13טן אקטאבער	13 oktober
7טן אקטאבער	7 oktober
11טן אקטאבער	11 oktober
6טן אקטאבער	6 oktober
4טן אקטאבער	4 oktober
5טן אקטאבער	5 oktober
3טן אקטאבער	3 oktober
2טן אקטאבער	2 oktober
אסונסיאן	Asunción
ציג	Tamget
היסטאריע פון קאנאדע	Kanadas historia
31סטן אקטאבער	31 oktober
30סטן אקטאבער	30 oktober
29סטן אקטאבער	29 oktober
28סטן אקטאבער	28 oktober
26סטן אקטאבער	26 oktober
25סטן אקטאבער	25 oktober
24סטן אקטאבער	24 oktober
27סטן אקטאבער	27 oktober
22סטן אקטאבער	22 oktober
23סטן אקטאבער	23 oktober
20סטן אקטאבער	20 oktober
21סטן אקטאבער	21 oktober
19טן אקטאבער	19 oktober
17טן אקטאבער	17 oktober
16טן אקטאבער	16 oktober
18טן אקטאבער	18 oktober
היידלבערג	Heidelberg
פריי	Frihet
15טן נאוועמבער	15 november
14טן נאוועמבער	14 november
13טן נאוועמבער	13 november
12טן נאוועמבער	12 november
11טן נאוועמבער	11 november
10טן נאוועמבער	10 november
7טן נאוועמבער	7 november
8טן נאוועמבער	8 november
9טן נאוועמבער	9 november
6טן נאוועמבער	6 november
5טן נאוועמבער	5 november
4טן נאוועמבער	4 november
3טן נאוועמבער	3 november
2טן נאוועמבער	2 november
1טן נאוועמבער	1 november
פאראמאריבא	Paramaribo
30סטן נאוועמבער	30 november
29סטן נאוועמבער	29 november
28סטן נאוועמבער	28 november
27סטן נאוועמבער	27 november
26סטן נאוועמבער	26 november
25סטן נאוועמבער	25 november
23סטן נאוועמבער	23 november
24סטן נאוועמבער	24 november
21סטן נאוועמבער	21 november
20סטן נאוועמבער	20 november
22סטן נאוועמבער	22 november
19טן נאוועמבער	19 november
18טן נאוועמבער	18 november
17טן נאוועמבער	17 november
16טן נאוועמבער	16 november
מיידל	Flicka
קאטמאנדו	Katmandu
העלגאלאנד	Helgoland
בעלמאפאן	Belmopan
קארל דער גרויסער	Karl den store
פיורדא	Fürth
סאן סאלוואדאר	San Salvador
קאנבערא	Canberra
סידני	Sydney
גרין	Grön
האדסאן טייך	Hudsonfloden
מעלבארן	Melbourne
רויט	Röd
פייער	Eld
ערד'ס אטמאספער	Jordens atmosfär
טעגוסיגאלפע	Tegucigalpa
מאנאגוע	Managua
פאנאמא-שטאט	Panama City
נילוס	Nilen
הארטפארדשיר	Hertfordshire
אסקאר (פיש)	Påfågelciklid
קאנגא טייך	Kongofloden
בארי	Bari
ניזשער טייך	Niger (flod)
ראבאט, מאראקא	Rabat
קאמעט	Komet
אלזשירס	Alger, Algeriet
טריפאלי	Tripoli
דזשיבוטי (שטאט)	Djibouti (stad)
אנטאפאגאסטא	Antofagasta
טעהראן	Teheran
אדיס אבאבא	Addis Abeba
דזשאקארטא	Jakarta
אנקארא	Ankara
נ'דזשאמענא	N'Djamena
ניאמיי	Niamey
נואקשוט	Nouakchott
ריאד	Riyadh
1961	1961
באמאקא	Bamako
בעלגראד	Belgrad
דאקאר	Dakar
באנזשול	Banjul
קאנאקרי	Conakry
ביסאו	Bissau
קאַטעגאָריע:וויקיפעדיע מוסטערן	Kategori:Mallar
קאסטרא (טשילע)	Castro (Chile)
מאנראוויע	Monrovia
1960	1960
קאַטעגאָריע:מוסטערן קאטעגאריעס	Kategori:Mallar efter ämne
אקרא	Accra
דמשק	Damaskus
יאמוסאקרא	Yamoussoukro
פראנצויזישע גויאנע	Franska Guyana
וואגאדוגו	Ouagadougou
פריטאון	Freetown
אמאזאנאס (טייך)	Amazonfloden
אבודזשא	Abuja
לאמע	Lomé
פארטא-נאווא	Porto-Novo
אמאן (יארדן)	Amman
יאונדע	Yaoundé
ביירוט	Beirut
ליברעוויל	Libreville
קאַטעגאָריע:היסטאריע מוסטערן	Kategori:Historiemallar
קינשאזע	Kinshasa
בראזאוויל	Brazzaville
ווארמז	Worms
בוזשומבורע	Bujumbura
ניקאסיע	Nicosia
קיגאלי	Kigali
דאכא	Doha
אסטערויד	Asteroid
דאדאמא	Dodoma
נייראבי	Nairobi
לילאנגווע	Lilongwe
קאַטעגאָריע:געאגראפישע מוסטערן	Kategori:Geografimallar
לוסאקא	Lusaka
ליקוי חמה	Solförmörkelse
מאפוטא	Maputo
קאמפאלא	Kampala
לואנדע	Luanda
מבאבאנע	Mbabane
מאסערו	Maseru
אלבערט דער צווייטער פון בעלגיע	Albert II av Belgien
בינארישע סיסטעם	Binära talsystemet
שולע	Skola
אנטאנאנאריווא	Antananarivo
אוניווערסיטעט	Universitet
גאבאראנע	Gaborone
הארארע	Harare
ווינטהוק	Windhoek
װיקיפּעדיע:זאמדקאסטן	Wikipedia:Sandlådan
װיקיפּעדיע:ברוכים הבאים	Wikipedia:Välkommen till Wikipedia
הויז	Hus
שויס קאמפיוטער	Bärbar dator
הארטווארג	Maskinvara
אלגעברע	Algebra
ליעזש	Liège
מענטשלעכע אנאטאמיע	Människans anatomi
מאפע	Karta
טייך	Flod
פראנקפורט אן דער אדער	Frankfurt an der Oder
אזאסקו	Osasco
גלאזגא	Glasgow
באדען-באדען	Baden-Baden
דאנג הוי לופטפעלד	Dong Hoi flygplats
קאסמאס	Rymden
אויטאביאגראפיע	Självbiografi
לוצערן	Luzern
טעלעסקאפ	Teleskop
מיילי סיירוס	Miley Cyrus
הויפט טאוול	Moderkort
קוריטיבא	Curitiba
מערב אפריקע	Västafrika
וואלד	Skog
הארטער דיסק	Hårddisk
מיט ראמני	Mitt Romney
פלאט	Örlogsflotta
אנדאליען (טייך)	Andalién
בארשט	Borsjtj
ספר איוב	Job
ראנקאגווע	Rancagua
אנע פראנק	Anne Frank
קאנפוציוס	Konfucius
שרה בערנאר	Sarah Bernhardt
מארלין דיטריך	Marlene Dietrich
מארלין מאנרא	Marilyn Monroe
קארבין בלו	Corbin Bleu
קאַטעגאָריע:מאטעמאטיק	Kategori:Matematik
בארברא סטרייסאנד	Barbra Streisand
פולא	Pula
רענעסאנס	Renässansen
לע קארבוזיע	Le Corbusier
איירא	Euro
אמעריקאנער דאלאר	Amerikansk dollar
מיטלענדישער ים	Medelhavet
זשארזשיע	Georgia (olika betydelser)
סעב-מילער	SABMiller
קריסטנטום	Kristendom
סיאטל	Seattle
בערלינער וואנט	Berlinmuren
גאנגעס	Ganges
רייז	Ris
באלטימאר, מערילענד	Baltimore
קאנטינענט	Världsdelar och kontinenter
פויגל	Fåglar
הויפטשטאט	Huvudstad
פארטוגעזיש	Portugisiska
מאנאט	Månad
מוסטאפא קעמאל אטאטורק	Mustafa Kemal Atatürk
1948	1948
רונדווערעם	Rundmaskar
1949	1949
הואנג קסיאנפאן	Huang Xianfan
פעברואר 2009	Februari 2009
1956	1956
1202	1202
1204	1204
1941	1941
1945	1945
1958	1958
1926	1926
1947	1947
1944	1944
1952	1952
בריליאנט	Diamant
ביל גייטס	Bill Gates
יאפאניש	Japanska
ענציקלאפעדיע	Uppslagsverk
דיסקעט	Diskett
RAM זיכרון	Random Access Memory
הויפט זייט	Portal:Huvudsida
פראצעסאר	Central Processing Unit
1959	1959
מוסטער:גוטער ארטיקל	Mall:Bra
1957	1957
רוטירער	Router
רעזיסטאר	Resistor
קאנדענסאטאר	Kondensator
אינדוקטאר	Induktor
טראנזיסטאר	Transistor
בעיסבאל	Baseboll
קוישבאל	Basket
קריקעט	Cricket
גאלף (שפיל)	Golf
ראגבי פוטבאל	Rugby
אויטאספארט	Bilsport
אלימפיאדע	Olympiska spelen
יאנגצע	Yangtze
מיזורי טייך	Missourifloden
סיביר	Sibirien
פראנסיסקא גאיא	Francisco de Goya
הימאלייע	Himalaya
אנדן	Anderna
ראקי בערג	Klippiga bergen
קאפשטאט	Kapstaden
טראוויזיע	Treviso
קאווקאז בערג	Kaukasus
קאספישער ים	Kaspiska havet
אונטערגרונט באן	Tunnelbana
וויקטאריע אזערע	Victoriasjön
טאנגאניקע אזערע	Tanganyikasjön
בייקאל אזערע	Bajkalsjön
סאלוואדאר דאלי	Salvador Dalí
אלברעכט דירער	Albrecht Dürer
ווינצענט וואן גאך	Vincent van Gogh
קאצושיקא האקוסיי	Katsushika Hokusai
פרידא קאהלא	Frida Kahlo
אנרי מאטיס	Henri Matisse
מיקעלאנדזשעלא	Michelangelo
פאבלא פיקאסא	Pablo Picasso
ראפאעל	Rafael (konstnär)
רעמבראנדט	Rembrandt
פעטער פאל רובענס	Peter Paul Rubens
סינאן	Mimar Sinan
ענדי ווארהאל	Andy Warhol
פרענק לויד רייט	Frank Lloyd Wright
מאדעם	Modem
עמינעם	Eminem
בוס	Buss
טראמוויי	Spårväg
אבו נואס	Abu Nuwas
האנס קריסטיאן אנדערסען	H.C. Andersen
מאצוא באשא	Basho
לארד בייראן	Lord Byron
מיגעל דע סערוואנטעס	Miguel Cervantes
דזשעפרי טשאסער	Geoffrey Chaucer
בבל	Babylon
אנטאן פאוולאוויטש טשעכאוו	Anton Tjechov
טשארלס דיקנס	Charles Dickens
יריחו	Jeriko
סאמארקאנד	Samarkand
באלעארישע אינזלען	Balearerna
בית לחם	Betlehem
מעקא	Mecka
טשע געווארא	Che Guevara
קאנארישע אינזלען	Kanarieöarna
מאא צעטאנג	Mao Zedong
קארדאבע	Córdoba, Spanien
טאלעדא	Toledo, Spanien
קאבול	Kabul
בית הכסא פאפיר	Toalettpapper
גבריאל גארסיא מארקעס	Gabriel García Márquez
יאהאן וואלפגאנג פאן געטע	Johann Wolfgang von Goethe
וואגינע	Slida
טאמיל	Tamil
ארגאזם	Orgasm
פילאסאפיע	Filosofi
קאסמאס-פארן	Rymdfart
משפחה מענטש	Family Guy
קאַטעגאָריע:געשטעלטע צו שנעל מעקן	Kategori:Snabbraderingar
פיאנע	Piano
ראפ מוזיק	Rap
פופציק צענט	50 Cent
טיי	Te
מארקא פאלא	Marco Polo
קאמוניזם	Kommunism
אנארכיזם	Anarkism
קאפיטאליזם	Kapitalism
ליבעראליזם	Liberalism
פאשיזם	Fascism
נאציאנאליזם	Nationalism
כאפעז	Hafez
לאנד	Land
פאלק (נאציאן)	Nation
צווייטע פונישע מלחמה	Andra puniska kriget
דזשאו ביידען	Joe Biden
הילערי ראדהעם קלינטאן	Hillary Clinton
אינדיאנאפאליס	Indianapolis
בלעטערער	Webbläsare
בריטישער מוזיי	British Museum
שווימען	Simning
קאַטעגאָריע:אסטראנאמיע	Kategori:Astronomi
דארדאנעלן	Dardanellerna
זשאן-זשאק רוסא	Jean-Jacques Rousseau
סטאניסלאוו לעם	Stanisław Lem
פראנצויזישע רעוואלוציע	Franska revolutionen
1550	1550
1551	1551
קאַטעגאָריע:אסטראנאמען	Kategori:Astronomer
1552	1552
1553	1553
1554	1554
האמסטער	Hamstrar
אירקוצק	Irkutsk
סאהארא	Sahara
1556	1556
1557	1557
1558	1558
שטראסבורג	Strasbourg
גיטאר	Gitarr
1559	1559
1560	1560
1561	1561
1562	1562
1563	1563
1564	1564
1565	1565
האמאסעקסואלוטעט	Homosexualitet
1566	1566
1567	1567
1568	1568
1569	1569
קראאטיש	Kroatiska
1570	1570
1571	1571
1572	1572
1573	1573
1574	1574
1575	1575
האמעראס	Homeros
אלעקסאנדער פאן האמבאלט	Alexander von Humboldt
1576	1576
1577	1577
1578	1578
1579	1579
1580	1580
1581	1581
1582	1582
1600	1600
קארל פרידריך גאוס	Carl Friedrich Gauss
1601	1601
1583	1583
1602	1602
1584	1584
פערפיניאן	Perpignan
1603	1603
1585	1585
1604	1604
1586	1586
1605	1605
1587	1587
1606	1606
1607	1607
1588	1588
1608	1608
1589	1589
1609	1609
1590	1590
1610	1610
1591	1591
1611	1611
1592	1592
1612	1612
1593	1593
1613	1613
1594	1594
1614	1614
1595	1595
1615	1615
1596	1596
1616	1616
1597	1597
1617	1617
1598	1598
1618	1618
1599	1599
1619	1619
1620	1620
1621	1621
1700	1700
1701	1701
1622	1622
1623	1623
1702	1702
1624	1624
1703	1703
1704	1704
1625	1625
1705	1705
1626	1626
1627	1627
1706	1706
1628	1628
1707	1707
1708	1708
1629	1629
1630	1630
1709	1709
1631	1631
1710	1710
1632	1632
1711	1711
1633	1633
1712	1712
1634	1634
1713	1713
1800	1800
1801	1801
1714	1714
1635	1635
דזשיימס דזשויס	James Joyce
1802	1802
1715	1715
1636	1636
1803	1803
1637	1637
1716	1716
1638	1638
1804	1804
1717	1717
1639	1639
1805	1805
1718	1718
1640	1640
1719	1719
1806	1806
1641	1641
1720	1720
1807	1807
1642	1642
1721	1721
1808	1808
1643	1643
1722	1722
1809	1809
1644	1644
1723	1723
1810	1810
1645	1645
1724	1724
20סטער י"ה	1900-talet
1811	1811
1646	1646
1725	1725
1812	1812
1647	1647
1726	1726
1813	1813
21סטער י"ה	2000-talet
1648	1648
1727	1727
1814	1814
1649	1649
1728	1728
1815	1815
1650	1650
1729	1729
1816	1816
19טער י"ה	1800-talet
1651	1651
1730	1730
1817	1817
1652	1652
1731	1731
1818	1818
1653	1653
1732	1732
1819	1819
1654	1654
1733	1733
1820	1820
1655	1655
1821	1821
1734	1734
1656	1656
1822	1822
1735	1735
1657	1657
1823	1823
1736	1736
1658	1658
1737	1737
1824	1824
1659	1659
1738	1738
1825	1825
1660	1660
1739	1739
1826	1826
1661	1661
1740	1740
1827	1827
קאלידאסא	Kālidāsa
18טער י"ה	1700-talet
17טער י"ה	1600-talet
16טער י"ה	1500-talet
15טער י"ה	1400-talet
לוגאנא	Lugano
קאטאלאניש	Katalanska
14טער י"ה	1300-talet
זשיראנע	Girona
13טער י"ה	1200-talet
12טער י"ה	1100-talet
11טער י"ה	1000-talet
אטעאיזם	Ateism
לי באי	Li Bai
ביבליאטעק	Bibliotek
דאכוי	Dachau
מאטעריאליזם	Materialism
ניעלס באהר	Niels Bohr
באוואוסטזיין	Medvetande
ביאכעמיע	Biokemi
ביאפיזיק	Biofysik
ביאטעכנאלאגיע	Bioteknik
עקאלאגיע	Ekologi
אפריקאנער פארבאנד	Afrikanska unionen
גענעטיק	Genetik
פאליטיק	Politik
וועלט באנק	Världsbanken
קאלאניאליזם	Kolonialism
קאנסערוואטיזם	Konservatism
אראבישע ליגע	Arabförbundet
דעמאקראטיע	Demokrati
נאגיב מאכפוז	Naguib Mahfouz
רויטער קרייץ	Röda Korset
גלאבאליזאציע	Globalisering
נאט"א	Nato
מארי קירי	Marie Curie
גען	Gen
רעגירונג	Regering
נאבעל פריז	Nobelpriset
קין שי הואנג	Qin Shi Huangdi
מיקראביאלאגיע	Mikrobiologi
סימאן דע באוואר	Simone de Beauvoir
אווידיוס	Ovidius
מארסעל פרוסט	Marcel Proust
אלעקסאנדער פושקין	Aleksandr Pusjkin
מיטל מזרח	Mellanöstern
פאלעאנטאלאגיע	Paleontologi
עליזאבעט די ערשטע	Elisabet I av England
האן דינאסטיע	Handynastin
וויראלאגיע	Virologi
זשאן ד'ארק	Jeanne d’Arc
ראזא לוקסעמבורג	Rosa Luxemburg
סאפאקלעס	Sofokles
קאַטעגאָריע:קוואלן	Kategori:Vattenkällor
ארגאניזם	Organism
ראבינדראנאט טאגאר	Rabindranath Tagore
שיינקייט	Skönhet
לעוו טאלסטוי	Lev Tolstoj
מארק טוויין	Mark Twain
עלן טיורינג	Alan Turing
פעמיניזם	Feminism
אידעאלאגיע	Ideologi
אימפעריאליזם	Imperialism
מארקסיזם	Marxism
קעניגרייך	Monarki
רעפובליק	Republik
סאציאליזם	Socialism
מדינה	Stat
פאליטישע פארטיי	Politiskt parti
פראפאגאנדע	Propaganda
טעראריזם	Terrorism
יאהאנעס בראהמס	Johannes Brahms
קילימאנדזשארא	Kilimanjaro
אנטאנין דווארזשאק	Antonín Dvořák
געארג פרידריך הענדל	Georg Friedrich Händel
גוסטאוו מאהלער	Gustav Mahler
קוש	Kyss
נאציזם	Nazism
דזיאקאמא פוטשיני	Giacomo Puccini
פראנץ שובערט	Franz Schubert
איגאר סטראווינסקי	Igor Stravinskij
פעטער איליטש טשייקאווסקי	Pjotr Tjajkovskij
דזשוסעפע ווערדי	Giuseppe Verdi
נאצי דייטשלאנד	Nazityskland
זשאק קארטיער	Jacques Cartier
קריסטאפער קאלאמבוס	Christofer Columbus
דזשיימס קוק	James Cook
ייד	Judar
הערנאן קארטעס	Hernán Cortés
יורי גאגארין	Jurij Gagarin
וואשקו דא גאמא	Vasco da Gama
איבן באטוטא	Ibn Battuta
זשענג הע	Zheng He
אוישוויץ	Auschwitz
אשפעצין	Oświęcim
גרויסער באריער ריף	Stora barriärrevet
גרויסע אזערעס	Stora sjöarna
אינדוס	Indus
יאזעף היידן	Joseph Haydn
פאנאמא קאנאל	Panamakanalen
דרום אקעאן	Antarktiska oceanen
געלער טייך	Gula floden
אויער	Öra
נאז	Nos
אויג	Öga
מוסקל	Muskel
ליד	Sång
קאמאר	Stickmyggor
שאף	Tamfår
דעלפין	Delfiner
פעדעריקא פעליני	Federico Fellini
הייפיש	Hajar
אלפרעד היטשקאק	Alfred Hitchcock
קעמל	Kameler
זויגער	Däggdjur
פרימאט	Primater
מוראשקע	Myror
שטימע	Rösten
ווייכווארג	Programvara
האלענדיש	Nederländska
מארגארעט טאטשער	Margaret Thatcher
עדה יאנאט	Ada Yonath
DNA	DNA
זגאל	Art
וואהלין	Volynien
פאטלעזשאן	Aubergine
אינגמאר בערזשמאן	Ingmar Bergman
לוצק	Lutsk
איבערזעצונג	Översättning
קאטשקע	Egentliga andfåglar
מוטער	Moder
שניי	Snö
טאטע	Fader
קינד	Barn
1828	1828
1829	1829
1741	1741
1662	1662
1742	1742
1830	1830
1663	1663
1831	1831
1743	1743
1664	1664
1665	1665
1744	1744
1832	1832
1666	1666
1745	1745
1833	1833
1667	1667
1746	1746
טראנספארט	Transport
1834	1834
1668	1668
1747	1747
1835	1835
1748	1748
1836	1836
1669	1669
לעאנהארד אוילער	Leonhard Euler
1670	1670
1749	1749
1837	1837
1671	1671
1750	1750
1838	1838
1672	1672
1751	1751
1839	1839
1673	1673
1752	1752
1840	1840
1674	1674
1753	1753
1841	1841
1754	1754
1675	1675
1842	1842
1755	1755
1676	1676
1843	1843
1677	1677
1756	1756
1844	1844
1678	1678
1757	1757
1845	1845
1679	1679
1758	1758
1846	1846
1680	1680
1759	1759
1847	1847
1681	1681
1760	1760
1848	1848
1682	1682
1761	1761
1849	1849
1683	1683
1762	1762
1850	1850
1684	1684
1763	1763
1851	1851
1764	1764
1685	1685
1852	1852
1686	1686
1765	1765
1853	1853
1687	1687
1766	1766
1854	1854
1688	1688
1767	1767
1855	1855
1689	1689
1768	1768
1856	1856
1690	1690
1769	1769
1857	1857
1691	1691
1770	1770
1858	1858
1692	1692
1771	1771
1859	1859
1693	1693
1772	1772
1860	1860
1773	1773
1861	1861
1694	1694
1695	1695
1774	1774
1862	1862
1696	1696
1775	1775
1863	1863
1697	1697
1776	1776
1864	1864
1698	1698
1865	1865
1777	1777
1699	1699
1866	1866
1778	1778
1779	1779
1867	1867
1780	1780
1868	1868
1781	1781
1869	1869
אוונט	Kväll
מינוט	Minut
יידישע אויטאנאמע געגנט	Judiska autonoma länet
יהושע בן נון	Josua
רוסיש	Ryska
1782	1782
1870	1870
לואי דער פערצנטער	Ludvig XIV av Frankrike
1783	1783
1871	1871
וולאדימיר פוטין	Vladimir Putin
געזעץ	Juridik
ראק און ראל	Rock'n'roll
1784	1784
1872	1872
מאטעמאטישער אנאליז	Matematisk analys
קאנסטיטוציע	Grundlag
1785	1785
1873	1873
1786	1786
1874	1874
1787	1787
1875	1875
1788	1788
1876	1876
פארבאנד פון דרום-מזרח אזיאטישע פעלקער	Association of Southeast Asian Nations
ביראבידזשאן	Birobidzjan
1789	1789
1877	1877
1790	1790
1878	1878
קהל פון זעלבשטענדיקע שטאטן	Oberoende staters samvälde
1879	1879
1791	1791
קאמאנוועלט	Samväldet
היסטאריע פון אייראפע	Europas historia
היסטאריע פון גריכנלאנד	Greklands historia
אפעק	Opec
אינטערנאציאנאלע געריכט פון יוסטיץ	Internationella domstolen i Haag
ברויט	Bröd
אינטערנאציאנאלער געלטפאנד	Internationella valutafonden
1792	1792
1880	1880
1793	1793
1881	1881
אונעסקא	Unesco
1794	1794
1882	1882
אלוועלטלעכע דעקלאראציע פון מענטשרעכט	FN:s deklaration om de mänskliga rättigheterna
1795	1795
1883	1883
װעלט געזונט ארגאניזאציע	Världshälsoorganisationen
1796	1796
1884	1884
1797	1797
1885	1885
1886	1886
1798	1798
וועלט האנדל ארגאניזאציע	Världshandelsorganisationen
1887	1887
1799	1799
1888	1888
1889	1889
1890	1890
קרים	Krim
1891	1891
סוואהילי	Swahili
1892	1892
1893	1893
1894	1894
1895	1895
1896	1896
1897	1897
1898	1898
כינעזיש	Kinesiska
1899	1899
בית הכסא	Toalett
נאטור	Natur
טוש	Dusch
פסיכיאטריע	Psykiatri
צעל	Cell
בלוט	Blod
טולוז	Toulouse
סקעלעט	Skelett
לונג	Lunga
אטעם-סיסטעם	Respirationssystemet
פארמערן סיסטעם	Fortplantningssystemet
רומעניש	Rumänska
בולגאריש	Bulgariska
רעגן	Regn
לאווינע	Lavin
קלימאט	Klimat
על ניניא	El Niño
גלאבאלע אנווארעמען	Global uppvärmning
ערדציטערניש	Jordbävning
מינעראל	Mineral
אמת	Sanning
ערד פלאטעס	Plattektonik
זען בודהיזם	Zen
מויז (קאמפיוטער)	Datormus
נאטור-וויסנשאפטן	Naturvetenskap
סערגיי אייזנשטיין	Sergej Eisenstein
אקירא קוראסאווא	Akira Kurosawa
פרענקלין דעלאנא רוזעוועלט	Franklin D. Roosevelt
ערד וויסנשאפט	Geovetenskap
אוויצענא	Avicenna
דארבי מוזיי און קונסט גאלעריע	Derby Museum and Art Gallery
ווינסטאן טשערטשיל	Winston Churchill
אויגוסטינוס	Augustinus
נעלסאן מאנדעלע	Nelson Mandela
מארטין לוטער קינג	Martin Luther King
עקאנאמיע פון דייטשלאנד	Tysklands ekonomi
ענזים	Enzym
10טער י"ה	900-talet
פראטעין	Protein
ציגיינער	Romer
שטיין	Bergart
נאטירלעכע קאטאסטראפע	Naturkatastrof
פארפלייצונג	Översvämning
צונאמי	Tsunami
וואולקאן	Vulkan
וואלקן	Moln
לאגיק	Logik
טארנאדא	Tromb
9טער י"ה	800-talet
טריגאנאמעטריע	Trigonometri
8טער י"ה	700-talet
געאמעטריע	Geometri
7טער י"ה	600-talet
6טער י"ה	500-talet
גראמאטיק	Grammatik
שטורעם ווינט	Tropisk cyklon
נינטענדא	Nintendo
ווינט	Vind
5טער י"ה	400-talet
4טער י"ה	300-talet
3טער י"ה	200-talet
2טער י"ה	100-talet
אטמאספער	Atmosfär
1טער י"ה	000-talet
גרוזיניש	Georgiska
עקאנאמיק	Nationalekonomi
קאפיטאל	Kapital
וואלוטע	Valuta
יאפאנעזער יען	Yen
אינדוסטריע	Industri
שטייער	Skatt
לינגוויסטיק	Språkvetenskap
ווארט	Ord
פאנעם	Fonem
טראף	Stavelse
שריפט	Skrift
אראבישער אלפאבעט	Arabiska alfabetet
כינעזישע שריפט	Kinesiska tecken
קירילישע שריפט	Kyrilliska alfabetet
גריכישער אלפאבעט	Grekiska alfabetet
האנגול	Hangul
לאטיינישער אלפאבעט	Latinska alfabetet
ליטעראט	Läskunnighet
קאַטעגאָריע:בולגאריע	Kategori:Bulgarien
ליטעראטור	Litteratur
קאַטעגאָריע:פראנקרייך	Kategori:Frankrike
די קונסט פון מלחמה	Krigskonsten
בעלעטריסטיק	Fiktion
קאַטעגאָריע:מוזיק	Kategori:Musik
טויזנט און איין נעכט	Tusen och en natt
קאַטעגאָריע:ליטעראטור	Kategori:Litteratur
ראמאן	Roman
קאַטעגאָריע:דיכטונג	Kategori:Poesi
חלום פונעם רויטן קאמער	Drömmar om röda gemak
קאַטעגאָריע:היסטאריע: פראנקרייך	Kategori:Frankrikes historia
אייראזאנע	Euroområdet
די מעשה פון גענזשי	Berättelsen om Genji
גילגאמעש עפאס	Gilgamesheposet
איליאדע	Iliaden
מאהאבהאראטא	Mahabharata
שאהנאמע	Shahnameh
FBI	Federal Bureau of Investigation
הארי פאטער	Harry Potter
טרומייט	Trumpet
דזשעז	Jazz
פידל	Violin
באראק מוזיק	Barockens musik
אלגאריטם	Algoritm
טשעלא	Cello
דראג	Drog
פעדעפיליע	Pedofili
סעקס פאזיציעס	Lista över samlagsställningar
אנאנירן	Onani
אנאל סעקס	Analsex
אלעקסאנדער דער גרויסער	Alexander den store
קאנסטאנטין דער גרויסער	Konstantin den store
כורש	Kyros II
געזעלשאפט (סאציאלאגיע)	Samhälle (sociologi)
ציוויליזאציע	Civilisation
חינוך	Bildning
פאמיליע	Familj
יוגא טשאוועז	Hugo Chávez
מאנצביל	Man
אטא פאן ביסמארק	Otto von Bismarck
אישות	Äktenskap
אבארטאציע	Abort
טויטשטראף	Dödsstraff
מענטשן רעכט	Mänskliga rättigheter
ראסיזם	Rasism
טימור	Timur Lenk
שקלאפעריי	Slaveri
בירגער קריג	Inbördeskrig
אומאר איבן אל-כאטאב	Umar ibn al-Khattab
מיליטער	Militär
סוליימאן דער ערשטער	Süleyman I
פיטער דער גרויסער	Peter den store
קאווע	Kaffe
זאפט	Juice
מילך	Mjölk
באַרג	Berg
מדבר	Öken
זומער אלימפיאדע 2008	Olympiska sommarspelen 2008
סון יאט-סען	Sun Yat-sen
זומער אלימפיאדע 2012	Olympiska sommarspelen 2012
סאלאדין	Saladin
אשאקא	Ashoka
אקבאר	Akbar den store
סימאן באליוואר	Simón Bolívar
היפנאזיע	Hypnos
ענדרו זשאנסאן	Andrew Johnson
פיער עליאט טרודא	Pierre Trudeau
קוואמע נקרומאה	Kwame Nkrumah
יידיש	Jiddisch
האנג קאנג	Hongkong
מיאמי	Miami
קאראטשי	Karachi
מיטל מזרח קאנפליקט	Arab-israeliska konflikten
לאגאס	Lagos
אמעריקאנער בירגערקריג	Amerikanska inbördeskriget
ריא דע זשאנערא	Rio de Janeiro
בריטישע אימפעריע	Brittiska imperiet
קאלטער קריג	Kalla kriget
סעאל	Seoul
שאנכיי	Shanghai
קולטורעלע רעוואלוציע	Kulturrevolutionen
לאנדאן היטרוי ערפארט	London-Heathrow flygplats
וועלט ווירטשאפט קריזיס	Stora depressionen
וואלט דיזני	Walt Disney
מיידזשי רעסטאראציע	Meijirestaurationen
סעווילא	Sevilla
רוסישע רעוואלוציע	Ryska revolutionen
לאס אנדזשעלעס אינטערנאציאנאלע פליפעלד	Los Angeles International Airport
טשינג דינאסטיע	Qingdynastin
ווערסיי אפמאך	Versaillesfreden
ארכימעד	Arkimedes
וויעטנאם קריג	Vietnamkriget
טאמעס עדיסאן	Thomas Edison
אוקלידוס	Euklides
מייקל פאראדיי	Michael Faraday
באסקיש	Baskiska
ענריקא פערמי	Enrico Fermi
בריטיש ערוועיס	British Airways
DNS	Domännamnssystemet
הענרי פארד	Henry Ford
גאלען	Galenos
קריפטאגראפיע	Kryptografi
אינטערנעט פראטאקאל	Internetprotokoll
אוקראיניש	Ukrainska
ביט	Bit
HTML	HTML
וואלענציע	Valencia
יוניקאד	Unicode
סאטיאדזשיט ריי	Satyajit Ray
סטיווען ספילבערג	Steven Spielberg
אייראפעאישע קאמיסיע	Europeiska kommissionen
אייראפעישער צענטראלבאנק	Europeiska centralbanken
אייראפעישע אטאמישע ענערגיע געמיינדע	Europeiska atomenergigemenskapen
יאהאן גוטנבערג	Johannes Gutenberg
דזשיימס פרעסקאט דזשול	James Prescott Joule
יאהאנעס קעפלער	Johannes Kepler
מאקס פלאנק	Max Planck
שוועדיש	Svenska
דעניש	Danska
ניקאלא טעסלא	Nikola Tesla
אל־כוואריזמי	Muhammad ibn Musa al-Khwarizmi
זשיימס וואט	James Watt
טשאנאקיע	Chanakya
גאטפריד ווילהעלם לייבניץ	Gottfried Wilhelm von Leibniz
נועם כאמסקי	Noam Chomsky
לוקסעמבורגיש	Luxemburgiska
טשעכיש	Tjeckiska
סלאוואקיש	Slovakiska
קארל מארקס	Karl Marx
סלאוועניש	Slovenska
אונגעריש	Ungerska
וואלטער	Voltaire
משה רבינו	Mose
לעטיש	Lettiska
וויסן	Kunskap
ליטוויש	Litauiska
הינדואיזם	Hinduism
בעלארוסיש	Vitryska
דזשיימס קלארק מאקסוועל	James Clerk Maxwell
ברוסט	Kvinnobröst
דמיטרי מענדלעעוו	Dmitrij Mendelejev
אטאם	Atom
ערנעסט ראדערפארד	Ernest Rutherford
ליכט	Ljus
גריכיש	Grekiska
ערווין שרעדינגער	Erwin Schrödinger
מיטאלאגיע	Mytologi
אפערירן סיסטעם	Operativsystem
טאזש מאהאל	Taj Mahal
איריש	Iriska
פראגראמירן שפראך	Programspråk
פינגווין	Pingviner
פונדאמענטאליזם	Fundamentalism
בליצפאסט	E-post
מאנאטעיזם	Monoteism
פאליטעאיזם	Polyteism
נשמה	Själ
מאלטעזיש	Maltesiska
פערסיש	Persiska
רעליגיע	Religion
קארעיש	Koreanska
אברהם אבינו	Abraham (patriark)
ספר בראשית	Första Moseboken
עמפייער סטעיט בילדינג	Empire State Building
ספר שמות	Andra Moseboken
רענע דעקארט	René Descartes
וויעטנאמעזיש	Vietnamesiska
שאול התרסי	Paulus
סטאטוע פון ליבערטי	Frihetsgudinnan
אמעריקאנער ארמיי	USA:s armé
זיגמונד פרויד	Sigmund Freud
טיילאנדיש	Thai
דזשייניזם	Jainism
געארג ווילהעלם פרידריך העגל	Friedrich Hegel
מאנגאליש	Mongoliska
באקו	Baku
וועלט ירושה ארט	Världsarv
סאלאט	Sallad
יידישקייט	Judendom
העברעאיש	Hebreiska
איבן כאלדון	Ibn Khaldun
סערביש	Serbiska
באסניש	Bosniska
אימאנועל קאנט	Immanuel Kant
סיקהיזם	Sikhism
דזשאן מיינארד קינס	John Maynard Keynes
אויפפיר	Beteende
לאא צי	Lao Zi
Gmail	Gmail
גוגל דאקומענטן	Google Drive
יאגא	Yoga
דזשאן לאק	John Locke
פרידריך ניצשע	Friedrich Nietzsche
בישקעק	Bisjkek
זשאן-פאל סארטרע	Jean-Paul Sartre
דושאנבע	Dusjanbe
גוגל (זוכמאשין)	Google (sökmotor)
לעבער	Lever
סימא טשיען	Sima Qian
ניר	Njure
אדם סמיט	Adam Smith
אוריניר פענכער	Urinblåsan
מאקס וועבער	Max Weber
לודוויג וויטגנשטיין	Ludwig Wittgenstein
זשו טשי	Zhu Xi
נערוון סיסטעם	Nervsystemet
געפיל	Känsla
פסיכאלאגיע	Psykologi
טראכטן	Tänkande
טימבוקטו	Timbuktu
אקעאן	Ocean
טאמאס פון אקווינא	Thomas av Aquino
קעניגין וויקטאריע	Viktoria av Storbritannien
גאוטאמא בודהא	Buddha
רעגנוואלד	Regnskog
דיאלעקטיק	Dialektik
מוכאמאד	Muhammed
מידות	Etik
עפיסטעמאלאגיע	Epistemologi
בחירה	Fri vilja
IPod	Ipod
משמעותדיקייט	Sannolikhet
רעאליטעט	Verklighet
אטעם	Andning
בי בי סי	BBC
טאני בלער	Tony Blair
אל-גאזאלי	Mohammad Ghazali
מארטין לוטער	Martin Luther
קאנפוציאניזם	Konfucianism
דזשעראלד פארד	Gerald Ford
שיא איסלאם	Shia
ריטשארד ניקסאן	Richard Nixon
ITunes	Itunes
קאטוילישע קירכע	Romersk-katolska kyrkan
טרימורטי	Trimurti
בויך	Buken
טאאיזם	Taoism
זאראאסטריזם	Zoroastrism
סופיזם	Sufism
בענגאליש	Bengali
טראכט	Livmoder
צונג	Tunga
פאנקרעאס	Bukspottkörtel
נערוו	Nerv
גענאק	Hals
מויל	Mun
שטימע קעסטל	Struphuvud
געדערעם	Tarm
לינדאן זשאנסאן	Lyndon B. Johnson
געלענק	Led
ברוסטקאסטן	Bröst
דריז	Körtel
פאלקלאנד אינזלען	Falklandsöarna
פארדייאונג סיסטעם	Mag- och tarmkanalen
A	A
מיכאל שומאכער	Michael Schumacher
אינזל פון ווייט	Isle of Wight
עליזאבעט די צווייטע	Elizabeth II
טאנג דינאסטיע	Tangdynastin
ניו יארק טיימס	The New York Times
מידקייט	Trötthet
זשאן עף. קענעדי	John F. Kennedy
B	B
זרע	Sädesvätska
דזשיאאקינא ראסיני	Gioacchino Rossini
קלאסישע מוזיק	Klassisk musik
סימפאניע	Symfoni
G	G
U	U
Z	Z
בלוז	Blues
פלאמענקא	Flamenco
F	F
J	J
עלעקטראנישע מוזיק	Elektronisk musik
אלפאבעט	Alfabet
אות	Bokstav
רעגיי	Reggae
T	T
C	C
מיטלשול	High school
R	R
D	D
אלפא	Alfa
I	I
מינג דינאסטיע	Mingdynastin
E	E
H	H
דווייט דעיוויד אייזנהאוער	Dwight D. Eisenhower
K	K
L	L
M	M
N	N
O	O
Q	Q
S	S
ראנאלד רייגען	Ronald Reagan
V	V
W	W
X	X
Y	Y
ענדי מאריי	Andy Murray
פלאזמע	Plasma
קאנאל טונעל	Kanaltunneln
פיטאגאראס	Pythagoras
קאלאסעום	Colosseum
פארטענאן	Parthenon
ארימקייט	Fattigdom
סאראגאסא	Zaragoza
דזשאן מעקעין	John McCain
פערנאנדא אלאנסא	Fernando Alonso
דעיוויד בעקהעם	David Beckham
גארדאן בראון	Gordon Brown
נעוויל טשעמבערליין	Neville Chamberlain
קאַטעגאָריע:װענעזועלע	Kategori:Venezuela
בעלפאסט	Belfast
קארדיף	Cardiff
פעריאדישע טאבעלע	Periodiska systemet
טיבאר סעקעלי	Tibor Sekelj
זעלבסטמארד	Självmord
נאקעט	Nakenhet
9/11	11 september-attackerna
רעפטיליע	Kräldjur
סעקס שפילצייג	Sexuella hjälpmedel
נאגער	Gnagare
טויבן	Duvor
שפּאנישע בירגער קריג	Spanska inbördeskriget
ארכעען	Arkéer
בלינדקייט	Blindhet
באקטעריע	Bakterier
בוים	Träd
פראטיסטן	Protister
אמפיביע	Groddjur
כארדאטן	Ryggsträngsdjur
רעוואלוציע	Revolution
קעז	Ost
וויינטרויבן	Druva
האניג	Honung
פלייש	Kött
קארטאפל	Potatis
צוקער	Socker
גרינצייג	Grönsaker
סויע	Sojaböna
נוס	Nöt
ראבאט	Robot
טעכנאלאגיע	Teknologi
מאשין	Maskin
שרויף	Skruv
אינזשעניריע	Ingenjörsvetenskap
קאמוניקאציע	Kommunikation
אינפארמאציע	Information
זשורנאליזם	Journalistik
צייטונג	Tidning
מאסן מעדיע	Massmedium
דרוקעריי	Tryckteknik
טעלעפאן	Telefon
קולטור	Kultur
הינדוסטאני	Hindustani
סאנסקריט	Sanskrit
בלוט צירקולאציע	Hjärt- och kärlsystemet
ענדאקרינאלע סיסטעם	Endokrina systemet
אלצהיימערס קרענק	Alzheimers sjukdom
גראבע קישקע	Tjocktarm
פארקינסאן קרענק	Parkinsons sjukdom
קליינע קישקע	Tunntarm
חוש-סיסטעם	Sinnesorgan
שפעק	Bacon
IP אדרעס	IP-adress
זייערס	Syra
אומארגאנישע כעמיע	Oorganisk kemi
פראגע צייכן	Frågetecken
כעמישע פארבינדונג	Kemisk förening
יוליאנישער קאלענדאר	Julianska kalendern
מעדיצין	Medicinsk vetenskap
וועלט פאקטבוך	The World Factbook
באזע (כעמיע)	Bas (kemi)
סאראיעווא	Sarajevo
לאגאריטם	Logaritm
העכסטע געריכט פון די פאראייניגטע שטאטן	USA:s högsta domstol
אריטמעטיק	Aritmetik
פענטאגאן	Pentagon (byggnad)
קאארדינאטן סיסטעם	Koordinatsystem
מיליטער פון די פאראייניקטע שטאטן פון אמעריקע	USA:s väpnade styrkor
דיפערענציאל-גלייכונג	Differentialekvation
Windows 7	Windows 7
נומערישער אנאליז	Beräkningsvetenskap
יו.עס. מארין קארפס	USA:s marinkår
אמעריקאנער פלאט	USA:s flotta
אמעריקאנער לופטפלאט	USA:s flygvapen
אמעריקאנער בארטן פאטראל	USA:s kustbevakning
פראצענט	Procent
Windows Vista	Windows Vista
היימלאנד זיכערהייט	USA:s inrikessäkerhetsdepartement
Windows Server 2008	Windows Server 2008
World Trade Center	World Trade Center
סמיילי	Smiley
Windows Server 2003	Windows Server 2003
Windows XP	Windows XP
מידטאון מאנהעטן	Midtown, Manhattan
לאוער מאנהעטען	Lower Manhattan
זאלץ	Salt
Microsoft Office	Microsoft Office
פידעל קאסטרא	Fidel Castro
Microsoft Word	Microsoft Word
קאנגרעס	USA:s kongress
עקסעל	Microsoft Excel
קאַטעגאָריע:בראזיל	Kategori:Brasilien
טראל (אינטערנעט)	Internettroll
מאנהעטן	Manhattan
וואלקן קראצער	Skyskrapa
שאפינג מאלל	Köpcentrum
קאַטעגאָריע:רומעניע	Kategori:Rumänien
כעמישער עלעמענט	Grundämne
גלייכונג	Ekvation
פונקציע	Funktion
ארגאנישע כעמיע	Organisk kemi
ווינקל	Vinkel
קארבאהידראט	Kolhydrat
הארמאן	Hormon
ליפיד	Lipid
יוניקס	Unix
מאלעקול	Molekyl
פיזיקאלישע כעמיע	Fysikalisk kemi
פארגיכערונג	Acceleration
ענערגיע	Energi
לאקאל נעצווערק	Lokalt datornät
קאנסערווירונג פון ענערגיע	Energiprincipen
עלעקטראמאגנעטישע שטראלונג	Elektromagnetisk strålning
אינפרארויט	Infraröd strålning
אולטראוויאלעט	Ultraviolett strålning
זגאלן אין סכנה	Utrotningshotad art
שטוביקונג	Domesticering
קלאסישע מעכאניק	Klassisk mekanik
ביאלאגישע קלאסיפיקאציע	Vetenskapligt namn
ראק מוזיק	Rockmusik
היפ האפ	Hiphop
קראפט	Kraft
סאמבע	Samba (musik)
פויק	Trumma
פלייט	Flöjt
מאגנעטיש פעלד	Magnetfält
אפארטהייד	Apartheid
שפיל	Spel
טריק-טראק	Backgammon
גראוויטאציע	Gravitation
גא	Go (brädspel)
שטארקע קראפט	Stark växelverkan
קאמפקונסט	Stridskonst
שוואכע קראפט	Svag växelverkan
קאראטע	Karate
דזשודא	Judo
מאגנעט	Magnet
שפילכל	Leksak
מאסע	Massa
פילם	Film
אנימאציע	Animering
מעטאל	Metall
שטאל (מעטאל)	Stål
יאדער-שפאלטונג	Fission
צושטאנד פון מאטעריע	Aggregationstillstånd
גאז	Gas
פליסיקייט	Vätska
לופטמאשין	Flygmaskin
סאלידער קערפער	Fast form
ביציקל	Cykel
שיף	Skepp
ראדיאאקטיוויטעט	Radioaktivitet
לאנדווירטשאפט	Jordbruk
אלגעמיינע טעאריע פון רעלאטיוויטעט	Allmänna relativitetsteorin
באוואסערונג	Konstbevattning
ספעציעלע טעאריע פון רעלאטיוויטעט	Speciella relativitetsteorin
האלב-דורכפירער	Halvledare
באוול	Bomull
קליידונג	Kläder
קלאנג	Ljud
אדאבי	Adobe Systems
אקער	Plog
גיכקייט	Hastighet
טעמפעראטור	Temperatur
מעטאלורגיע	Metallurgi
נאנאטעכנאלאגיע	Nanoteknik
גלאז	Glas
צייט	Tid
פאפיר	Papper
טערמאדינאמיק	Termodynamik
פלאסטיק	Plast
וואקיום	Vakuum
שטח	Area
פיטאגאראס פרינציפ	Pythagoras sats
מאטעמאטישער דערווייז	Matematiskt bevis
צאל	Tal
קאמפלעקסע צאל	Komplexa tal
דארווין, אויסטראליע	Darwin, Northern Territory
קילאגראם	Kilogram
מעטער	Meter
סעקונדע	Sekund
קוקורוזע	Majs
גערשט	Korn
ליטער	Liter
בליטש	Blekmedel
הערי עס טרומאן	Harry S. Truman
מאלעריי	Målarkonst
פאטאגראפיע	Fotografi
סקולפטור	Skulptur
טעאטער	Teater
דזשודי גארלאנד	Judy Garland
טאנץ	Dans
טעפעריי	Krukmakeri
עלעקטראניק	Elektronik
עלעקטרישער שטראם	Elektrisk ström
פרעקווענץ	Frekvens
דיאדע	Diod
טראנספארמאטאר	Transformator
קינסטלעכע אינטעליגענץ	Artificiell intelligens
אינפארמאציע טעכנאלאגיע	Informationsteknik
וועטער	Väder
ענדרו קוואמא	Andrew Cuomo
דעיוויד פעטערסאן	David Paterson
עליאט שפיצער	Eliot Spitzer
דזשארזש פאטאקי	George Pataki
אקציע (פינאנץ)	Aktie
פרעזידענט פון די פאראייניגטע שטאטן	USA:s president
רעסטאראן	Restaurang
דרום-מזרח אזיע	Sydostasien
רשימה:לענדער פון דער וועלט	Lista över självständiga stater
פרעהיסטאריע	Förhistorisk tid
לייזער זאמענהאף	Ludwig Zamenhof
שטיין עפאכע	Stenåldern
בראנדז עפאכע	Bronsåldern
אייזן עפאכע	Järnåldern
מעסאפאטאמיע	Mesopotamien
אוראלט עגיפטן	Forntida Egypten
אוראלט גריכנלאנד	Antikens Grekland
גופטא אימפעריע	Guptariket
בער	Björnar
זשאן עדעמס	John Adams
טאמעס זשעפערסאן	Thomas Jefferson
זשיימס מעדיסאן	James Madison
זשיימס מאנרא	James Monroe
זשאן קווינסי עדעמס	John Quincy Adams
ענדרו זשעקסאן	Andrew Jackson
מארטין וואן ביורען	Martin Van Buren
וויליאם הענרי העריסאן	William Henry Harrison
זשאן טיילער	John Tyler
וויליאם ראאן האמילטאן	William Rowan Hamilton
זשיימס נאקס פאלק	James K. Polk
זאקארי טיילאר	Zachary Taylor
בריטני ספירס	Britney Spears
פארדייאונג	Matspjälkning
פאטאסינטעז	Fotosyntes
רעפראדוקציע	Fortplantning
שוואנגערן	Graviditet
קיילי מינא	Kylie Minogue
דעמב	Eksläktet
גוגל מאפע	Google Maps
גוגל נייעס	Google Nyheter
סאסנע	Tallsläktet
אדיקציע	Beroende
קענסער	Cancer
כאלערע	Kolera
קארן	Råg
האבער	Havre
ווייץ	Vetesläktet
סארגע	Durrasläktet
תבואה	Sädesslag
פארקילונג	Förkylning
ציינדאקטעריי	Tandvård
דעפעקטיווקייט	Funktionsnedsättning
קאלענדאר	Kalender
טויב	Dövhet
מח-קרענק	Psykisk störning
קראנקייט	Sjukdom
גרעגאריאנישער קאלענדאר	Gregorianska kalendern
מעדיקאמענט	Läkemedel
צייט זאנע	Tidszon
ניקאטין	Nikotin
געזונט	Hälsa
הארץ אטאקע	Hjärtinfarkt
טוטאַנכאַמון	Tutankhamon
מאלאריע	Malaria
אנטארעס	Antares
נישט-דערנערונג	Näringsbrist
מענסטרואציע	Menstruation
גראב	Fetma
פאנדעמיע	Pandemi
אנטיביאטיק	Antibiotikum
פעניצילין	Penicillin
נאנט	Nantes
לונגען אנטצינדונג	Lunginflammation
קינדער-פאראליז	Polio
געשלעכט-קראנקייט	Sexuellt överförbar infektion
עידס	Aids
וואטע שפיץ	Bomullspinne
אנפאל	Slaganfall
טובערקולאז	Tuberkulos
צוקערקרענק	Diabetes
פאקן	Smittkoppor
קורדן	Kurder
ארכיטעקטור	Arkitektur
בויגן (ארכיטעקטור)	Båge
בריק	Bro
קאנאל	Kanal
מילארד פילמאר	Millard Fillmore
פרענקלין פירס	Franklin Pierce
דאם	Dammbyggnad
זשיימס ביוקענען	James Buchanan
זאלץ (כעמיע)	Salter
פירענעען	Pyrenéerna
שוויץ (קאנטאן)	Schwyz (kanton)
דעטרויט	Detroit
מאס	Mätning
אינטערנאציאנאלע סיסטעם פון איינסן	Internationella måttenhetssystemet
נומערן טעאריע	Talteori
סכומען טעאריע	Mängdteori
סטאטיסטיק	Statistik
סימעטריע	Symmetri
קופאל	Kupol
בורדזש כאליפא	Burj Khalifa
כינעזער וואנט	Kinesiska muren
גאנצע צאל	Heltal
האגיא סאפיא	Hagia Sofia
טרעפּ	Trappa
פעטראס באסיליקע	Peterskyrkan
דריי-שלוכטן-דאמבע	De tre ravinernas damm
פיראמיד	Pyramid
טורעם	Torn
אבאסישער כאליפאט	Abbasidkalifatet
אויפקלערונג	Upplysningstiden
אזטעק	Azteker
ביזאנטישע אימפעריע	Bysantinska riket
קרייצצוג	Korståg
הייליגע רוימישע אימפעריע	Tysk-romerska riket
הונדערט-יעריגע מלחמה	Hundraårskriget
מיטל אלטער	Medeltiden
מאנגאלישע אימפעריע	Mongolväldet
אטאמאנישע אימפעריע	Osmanska riket
פראטעסטאנטישע רעפארמאציע	Reformationen
וויקינג	Viking
נבוכדנאצר דער צווייטער	Nebukadnessar II
ברוטא אינלענדישער פראדוקט	Bruttonationalprodukt
קאליגראפיע	Kalligrafi
מאדע	Mode
דערנייבארע ענערגיע	Förnybara energikällor
עלעקטריע	Elektricitet
קערנדיקע קראפט	Kärnenergi
פאסיל-ברענשטאף	Fossila bränslen
אינטערנל קאמבאסטשען ענזשין	Förbränningsmotor
דאמפמאטאר	Ångmaskin
שווערד	Svärd
פייער-געווער	Eldvapen
מאשינביקס	Kulspruta
נוקלעארער וואפן	Kärnvapen
2029	2029
איבערישער האלבאינזל	Pyreneiska halvön
שיספולווער	Krut
פליסיגע אויפרייס	Sprängämne
טאנק	Stridsvagn
אנטווערפן	Antwerpen
דזשארדזש סאראס	George Soros
רעאלע צאל	Reella tal
לעאפאלד דער צווייטער פון בעלגיע	Leopold II av Belgien
לעאפאלד דער ערשטער פון בעלגיע	Leopold I av Belgien
לעאפאלד דער דריטער פון בעלגיע	Leopold III av Belgien
אלבערט דער ערשטער פון בעלגיע	Albert I av Belgien
באדעוויין פון בעלגיע	Baudouin av Belgien
מישעל אבאמא	Michelle Obama
ראזשינקע	Russin
קאקאס	Kokospalm
מילגרוים	Granatäpple
מאראנץ	Apelsin
רומאנטש	Rätoromanska
אייזקרעם	Glass
קוכן	Kaka
יאגארט	Yoghurt
הארווארד אוניווערסיטעט	Harvard University
על זשאזירא	Al-Jazira
סעבו (גובערניע)	Cebu
אנזשאלינא זשאולי	Angelina Jolie
אדריאטישער ים	Adriatiska havet
אראביש	Arabiska
דאנק טאג	Thanksgiving
Msnbc	MSNBC
האנשו	Honshu
בערנארד מעדאף	Bernard Madoff
ערווין ראמעל	Erwin Rommel
קאנדאם	Kondom
פאלמע	Palmer
טשימבאראזא	Chimborazo
דאלאר	Dollar
ביקיני	Bikini
ספארטזאל	Gym
קארסיקע	Korsika
פרעמיער מיניסטער	Premiärminister
דזשוסעפע פיאצי	Giuseppe Piazzi
ערשטער ניווא דאמען	Toppdomän
סאנטיאגא דע קאמפאסטעלא	Santiago de Compostela
וויטאריע	Vitoria-Gasteiz
סאנטא קרוז דע טענעריפע	Santa Cruz de Tenerife
בעטא	Beta
גאמא	Gamma
קאקטוס	Kaktusväxter
אפטיק	Optik
הערב	Heraldiskt vapen
פאן	Flagga
טיש	Bord
לענאווא	Lenovo
הייסע וואסער סיסטעם	Ackumulatortank
ברין	Brno
עסקאלאטאר	Rulltrappa
שטול	Stol
אינטערנאציאנאלע ארגאניזאציע פאר סטאנדארטיזאציע	Internationella standardiseringsorganisationen
ב	Bet
ג	Gimel
ד	Dalet
ה	He (bokstav)
זשיראף	Giraff
דרום טיראל	Sydtyrolen
ו	Vav
ז	Zayin
ח	Het
ט	Tet (bokstav)
וואנצעס	Mustasch
סאוועטן פארבאנד	Sovjetunionen
ראן פאול	Ron Paul
מוניציפאליטעט	Kommun
גוט	Godhet
שלעכטס	Ondska
אלקאהאליזם	Alkoholism
קאמערע	Kamera
טעלעוויזיע פראגראם	TV-program
פאראנא	Paraná (delstat)
C (פראגראם שפראך)	C (programspråk)
פוס	Fot
האנטקייטן	Handbojor
קווין	Queen
פרעדי מערקורי	Freddie Mercury
ברייען מעי	Brian May
ראדזשער טעילער	Roger Taylor
עמי וויינהאוס	Amy Winehouse
מאנטעסקיע	Charles-Louis de Secondat Montesquieu
פעניאראל	CA Peñarol
פערזענלעכער קאמפיוטער	Persondator
אקסל	Axel (kroppsdel)
שילדדריז	Sköldkörtel
פארטאל:רעקאמענדירטע ארטיקלען	Wikipedia:Utmärkta artiklar
מוסטער:רא	Mall:Link FA
וועלט	Världen
װיקיפּעדיע:קאווע שטיבל	Wikipedia:Bybrunnen
ריכטער	Domare
ווערמאנט	Vermont
סאן דיעגא	San Diego
דענווער	Denver
היוסטן	Houston
פיניקס	Phoenix
אסטין	Austin
מעמפיס	Memphis, Tennessee
קאלומבוס, אהייא	Columbus, Ohio
אמעריקאנישער סאמאא	Amerikanska Samoa
עדגאר אלאן פא	Edgar Allan Poe
לאס אנדזשעלעס, טשילע	Los Ángeles
שפיטאל	Sjukhus
מזרח דייטשלאנד	Östtyskland
קלויסטער	Kyrka
נארד-פא-דע-קאלע	Nord-Pas-de-Calais
אקלאנד, קאליפארניע	Oakland
גאוויאל	Gavial
איי	Ägg
מונטינלופא	Muntinlupa
אעראפלאנען שיף	Hangarfartyg
שניי-מאביל	Snöskoter
מאנאפאלי (שפיל)	Monopol (spel)
קרייז	Cirkel
פלאך	Plan (geometri)
זעלביקער-געשלעכט חתונה	Samkönat äktenskap
וויקיע	Wikia
קיינציקלאפעדיע	Psyklopedin
פלאמענגא	Clube de Regatas do Flamengo
צעלפאן	Mobiltelefoni
שטרויס	Struts
סטיווען האקינג	Stephen Hawking
אקסיאם	Axiom
טעאריע	Teori
סעקסואלער אריענטאציע	Sexuell läggning
סאקראמענטא	Sacramento
האנאלולו	Honolulu
קארעע	Korea
1925	1925
1927	1927
מאנטשעסטער	Manchester
אספירין	Acetylsalicylsyra
אינסטינקט	Instinkt
פראווידענס	Providence
ניו ענגלאנד	New England
אלי וויזעל	Elie Wiesel
ברוקלין	Brooklyn
קווינס	Queens
בראנקס	Bronx
סטעטן איילאנד	Staten Island
לאנג איילענד	Long Island
וואלף	Varg
מעטאפאר	Metafor
אלעגאריע	Allegori
מאפיא	Maffia
1955	1955
1954	1954
1953	1953
1951	1951
1950	1950
1946	1946
1943	1943
1942	1942
1940	1940
1939	1939
1938	1938
1937	1937
1936	1936
1935	1935
1934	1934
1933	1933
1932	1932
1931	1931
1930	1930
1929	1929
פיאנגיאנג	Pyongyang
נייער טעסטאמענט	Nya Testamentet
GPS	Global Positioning System
אסקאר	Oscar
2010ער	2010-talet
אייקאריאט	Eukaryoter
9 (נומער)	9 (tal)
י	Yod
כ	Kaf
סאן פעדרא דע לא פאז	San Pedro de la Paz
פאדאלסק	Podolsk
באנאבא	Bonobo
זוכמאשין	Söktjänst
פויבסט	Påve
אלקאלי מעטאל	Alkalimetall
ראפאעל קארעא	Rafael Correa
איבערגאנג מעטאל	Övergångsmetall
האלבמעטאלן	Halvmetall
נישט-מעטאל	Icke-metall
איידעלער גאז	Ädelgas
בוקארעשט	Bukarest
על גאר	Al Gore
סעווערן	Severn
פארטא-ריקאנישע אומאפהענגיקייט פארטיי	Puertoricanska självständighetspartiet
טעמז	Themsen
טיראנא	Tirana
1928	1928
מאנגראווע	Mangrove
קראצמעך	Jul
דרייעק	Triangel
עיבור יאר	Skottår
סטיוו זשאבס	Steve Jobs
ליידי גאגא	Lady Gaga
ברייניגערבערג	Breinigerberg
מואמאר קאדאפי	Muammar al-Gaddafi
בעקערלו ליניע	Bakerloo line
טיגער	Tiger
כואן קארלאס דער ערשטער	Juan Carlos I av Spanien
לאנדאנער אונטערגרונט	Londons tunnelbana
MAC אדרעס	MAC-adress
פאדקעסט	Poddradio
קעשענעוו	Chișinău
נאטירלעכע צאל	Naturliga tal
סאציאלאגיע	Sociologi
שלום (צייטונג)	Şalom
אדישא	Odisha
GNU פרייע דאקומענטאציע ליצענץ	GNU Free Documentation License
זשאן קערי	John Kerry
טייוואן אינזל	Taiwan (ö)
אנטיסעמיטיזם	Antisemitism
נאפט	Petroleum
פרידריך שילער	Friedrich Schiller
שיך	Sko
דאנאלד טראמפ	Donald Trump
באנק	Bank
מעץ	Metz
פרייהייט פון ווארט	Yttrandefrihet
טעאריע:סעפטעמבער 11	Konspirationsteorier om 11 september-attackerna
באפעלקערונג ענגקייט	Befolkningstäthet
Russia Today	RT (TV-kanal)
אירלאנד (אינזל)	Irland (ö)
װיקיפּעדיע:בלעטער צו אויסמעקן	Wikipedia:Sidor föreslagna för radering
בראדפארד	Bradford
טשעשיר	Cheshire
קאמבריע	Cumbria
לאנקאשיר	Lancashire
נארטהאמבערלאנד	Northumberland
טיין און וויר	Tyne and Wear
קאנטי דארהאם	Durham (grevskap)
מערב יארקשיר	West Yorkshire
צפון יארקשיר	North Yorkshire
מזרח ריידינג פון יארקשיר	East Riding of Yorkshire
לינקאנשיר	Lincolnshire
נאטינגהאמשיר	Nottinghamshire
דרום יארקשיר	South Yorkshire
דארבישיר	Derbyshire
גרויס-מאנטשעסטער	Greater Manchester
מערזיסייד	Merseyside
שראפשיר	Shropshire
סטאפארדשיר	Staffordshire
לעסטערשיר	Leicestershire
ראטלאנד	Rutland
נארפאלק	Norfolk
סאפאלק	Suffolk
קעמברידזשיר	Cambridgeshire
לו קסון	Lu Xun
נארטהאמפטאנשיר	Northamptonshire
הערעפארדשיר	Herefordshire
וואוסטערשיר	Worcestershire
וואריקשיר	Warwickshire
בעדפארדשיר	Bedfordshire
קארנוואל	Cornwall
בריסטאל	Bristol
דעוון	Devon, England
דארסעט	Dorset
גלאסטערשיר	Gloucestershire
אקספארדשיר	Oxfordshire
10	10
ווילטשיר	Wiltshire
האמפשיר	Hampshire
בארקשיר	Berkshire
באקינגהאמשיר	Buckinghamshire
20	20
אמטראק	Amtrak
עסעקס	Essex
סארי	Surrey
מערב סאסעקס	West Sussex
מזרח סאסעקס	East Sussex
30	30
קענט	Kent (grevskap)
גרויסלאנדאן	Storlondon
סיטי פון לאנדאן	City of London
9	9
7 (נומער)	7 (tal)
8 (נומער)	8 (tal)
זשאן אגוסט דאמיניק ענגרע	Jean-Auguste-Dominique Ingres
וואָך	Vecka
אייז	Is
אזערע	Insjö
קנאבל	Vitlök
אנטראפאלאגיע	Antropologi
ים סוף	Röda havet
אוגערקע	Gurka
אולאן באטאר	Ulan Bator
עדינבורג	Edinburgh
אשגאבאט	Asjchabad
אקטאוו מירבא	Octave Mirbeau
אינזל	Ö (landområde)
ווייס	Vit
שווארץ	Svart
מארסיי	Marseille
ציבל	Lök (art)
6 (נומער)	6 (tal)
ארכעאלאגיע	Arkeologi
טאמאטע	Tomat
דזשארזש ה. וו. בוש	George H.W. Bush
ריקי דזשארוועיס	Ricky Gervais
באלקאן לענדער	Balkanhalvön
סלאווישע שפראכן	Slaviska språk
עקוואטאר	Ekvator
סעלענא	Selena Quintanilla
מערידא, ווענעזועלע	Mérida, Venezuela
אטלאנטא	Atlanta
בעניטא מוסאליני	Benito Mussolini
לאסט (טעלעוויזיע סעריע)	Lost
17	17
ווערטערבוך	Ordbok
קאפ	Huvud
װעלינגטאן	Wellington
גרויסבריטאניע	Storbritannien (ö)
23	23
זשימי קארטער	Jimmy Carter
נאציאנאלער הימען	Nationalsång
סיינפעלד (סעריע)	Seinfeld
לאס וועגאס	Las Vegas
26	26
פאלעסטינע	Palestina
10 (נומער)	10 (tal)
אטאם נומער	Atomnummer
אלפרעד נאבעל	Alfred Nobel
24	24
29	29
לילך דאונס	Lila Downs
ים המלח	Döda havet
25	25
31	31
28	28
ליווערפול	Liverpool
אלבאני	Albany, New York
אוואטאר (פילם)	Avatar (film)
ווערב	Verb
770	770
וואדי עלען	Woody Allen
טיטאניק	RMS Titanic
ראמשטיין	Rammstein
סאווע	Ugglor
פונט שטערלינג	Brittiskt pund
בענעטיץ	Benetice (Světlá nad Sázavou)
ווערטייברעיטס	Ryggradsdjur
מעטעאראלאגיע	Meteorologi
אזארן	Azorerna
פעלידאע	Kattdjur
אינטערנאציאנאלע קאסמאס סטאנציע	Internationella rymdstationen
היספאניאלא	Hispaniola
דא נאנג	Da Nang
פעטרישקע	Persilja
אופסאלא	Uppsala
געטעבארג	Göteborg
וואג	Tyngd
קארניש	Korniska
טייטלבוים	Dadelpalm
האמער	Hammare (handverktyg)
ראטיבאר	Racibórz
פליג	Tvåvingar
בליענדיקע פלאנצן	Gömfröväxter
ארקטיק	Arktis
מאלוסקן	Blötdjur
Gaudi Antoni	Antoni Gaudí
מאכט	Effekt
טענענבוים	Ädelgranssläktet
דראמא	Dramatik
ליבעלעס	Trollsländor
פארשטעלונג	Teaterpjäs
בורשטין	Bärnsten
נוארק	Newark, New Jersey
וועסטעראס	Västerås
לינשעפינג	Linköping
וואלטאזש	Elektrisk spänning
זאפראן	Saffran
סארביש	Sorbiska
מעלנליקע	Mölnlycke
ליכט-ארויסגעבנדיקער דיאד	Lysdiod
נארשעפינג	Norrköping
ערעברו	Örebro
פראטאקאלן פון זקני-ציון	Sions vises protokoll
נאציאנאלע באן	National Rail
אוגרע	Europeisk ål
פאפראד	Poprad
נייטרא	Nitra
צאבעל	Sobel
רש"י	Rashi
סאטעליט	Satellit
כריין	Pepparrot
זאכלא	Zahle
אילטיס	Iller
מארק ענטאני	Marc Anthony
פאלעסטין באפרייונג ארגאניזאציע	Palestinska befrielseorganisationen
נעגעלע	Kryddnejlika
אטעלא	Othello
טעילאר סוויפט	Taylor Swift
לאנדאנער בארא פון קרוידן	London Borough of Croydon
פראפיט	Vinst
מזרח אזיע	Östasien
צפון אפריקע	Nordafrika
צענטראל-אפריקע	Centralafrika
דרום אייראפע	Sydeuropa
מזרח אייראפע	Östeuropa
מערב אייראפע	Västeuropa
צענטראל אייראפע	Centraleuropa
צענטראל-אמעריקע	Centralamerika
האטעל	Hotell
מזרח פריזישע אינזלען	Ostfrisiska öarna
נירנבערג געזעצן	Nürnberglagarna
אדאלף אייכמאן	Adolf Eichmann
צימערינג	Kanel
קאנקארד, ניו העמפשער	Concord, New Hampshire
סעלערי	Selleri
אספארגוס	Sparris
סצענאר שרייבער	Manusförfattare
גראד	Grad (vinkelenhet)
האר	Hår
עסטרייך אונגארישע אימפעריע	Österrike-Ungern
ספרינגפילד, אילינוי	Springfield, Illinois
דזשיקאוו	Tarnobrzeg
אראמיש	Arameiska
פאך	Yrke
שניטקע	Sandwich
איסלאמישער קאלענדאר	Muslimska kalendern
טענעריפע אוידיטאריע	Auditorio de Tenerife
סאשא בארון כהן	Sacha Baron Cohen
פוס מיליטער	Infanteri
F-35 לייטנינג II	Lockheed Martin F-35
מאנטגאמערי	Montgomery, Alabama
באקא ראטאן	Boca Raton, Florida
יצחק מרדכי	Yitzhak Mordechai
רעפובליקאנער פארטיי	Republikanska partiet
באק פולווער	Bakpulver
לאקימיע	Leukemi
אפגאט	Hedendom
דעמאקראטישע פארטיי	Demokratiska partiet
בעאטריקס פון די נידערלאנדן	Beatrix av Nederländerna
Wi-Fi	Wi-Fi
לופטל	Maskrossläktet
בירגערמייסטער	Borgmästare
שניי לעמפערט	Snöleopard
שטייגעררעכט	Common law
שלעזיש	Schlesiska
פרעזידענט	President
בלאג	Blogg
אחז	Achas
דזשיימסטאן, סאנט העלענע	Jamestown, Sankta Helena
וואלטער קראנקייט	Walter Cronkite
קאלקולאטאר	Miniräknare
געשוויסטער	Syskon
העלט קעיר	Sjukvård
פאפוגיי	Papegojfåglar
קראקע	Kraków
קאני 2012	Kony 2012
אנארכיע	Anarki
אראבישער האלבאינדזל	Arabiska halvön
צוגאב	Addition
לעבנסשטייגער	Livsstil
מערידיאן	Meridian
באקס	Boxning
דאמעלי	Dameli
שאלקע 04	FC Schalke 04
לאנדאנער בארא פון מערטאן	London Borough of Merton
קעניגלעכע בארא פון קינגסטאן אויפן טעמז	Royal Borough of Kingston upon Thames
לאנדאנער בארא פון ריטשמאנד אויפן טעמז	London Borough of Richmond upon Thames
דזשעניפער עניסטאן	Jennifer Aniston
לוזשיץ	Lausitz
אייקאן	Akon
וואלערי לעאנטיעוו	Valerij Leontiev
ISBN	ISBN
זיבן יעריגער קריג	Sjuårskriget
אויסטרא-אזיאטישע שפראכן	Austroasiatiska språk
טאסמאן ים	Tasmanhavet
שווארצע טומאה	Bila Tserkva
אקצענט	Dialekt
לייב טראצקי	Lev Trotskij
ליטל ראק	Little Rock
פאטענץ	Potens
קארדעמאן	Kardemumma
מוזיי	Museum
אלף בית	Hebreiska alfabetet
דאווער, דעלאווער	Dover, Delaware
לודמיר	Volodymyr-Volynskyj
קישא	Kesha
קאנאדא	Kannada
קאשוביש	Kasjubiska
האנט	Hand
דו פו	Du Fu
עדמונד הילארי	Edmund Hillary
נעפאליש	Nepali
באפעלקערונג	Befolkning
ארכיפעלאג	Ögrupp
טעאדער רוזעוועלט	Theodore Roosevelt
טור דע פראנס	Tour de France
ענטעבע אפעראציע	Operation Entebbe
תל אביב-יפו	Tel Aviv
טשעכאסלאוואקיי	Tjeckoslovakien
ניס	Nice
בלאט	Blad
וואלפאראיסא	Valparaíso
אקטיאר	Skådespelare
האליוואד	Hollywood
מארלאן בראנדא	Marlon Brando
גארטל ליניע (געאגראפיע)	Latitud
סעמיטישע שפראכן	Semitiska språk
טאגאלאג	Tagalog
יצחק רבין	Yitzhak Rabin
אשכנזים	Ashkenazer
זשאסטין ביבער	Justin Bieber
בראנדז	Brons
כאסני מובאראק	Hosni Mubarak
פארגא	Fargo, North Dakota
וואכאקא	Oaxaca
פוטער	Smör
טעאלאגיע	Teologi
זעאוס	Zeus
יאסיר אראפאט	Yassir Arafat
מוסד (אגענטור)	Mossad
אקספארד	Oxford
ניאגארא פאלס	Niagarafallen
שטום לשון	Teckenspråk
לינוס טארוואלדס	Linus Torvalds
לאנגווייליגקייט	Tristess
BSD	Berkeley Software Distribution
רוסלענדישע אימפעריע	Kejsardömet Ryssland
אלעקסאנדער גרעהעם בעל	Alexander Graham Bell
וואודרא ווילסאן	Woodrow Wilson
דאקטאר הו	Doctor Who
אסטראלאגיע	Astrologi
טאסמאניע	Tasmanien
ראטערדאם	Rotterdam
שוואן	Svanar
גלויבן	Tro (kognition)
זייף	Tvål
ניו ארלינס	New Orleans
מאשאווצע	Mošovce
בענאזיר בוטא	Benazir Bhutto
שאקירא	Shakira
אוניווערסיטעט פון אקספארד	Oxfords universitet
טראקט	Väg
מאכמוד אכמעדיניזשאד	Mahmoud Ahmadinejad
סידי	CD
היראהיטא	Hirohito
העליקאפטער	Helikopter
אל קיידא	Al-Qaida
ווידעא	Video
אגאישער ים	Egeiska havet
געבורט	Förlossning
אנאסטאסיע	Anastacia
פרת	Eufrat
זשיימס גארפילד	James Garfield
קיאטא	Kyoto
עשרת הדיברות	De tio budorden
שול	Synagoga
ענגלישער קאנאל	Engelska kanalen
1980ער	1980-talet
יאהאנעסבורג	Johannesburg
1990ער	1990-talet
י. ק. ראלינג	J.K. Rowling
פערסישער איינגאס	Persiska viken
רויז	Rossläktet
אדיעקטיוו	Adjektiv
זאלצבורג	Salzburg
גריכישע מיטאלאגיע	Grekisk mytologi
קאמפאס	Kompass
מין (ביאלאגיע)	Släkte
סאציאל וויסנשאפט	Samhällsvetenskap
האלבאינזל	Halvö
רענטגען שטראלן	Röntgenstrålning
יוליסעס סימפסאן גרענט	Ulysses S. Grant
עליזעבעט טעילער	Elizabeth Taylor
פראווינץ	Provins
בריזבן	Brisbane
וויטאמין	Vitamin
בענדזשאמין פרענקלין	Benjamin Franklin
אייזיק אזימאוו	Isaac Asimov
תורה	Torah
ים פון אזאוו	Azovska sjön
1970ער	1970-talet
2000ער	2000-talet (decennium)
וויליאם מעקינלי	William McKinley
ליסטע פון פרעזידענטן פון די פאראייניגטע שטאטן	Lista över USA:s presidenter
רשימה:הויפטשטעט	Lista över huvudstäder
סלאגאן	Ordspråk
וועבזייטל	Webbplats
אדיסעע	Odysséen
סטיווען גראווער קליוולאנד	Grover Cleveland
שפיגל	Spegel
הערבערט קלארק האווער	Herbert Hoover
מעטאפיזיק	Metafysik
ווארען הארדינג	Warren G. Harding
אראבער	Araber
ברעד פיט	Brad Pitt
שומער	Sumer
ים פון מארמארא	Marmarasjön
פאנעטיק	Fonetik
פאמיליע (ביאלאגיע)	Familj (biologi)
זשערוסאלעם פאסט	The Jerusalem Post
פענסטער	Fönster
אלמאטיע	Almaty
טשעסטער עלען ארטור	Chester A. Arthur
הייל	Grotta
לאס	Älg
ווייסע הויז	Vita huset
פאליציי	Polis
האקיידא	Hokkaido
חידקל	Tigris
ארטור קאנאן דויל	Arthur Conan Doyle
אינגבער	Ingefära
וויליאם האווארד טעפט	William Howard Taft
גלעטשער	Glaciär
פיטקארן	Pitcairnöarna
בענזשעמין העריסאן	Benjamin Harrison
ראטערפארד בי הייז	Rutherford B. Hayes
1930ער	1930-talet
1960ער	1960-talet
1920ער	1920-talet
פארלאמענט	Parlament
מאטריאל	Materia
סאפארי	Safari (webbläsare)
על בייַדאַ	Al-Bayda, Libyen
ברוך שפינאזא	Baruch Spinoza
נאס	Nysning
שלאף	Sömn
אינפלאציע	Inflation
הומאר	Humor
E=mc²	E = mc²
אראל ים	Aralsjön
קארינטיאנס	Sport Club Corinthians Paulista
עסטעטיק	Estetik
מייבאק	Maybach
מאזדא	Mazda
איזמיר	Izmir
זשאן קעלווין קולידזש	Calvin Coolidge
לעמבערג	Lviv
ווערבע	Videsläktet
דורכגאס פון גיבראלטאר	Gibraltar sund
באדן	Jord
פייג	Fikon
סכום (מאטעמאטיק)	Mängd
שרייבער	Skribent
לאדינא	Ladino
סענדיי ערדציטערניש	Jordbävningen vid Tohoku 2011
פּארטא מאנט	Puerto Montt
פראנאם	Pronomen
וואצלאוו האוועל	Václav Havel
וואקאל	Vokal
לענג	Längd
בריזשיט בארדא	Brigitte Bardot
ביאגראפיע	Biografi
זיידן גאס	Sidenvägen
1950ער	1950-talet
חלום	Dröm
לאזשבאן	Lojban
אבערדין	Aberdeen
מעל	Mjöl
קאניונקציע	Konjunktion (ordklass)
אויוון	Ugn
1940ער	1940-talet
1900ער	1900-talet (decennium)
1910ער	1910-talet
דען האג	Haag
טיכא בראהע	Tycho Brahe
זנות	Prostitution
וויזועלע קונסטן	Bildkonst
הענריק איבסן	Henrik Ibsen
זומער זייגער	Sommartid
מערב ברעג	Västbanken
יוגאסלאוויע	Jugoslavien
קריסטאל נאכט	Kristallnatten
קאמפאזיטאר	Kompositör
ריהאנא	Rihanna
חזיר גריפע	Svininfluensa
נאגל (אנאטאמיע)	Nagel
12 (נומער)	12 (tal)
וואלאפוק	Volapük
צרפתיש	Zarfatiska
טאשירא מיפונע	Toshiro Mifune
געזיכט	Ansikte
רעקלאמע	Reklam
טאלאהאסי	Tallahassee
פאפ מוזיק	Popmusik
נאגל (בויען)	Spik
טאם קרוז	Tom Cruise
איילבירט	Olivträd
שלמה המלך	Salomo
יאהו	Yahoo!
30סטן פעברואר	30 februari
שטריך	Rät linje
פרעה	Farao
AK-47	AK-47
מאריופאל	Mariupol
11 (נומער)	11 (tal)
13 (נומער)	13 (tal)
גרופע 8	G8
אטאמקערן	Atomkärna
אוואקאדא	Avokado
איי.בי.עם.	IBM
דייוויד היום	David Hume
כוואליע	Vågrörelse
פיאדאר טיוטשעוו	Fjodor Tiuttjev
דיאמעטער	Diameter
לערער	Lärare
CIA	Central Intelligence Agency
שרייבן	Skrivkonst
קליוולאנד	Cleveland
לובלין	Lublin
דזשאן מייקל טאלבאט	John Michael Talbot
קלאוס עבנער	Klaus Ebner
סטאשקע	Jordnöt
100 (נומער)	100 (tal)
אפריקאס	Aprikos
זיכערהייטס ראט	FN:s säkerhetsråd
יאנישער ים	Joniska havet
ברילן	Glasögon
פילעק	Polygon
וואלענטינע טאג	Alla hjärtans dag
דוד בן גוריון	David Ben-Gurion
סכעלדע	Schelde
מארק	Marknad (ekonomi)
דעמאגראפיע	Demografi
כראמאזאם	Kromosom
געשמעלץ	Legering
בעזאנסאן	Besançon
אהקלענד גראמאטישע שולע	Auckland Grammar School
פרידזשידער	Kylskåp
מילוואקי	Milwaukee
דורכגאס	Sund
זיסע קארטאפל	Sötpotatis
קאנסאנאנט	Konsonant
מאקדאנעלדס	McDonald’s
לואיס קאראל	Lewis Carroll
ליאנארדא דיקאפריא	Leonardo DiCaprio
פעלקער-ליגע	Nationernas förbund
סאמוריי	Samuraj
בריטישע אינזלען	Brittiska öarna
יאקאהאמע	Yokohama
1840ער	1840-talet
הענרי דער אכטער פון ענגלאנד	Henrik VIII av England
קאלאמביע, דרום קאראליינע	Columbia, South Carolina
מיליאן	Miljon
סאו פאולא פוטבאל גרופע	São Paulo Futebol Clube
14 (נומער)	14 (tal)
ארבוז	Vattenmelon
1880ער	1880-talet
בוכטע פון בענגאל	Bengaliska viken
15 (נומער)	15 (tal)
18 (נומער)	18 (tal)
ריכטער סקאלע	Richterskalan
אוניווערסיטעט פון ביא-ביא	Universidad del Bío-Bío
כאמאס	Hamas
רוחאלא כומעיני	Ruhollah Khomeini
לאזער	Laser
פרייסן	Preussen
קאוונט גארדן אונטערגרונט סטאנציע	Covent Garden (tunnelbanestation)
רוימישע צאל	Romerska talsystemet
נייעס	Nyhet
בירגערמייסטער פון לאנדאן	Londons borgmästare
פיבער	Feber
1890ער	1890-talet
מענטשליכע אנטוויקלונג אינדעקס	Human Development Index
לידז	Leeds
אפענער קאד	Öppen källkod
בעהמען	Böhmen
מויז	Möss
אראנזש	Orange
סאטשי	Sotji
רונאלדיניו	Ronaldinho
זיבנבערגן	Transsylvanien
1830ער	1830-talet
סעמי טריילער	Traktor
אררט, ארמעניע	Ararat (stad)
גאמאל אבדול נאסער	Gamal Abdel Nasser
בלו טוט	Bluetooth
ווערקצייג	Verktyg
דרוק	Tryck
בענזין	Bensin
בוכטע	Havsvik
צווינטער	Begravningsplats
דאקטער (מעדיצין)	Läkare
עיאפיאטלאיעקול	Eyjafjallajökull
קדימה	Kadima
באלטישע לענדער	Baltikum
עזה פאס	Gazaremsan
זשעק ניקאלסאהן	Jack Nicholson
אינסולין	Insulin
מארקעטינג	Marknadsföring
טאל	Dal
צענזוס	Folkräkning
איבן ראשד	Averroës
Radio Studio 54 Network	Radio Studio 54 Network
1860ער	1860-talet
1870ער	1870-talet
19 (נומער)	19 (tal)
הויזן	Byxor
יארצענדלינג	Decennium
מאנדל	Mandel
פיער-אגוסט רענואר	Pierre-Auguste Renoir
קאנסעפסיאן פראווינץ	Provincia de Concepción, Chile
צער בעלי חיים	Djurplågeri
קאמפיוטער פראגראם	Datorprogram
ירדן טייך	Jordan
פלאזשע	Strand
17 (נומער)	17 (tal)
קאסמאסשיף	Rymdfarkost
וואלן	Val
מאנאוס	Manaus
מאראטאן	Maraton
16 (נומער)	16 (tal)
צעל יאדער	Cellkärna
טאפלונג	Multiplikation
צוואנציק	20 (tal)
אדוואקאט	Advokat
טורמע	Anstalt (kriminalvård)
געוועב (ביאלאגיע)	Vävnad
באפאלא	Buffalo, New York
AP	Associated Press
לאנדאנער בארא פון האמערסמיט און פולהאם	London Borough of Hammersmith and Fulham
רבקה	Rebecka, Isaks hustru
לוט	Lot
לאנדאנער בארא פון וואלטם פארעסט	London Borough of Waltham Forest
פאסיל	Fossil
טאקלאבאן	Tacloban City
Myspace	Myspace
זשיטאמירער גובערניע	Zjytomyr oblast
זשענאפער לאפעז	Jennifer Lopez
די הונדערט ביכער פונעם יארהונדערט פון לע מאנד	Århundradets 100 böcker enligt Le Monde
אראפנעם	Subtraktion
כירורגיע	Kirurgi
קאמעדיע	Komedi
טענעריפע	Teneriffa
דניעפער	Dnepr
ווערנער הייזנבערג	Werner Heisenberg
אורין	Urin
1850ער	1850-talet
וואלראס	Valross
כעזבאלא	Hizbollah
שטערן (קאפ)	Panna (anatomi)
תהילים	Psaltaren
אווענידא פאוליסטא	Avenida Paulista
אשור	Assyrien
ארבעטסלאזיקײט	Arbetslöshet
מעכאניק	Mekanik
באריס פאסטערנאק	Boris Pasternak
בידגאש	Bydgoszcz
קינא	Biograf
נאטינגהאם	Nottingham
זשורנאל	Tidskrift
קוואדראטישע גלייכונג	Andragradsekvation
הארן מעלאנע	Kiwano
אמעריקאנער פוסבאל	Amerikansk fotboll
גרייפפרוכט	Grapefrukt
עסיג	Ättika
דוד המלך	Kung David
פעלקער מארד	Folkmord
טעלעטאביס	Teletubbies
זופ	Soppa
איינגאס פון גינע	Guineabukten
אייז האקי	Ishockey
קורדיסטאן	Kurdistan
מערידן	Hemorrojder
פאלמעסונג	Obduktion
געריכט	Domstol
ספר ויקרא	Tredje Moseboken
אוראלטע היסטאריע	Antiken
ווארצל	Rot
קראכמל	Stärkelse
ארגאניזאציע פאר עקאנאמישע קאאפעראציע און אנטוויקלונג	OECD
זשוליא גילארד	Julia Gillard
דייוויד דשזאנסטאן	David Johnston
האמלעט	Hamlet
דויד הילבערט	David Hilbert
שירעם	Paraply
חיפה	Haifa
ווארשע פאקט	Warszawapakten
ראמאדאן	Ramadan
דעמיליטאריזירטע זאנע	Demilitariserad zon
עטנישע גרופע	Etnicitet
אירישער ים	Irländska sjön
יאזעף געבעלס	Joseph Goebbels
זאץ	Mening (språk)
גראם (מאס)	Gram
באר שבע	Be'er Sheva
טאלקאוואנא	Talcahuano
אויבערשאפט	Suveränitet
אנוואר סאדאט	Anwar Sadat
בירגערשאפט	Medborgarskap
תחת	Stjärt
וויצע פרעזידענט	Vicepresident
מעכאנישע ארבעט	Fysikaliskt arbete
פארשונג	Forskning
URL	Uniform Resource Locator
אבזערוואציע פונעם טאל	Mirante do Vale
גוגל ערד	Google Earth
פארענהייט	Grad Fahrenheit
כארקעוו	Charkiv
סעבאסטיאן פעטל	Sebastian Vettel
40 (נומער)	40 (tal)
וואל	Ull
PDF	Portable Document Format
קאנוס	Kon
USB	Universal Serial Bus
קאקאא בוים	Kakao
ציוניזם	Sionism
ווייסע בלוט צעל	Vit blodkropp
טאליבאן	Taliban
שעפילד	Sheffield
יארק	York
קעטי פערי	Katy Perry
עלנבויגן	Armbågsled
MP3	MP3
ספר דברים	Femte Moseboken
בארד	Skägg
30 (נומער)	30 (tal)
קלינישע דעפרעסיע	Depression
דאטן	Data (representation)
נביא	Profet
פארמיטל	Fordon
מוטאציע	Mutation
טרויאנישער קריג	Trojanska kriget
בוימל	Olja
ארכיטעקט	Arkitekt
איוואן פאוולאוו	Ivan Pavlov
טאפאלאגיע	Topologi
גאלדע מאיר	Golda Meir
ארקעסטער	Orkester
טאטואירונג	Tatuering
פינאנץ	Finans
1000 (נומער)	1000 (tal)
SMS	Short Message Service
דזשארדזש בוש	George Bush
ניוראן	Nervcell
טרוקעניש	Torka
היינריך הימלער	Heinrich Himmler
שווארצער פעפער	Pepparplanta
ספר במדבר	Fjärde Moseboken
רעפערענדום	Folkomröstning
אייקידא	Aikido
הילף:מערסטע געפרעגטע פראגעס	Wikipedia:Vanliga frågor
סארא פעלין	Sarah Palin
גאַניידן הייל	Thien Duong
פארזיכערונג	Försäkring
לאסט אויטא	Lastbil
דעלטע	Floddelta
בייסעקסואלוטעט	Bisexualitet
בורגנלאנד	Burgenland
ארגאניזאציע	Organisation
גראז	Gräs
געשטאפא	Gestapo
פאלינאם	Polynom
מעהרן	Mähren
קאגניטיווער נעץ	Neuronnät
תלמוד	Talmud
סולטאן	Sultan
מיכאיל סאקשווילי	Micheil Saakasjvili
סי בי עס	CBS
טשאנדיגאר	Chandigarh
פערל	Pärla
נקיבה	Hona
פילזען	Plzeň
ארעם	Arm
אנגקאר וואט	Angkor Wat
דארבי	Derby, Storbritannien
נאטירלעכע סעלעקציע	Naturligt urval
זאא-גארטן	Djurpark
אקעאנאגראפיע	Oceanografi
קריסטאל	Kristall
מאקאס	Mac OS
ליידן	Leiden
מאנאפאל	Monopol
קיווי	Kivier
אפאלא 11	Apollo 11
שטרימפ	Strumpor
בנימין נתניהו	Benjamin Netanyahu
אאזיס	Oas
ברעם	Ögonbryn
פופיק	Navel
פאס	Pass
סוחר	Affärsman
יעקב בן זבדי	Jakob (apostel)
בנימין זאב הערצל	Theodor Herzl
לא פלאטא	La Plata
דן שעכטמאן	Dan Shechtman
פלוים	Plommon
דינער (קאמפיוטער)	Server
זכר	Hane
מאטאר	Motor
קארדאבע, ארגענטינע	Córdoba, Argentina
ליקוי לבנה	Månförmörkelse
פארד מאטאר	Ford Motor Company
דזשים מאריסאן	Jim Morrison
סאלמאן ראשדי	Salman Rushdie
באשער על אסאד	Bashar al-Assad
לעגענדע	Legend
דריווש דער ערשטער	Dareios I
כעמישער בונד	Kemisk bindning
היץ	Värme
קטניות	Ärtväxter
שפיל טעאריע	Spelteori
ריטשארד דאקינס	Richard Dawkins
עפידעמיע	Epidemi
וועקטאר	Vektor
GNU	GNU
טיטאניק (פילם)	Titanic (film)
קאניבאליזם	Kannibalism
שרעק	Rädsla
אורי געלער	Uri Geller
עס עס	Schutzstaffel
די סטאר ספענגלד בענער	The Star-Spangled Banner
יידישער לוח	Judiska kalendern
בערינג ים	Berings hav
אומזיכערקייט פרינציפ	Osäkerhetsprincipen
פארט	Hamn
סודאקו	Sudoku
פונקט (געאמעטריע)	Punkt (geometri)
אקספארד ענגליש ווערטערבוך	Oxford English Dictionary
מאטראס	Sjöman
מאריס הירש	Maurice de Hirsch
עלבע	Elba
מזרח כינע ים	Östkinesiska havet
The Doors	The Doors
איבערקערעניש	Statskupp
הייוון	Jäst
RSS	RSS
האקנקרייץ	Svastika
אמעריקאנער פרעזידענט וואלן 2008	Presidentvalet i USA 2008
מיסט	Avfall
פעטש	Pécs
אקוואריום	Akvarium
דונקערק	Dunkerque
בארענטס ים	Barents hav
א ליד פון אייז און פייער	Sagan om is och eld
מוכאמאד כוסיין טאנטאווי	Mohamed Hussein Tantawi
פייל	Pil (vapen)
מיסטיק	Mystik
פעליקס מענדלסאן	Felix Mendelssohn
קינעטישע ענערגיע	Kinetisk energi
טראפעז	Parallelltrapets
שרייבמאשין	Skrivmaskin
מיקראפאן	Mikrofon
שאץ	Suceava
פוליצער פרייז	Pulitzerpriset
פידזשי הינדי	Fijiansk hindi
דארפור	Darfur
ראאול קאסטרא	Raúl Castro
ישראל מוזיי	Israel Museum
בארג קייט	Bergskedja
יאס	Iași
לופטליניע	Flygföretag
באק	Kind
רוביקס קוב	Rubiks kub
ברוין	Brun
פארגעוואלדיגונג	Våldtäkt
ענריקע איגלעסיאס	Enrique Iglesias
קו קלוקס קלען	Ku Klux Klan
שעטלאנד	Shetlandsöarna
ווארען באפעט	Warren Buffett
קאנדאליזא רייס	Condoleezza Rice
געבורטס טאג	Födelsedag
ווארעם	Maskar
ייחוס	Genealogi
מילטאן פרידמאן	Milton Friedman
עזה	Gaza
קאמפיילער	Kompilator
נארוועגישער ים	Norska havet
אייזבארג	Isberg
MS-DOS	MS-DOS
אמעריגא וועספוטשי	Amerigo Vespucci
ספר יהושע	Josua (bok)
דער גאדפאטער	Gudfadern (film)
מענטא	Myntasläktet
פאריס הילטאן	Paris Hilton
מאריא מאנטי	Mario Monti
הערמאן גערינג	Hermann Göring
לונגען קענסער	Lungcancer
צירקוס	Cirkus
אידענטיטעט קארטע	Legitimationshandling
מוסטער:Commonscat	Mall:Commonscat
טוירק	Vridmoment
סטעם צעל	Stamcell
אויגן לאד	Ögonlock
23 (נומער)	23 (tal)
מיין קאמף	Mein Kampf
דניפראפעטראווסק	Dnipropetrovsk
דיק טשעיני	Dick Cheney
מין (אידענטיטעט)	Socialt kön
סטודענט	Student
תפילין	Tefillin
פאראבעל	Parabel (kurva)
שופר	Shofar
מוסר	Moral
CNN	CNN
אימפעריע	Imperium
כראמיום	Chromium
מלכות יהודה	Juda rike
באבי יאר	Babij Jar
קאסמאס שאטל	Space Shuttle
ליינוס פאלינג	Linus Pauling
פרימצאל	Primtal
ניי מאשין	Symaskin
גבי אשכנזי	Gabi Ashkenazi
הערמאן וואק	Herman Wouk
זעקסטאגיקע מלחמה	Sexdagarskriget
קריסטאפער היטשענס	Christopher Hitchens
קורצע דערציילונג	Novell
שמעון וויזנטאל	Simon Wiesenthal
קאלומביע אוניווערסיטעט	Columbia University
אומאפהענגיקייט מלחמה	1948 års arabisk-israeliska krig
יום כיפור מלחמה	Oktoberkriget
סיני מלחמה	Suezkrisen
צווייטע לבנונישע מלחמה	Libanonkriget 2006
על אקצא אינטיפאדע	Al-Aqsa-intifadan
מאסאטשוסעטס אינסטיטוט פון טעכנאלאגיע	Massachusetts Institute of Technology
קעמברידזש, מאסאטשוסעטס	Cambridge, Massachusetts
וועסט הארטפארד	West Hartford
אמהערסט, מאסאטשוסעטס	Amherst, Massachusetts
דען קוועיל	Dan Quayle
רינא	Reno
אנאהיים, קאליפארניע	Anaheim
טוריזם	Turism
מאסן פארניכטונג וואפן	Massförstörelsevapen
די אינטערנאציאנאלע זינגליד	Internationalen (sång)
דיכטער	Poet
חתונה	Bröllop
פאסט	Post
וואסאבי	Wasabi
אנקעטע	Opinionsundersökning
איטאליענער	Italienare
Visual Basic .NET	Visual Basic .NET
פרעפעקטורן פון יאפאן	Japans prefekturer
היסטאריע פון קונסט	Konstens historia
צוזאמענגעזעצטע צאל	Sammansatt tal
פראנץ יאזעף	Frans Josef I av Österrike
שטאלץ פאראד	Prideparad
ראמאן פאלאנסקי	Roman Polański
פּונטא ארענאס	Punta Arenas
סיבילאנט	Sibilant
אנאטאליע	Anatolien
שבטי ישראל	Israeliter
שיר השירים	Höga Visan
הורדוס	Herodes den store
ספר מלאכי	Malaki
אהרן הכהן	Aron
גוגל שמועס	Google Talk
צושימע אינדזל	Tsushima (Nagasaki)
קלימאטאלאגיע	Klimatologi
קאלאמיי	Kolomyia
קאליש	Kalisz
אייראפעישע עקאנאמישע געמיינדע	Europeiska ekonomiska gemenskapen
ליסא	Leszno
שמועס	Samtal
רעדן	Tal (språk)
פעדעראלע רעזערוו	Federal Reserve System
זשאבע	Stjärtlösa groddjur
עמוד ענן אפעראציע	Operation Pillar of Defense
רופערט מורדאק	Rupert Murdoch
בערגל	Ås
וועסטשעסטער קאונטי	Westchester County
קאַטעגאָריע:מאנארכן	Kategori:Monarker
קאַטעגאָריע:רעגירונג מעטאדן	Kategori:Statsskick
קאַטעגאָריע:רעגירונג	Kategori:Myndigheter
קאַטעגאָריע:ליבע	Kategori:Kärlek
קאַטעגאָריע:וואיעוואדעשאפטן פון פוילן	Kategori:Polens vojvodskap
קליינפוילישע וואיעוואדעשאפט	Lillpolens vojvodskap
מאזאוויער וואיעוואדעשאפט	Masoviens vojvodskap
אונטערקארפאטישע וואיעוואדעשאפט	Nedre Karpaternas vojvodskap
גרויספוילישע וואיעוואדעשאפט	Storpolens vojvodskap
ווארט פראצעסאר	Ordbehandlare
קאַטעגאָריע:פילמען	Kategori:Filmer
וואקזאל	Järnvägsstation
מוסטער:היסטאריע פון לענדער אין אייראפע	Mall:Historia i Europa
װיקיפּעדיע:וויקיפעדיע אין די מעדיע	Wikipedia:Wikipedia i media
Active Directory	Active Directory
בראנפן	Spritdryck
טיש קאמפיוטער	Skrivbordsdator
זשארזש ביזע	Georges Bizet
בליצקריג	Blixtkrig
שוויצבאד	Bastu
דניאל פארענהייט	Daniel Gabriel Fahrenheit
אלפרעד יאדל	Alfred Jodl
אבדאללא, קעניג פון סאודי	Abdullah bin Abdul Aziz
דזשאלאל טאלאבאני	Jalal Talabani
אסיף אלי זארדארי	Asif Ali Zardari
נוייען מין טריעט	Nguyen Minh Triet
טרואנג טאן סאנג	Truong Tan Sang
שמעון פרס	Shimon Peres
וואצלאוו קלאוס	Václav Klaus
אבדאללא דער צווייטער	Abdullah II av Jordanien
איסלאם קארימאװ	Islam Karimov
EBay	Ebay
אביגדור ליבערמאן	Avigdor Lieberman
סקול באס	Skolbuss
טראנס-סיבירישע באן	Transsibiriska järnvägen
סיסטעם	System
צה"ל	Israels försvarsmakt
168 (נומער)	168 (tal)
אסקאר שינדלער	Oskar Schindler
ריינהארד היידריך	Reinhard Heydrich
אריאל שרון	Ariel Sharon
זינד	Synd
קאפעין	Koffein
אשקלון	Ashkelon
וואסילי קאנדינסקי	Vasilij Kandinskij
קארל דער דריטער ווילהעלם	Karl III Wilhelm av Baden-Durlach
רייזע	Resa
טורעם פון לאנדאן	Towern
יתרו	Jetro
אבסערוואטאריע	Observatorium
מערי מעגדעלין	Maria från Magdala
מארקס די ברידער	Bröderna Marx
טעארעם	Teorem
כאליף	Kalif
אליהו בחור	Elia Levita
בראכטייל	Bråk
סענאט	USA:s senat
קורס (פינאנץ)	Växelkurs
צענטראלבאנק	Centralbank
סיטען	Sion (Valais)
באקסער	Johannesbröd
מאנטרע	Montreux
סאס-פע	Saas-Fee
ווישי רעגירונג	Vichyregimen
סקווירא	Skvyra
סאליוואן קאונטי	Sullivan County, New York
אוריה החתי	Uria
טעטריס	Tetris
ברעכונג	Refraktion
קעסי	Cassie
דעלפי	Delfi
פלאטא	Platå
יצחק באשעוויס זינגער	Isaac Bashevis Singer
פיער דע פערמא	Pierre de Fermat
בר מצווה	Bar mitzva
מעקינטאש	Macintosh
קארטעקס	Hjärnbark
רודאלף העס	Rudolf Hess
אויער וואקס	Öronvax
טעראר אטאקע אין מומביי (2008)	Terroristattackerna i Bombay 2008
טרערן	Tårar
מומע	Tant
פעטער	Onkel
העמד	Skjorta
דיטער וויסליצעני	Dieter Wisliceny
סאפי שאל	Sophie Scholl
רודאלף פראנץ העס	Rudolf Höss
קריסטיאנע פ'	Christiane Vera Felscherinow
יוליוס שטרייכער	Julius Streicher
שמשון רפאל הירש	Samson Raphael Hirsch
אנטאן דרעקסלער	Anton Drexler
וולאדימיר קעפן	Wladimir Köppen
יירגן שטרופ	Jürgen Stroop
וואלפגאנג פעטרי	Wolfgang Petry
משה מענדלסאן	Moses Mendelssohn
יום טוב ליפמאן צונץ	Leopold Zunz
טאמאס מאסאריק	Tomáš Garrigue Masaryk
גאס	Gata
פוילבוים	Getaplar
כעמישע סובסטאנץ	Kemikalier
גוגל דעסקטאפ	Google Desktop
גוגל כלים פאס	Google Toolbar
טעראבייט	Terabyte
ליכט (לעמפל)	Levande ljus
אליגאראכיע	Oligarki
פריינט (סעריע)	Vänner
מאזלען	Mässling
צארן	Vrede
רעגירונגס מאכט אבטייל	Maktdelningsprincipen
װיקיפּעדיע:פעסטשטעלן	Wikipedia:Verifierbarhet
Ethernet	Ethernet
25 (נומער)	25 (tal)
24 (נומער)	24 (tal)
60 (נומער)	60 (tal)
אוראנוס (אפגאט)	Uranos
קאמפיוטער פראגראמירן	Programmering
קאנטראבאס	Kontrabas
דענענבורג	Daugavpils
מגילת רות	Ruts bok
טשעק	Check (betalningsmedel)
פריזן ברייק	Prison Break
טאבריז	Tabriz
גייסט וויסנשאפט	Humaniora
נירנבערג פראצעס	Nürnbergprocessen
פאקער	Poker
קאפעליטש	Hatt
דענדראכראנאלאגיע	Dendrokronologi
פלאש	Flaska
טאמארינד	Tamarind
קארן (טרופע)	Korn (musikgrupp)
ענגלישער בירגערקריג	Engelska inbördeskriget
עדווארד גריג	Edvard Grieg
עקסעס	Microsoft Access
קא גע בע	KGB
טראגעדיע	Tragedi
זשאן טראוואלטע	John Travolta
1 אין אפריל	Aprilskämt
קייט בלאנשט	Cate Blanchett
ארטאדאקסישע יידנטום	Ortodox judendom
פרישטיק	Frukost
ערוואקסענער	Vuxen
פייער מויער	Brandvägg
האמעאפאטיע	Homeopati
אינזשעניר	Ingenjör
קארפ	Karp
געלט אויטאמאט	Uttagsautomat
ספר שופטים	Domarboken
דעצימאל	Decimala talsystemet
נאהיט	Kikärt
TCP/IP	TCP/IP
נח	Noa
ציטרוס פרוכט	Citrussläktet
סעגעד	Szeged
מעלאן	Melon
אילת איינגאס	Akabaviken
שלעזיע	Schlesien
גלעזל	Dricksglas
כישוף	Magi
פאסט פוד	Snabbmat
שלייערל	Fjärilslarv
ווייטאג	Smärta
באשטעק	Bestick
VoIP	IP-telefoni
GM	General Motors
צור	Tyros
טעמוקא	Temuco
באדליען ביבליאטעק	Bodleianska biblioteket
ליניארע אלגעברע	Linjär algebra
דעזיין	Design
בלוט דרוק	Blodtryck
איראן-איראק מלחמה	Iran–Irak-kriget
גאמבע	Haka
איניעס	Aeneas
קאמפיוטער טעקע	Fil (data)
קאנדזשי	Kanji
פליניוס דער עלטערער	Plinius den äldre
ראיאן	Region
נאמען	Egennamn
העקסאדעצימאל סיסטעם	Hexadecimala talsystemet
היסטאריע פון כינע	Kinas historia
ציפער	Siffra
נעווראלאגיע	Neurologi
אפעראציע בארבאראסע	Operation Barbarossa
ספעם	Skräppost
סאול בעלאו	Saul Bellow
לעסטער	Leicester
שוועמל	Fruktkropp
טורעם בריק	Tower Bridge
מושקאט נוס	Muskotsläktet
ראמעא און יוליא	Romeo och Julia
רמת הגולן	Golanhöjderna
טכויר	Skunkar
26 (נומער)	26 (tal)
פארברעכן	Brott
סעלינע גאמעז	Selena Gomez
יאהאן שטראוס דער זון	Johann Strauss den yngre
מאסול	Mosul
וועגעטאריאניזם	Vegetarianism
תנ"ך	Tanach
Windows 95	Windows 95
העראען (טעלעוויזיע סעריע)	Heroes (TV-serie)
איידלשטיין	Ädelsten
קאנטערי	Countrymusik
גענעראל	General
דזשודאס פריסט	Judas Priest
גרופע (מאטעמאטיק)	Grupp (matematik)
סוזאן בויל	Susan Boyle
אינטעליגענץ	Intelligens
סאוואנאה	Savannah, Georgia
אשרה	Ashera
מארטין בובער	Martin Buber
דזשעף האקינס	Jeff Hawkins
שמן־זית	Olivolja
אהוד אלמערט	Ehud Olmert
צייכענען	Teckning (konst)
גט	Skilsmässa
דאקומענטארער פילם	Dokumentärfilm
איסטמאס	Näs
מארק שאגאל	Marc Chagall
לאקאמאטיוו	Lok
קאדעקס כאמוראבי	Hammurabis lagar
קשאנאוו	Chrzanów
ווישי	Vichy
ברעג ים	Kust
גרויסווארדיין	Oradea
ביאביא (טייך)	Río Biobío
אינטערסטעיט הייוועי סיסטעם	Interstate Highway System
יום טוב	Judisk festkalender
אינטערסטעיט 87	Interstate 87
מיליאו וויאדוקט	Millaubron
F-16 פייטינג פעלקון	Lockheed Martin F-16 Fighting Falcon
קלויזנבורג	Cluj-Napoca
פונט	Pund (viktenhet)
דעפיניציע	Definition
יאסוא פוקודא	Yasuo Fukuda
ראשי תיבות	Akronym
פלי מאנשאפט	Kabinpersonal
אומקרויט	Ogräs
יאאכים פאן ריבענטראפ	Joachim von Ribbentrop
חזיר ווארצל	Vårta
אנצינדונג	Inflammation
נאוויגאציע	Navigation
וויטעבסק	Vitsebsk
קעלץ	Kielce
פוסיקאט דאלז	The Pussycat Dolls
שבת	Sabbat
כעמישער סימבאל	Kemiskt tecken
קאמפאניע (מיליטעריש)	Kompani
קלענסטע געמיינזאמע טאפלונג	Minsta gemensamma multipel
קורץ ווארט	Förkortning
ארץ	Malm
ספרונזשינע	Fjäder (teknik)
האניג בין	Honungsbin
דריווש דער דריטער	Dareios III
ארטיקל (גראמאטיק)	Artikel (grammatik)
בהמה	Boskap
ליסטע פון שטעט און שטעטלעך אין פוילן	Lista över städer i Polen
ארץ יהודה	Judeen
אמיש	Amish
ליולקע	Rökpipa
פלאצק	Płock
ראדעם	Radom
היפאטענוז	Hypotenusa
גלידער איבערפלאנצונג	Transplantation
בוקאווינא	Bukovina
נארגילע	Vattenpipa
שייטל	Peruk
שאנק	Skåp
טארנע	Tarnów
לאנדשאפט	Landskap (terräng)
הלכה	Halacha
טשייניק	Kittel
שת	Set (Bibeln)
פייער לעשער	Brandman
מעדיטאציע	Meditation
אראנדזש קאונטי, ניו יארק	Orange County, New York
דימינוטיוו	Diminutiv
געשווילאכץ	Svullnad
בערגאמאט	Bergamott
יותם המלך	Jotam
אפרים קציר	Ephraim Katzir
עופרה חזה	Ofra Haza
ראקלענד קאונטי	Rockland County
נבוכדנאצר	Nebukadnessar
ארטיקל	Artikel
יהודה המכבי	Judas Mackabaios
עדווארד ראשמאן	Eduard Roschmann
אינזל לאנד	Östat
נתן בירנבוים	Nathan Birnbaum
חסידי אומות העולם	Rättfärdig bland folken
היסטאריע פונעם פאראייניגטן קעניגרייך	Storbritanniens historia
שלמה בירנבוים	Solomon Birnbaum
מינאריטעט רעגירונג	Minoritetsregering
איהעל	Sátoraljaújhely
מיקלאש הארטי	Miklós Horthy
איינגאס פון קאדיז	Cádizbukten
כאפעז על אסאד	Hafez al-Assad
ראץ	Näspetning
אמעדעא מאדיליאני	Amedeo Modigliani
NSA	National Security Agency
סאציאל דעמאקראטיע	Socialdemokrati
אינפראסטרוקטור	Infrastruktur
פסח	Pesach
פראפעסאר	Professor
קארמען מיראנדא	Carmen Miranda
רעפערענץ	Referens
פראנצויזן	Fransmän
אמבאסאדאר	Ambassadör
היסטאריע פון דייטשלאנד	Tysklands historia
געבורט קאנטראל	Preventivmedel
דניאל בערנולי	Daniel Bernoulli
יאקאב בערנולי	Jakob Bernoulli
אטיקע	Attika
נומערן סיסטעם	Talsystem
שוועדישע קראנע	Svensk krona
קבלה	Kabbala
גאלדפיש	Guldfisk
שדרות	Sderot
לאנד איינגעשלאסן	Inlandsstat
ביקס	Gevär
אייזערנעם פארהאנג	Järnridån
געארגי זשוקאוו	Georgij Zjukov
קוואל וואסער	Vattenkälla
ראיאטן	Kravall
טעם	Grundsmak
ברוקלין בריק	Brooklynbron
זעג	Såg
שאקאל	Schakaler
ווארראזאנאו נערויס בריק	Verrazano-Narrows Bridge
אהוד ברק	Ehud Barak
ווייטקייט	Avstånd
עכו	Akko
וואלווערהאמפטאן	Wolverhampton
נח'ס תיבה	Noas ark
יהושפט	Josafat
נעמן	Naaman
קליינהאנדל	Detaljhandel
קינדערגארטן	Barnträdgård
ים כנרת	Gennesaretsjön
ענדגילטיקע לייזונג	Den slutgiltiga lösningen
פערל הארבער	Pearl Harbor
באמבע	Bomb
רמב"ם	Maimonides
טינט	Bläck
פרא באנא	Pro bono publico
גילוי עריות	Incest
קאטאראקט	Grå starr
פינפעק	Pentagon
פסעוודאנים	Författarnamn
פייער ווארקס	Fyrverkeri
מיקראכוואליע	Mikrovågor
מאכמוד אבאס	Mahmoud Abbas
טאפיר	Tapirer
קאפיטע	Hov (djurfot)
דינאמיק	Dynamik (mekanik)
עלעקטראנישער בוך	E-bok
יאנקערס, ניו יארק	Yonkers
קינגסטאן אויף האל	Kingston upon Hull
ישראלדיקע פאן	Israels flagga
פאל מארטין	Paul Martin
על דזשאלסאן	Al Jolson
זשאן קרעטיען	Jean Chrétien
קים קעמפבעל	Kim Campbell
ברייען מאלראני	Brian Mulroney
דזשאן טורנער	John Turner
ביאאינפארמאטיק	Bioinformatik
דזשאו קלארק	Joe Clark
גלגול	Själavandring
לעסטער פערסאן	Lester B. Pearson
דזשאן דיפענבעיקער	John Diefenbaker
לואיס סעינט לורענט	Louis Saint-Laurent
וויליאם ליאן מעקענזי קינג	William Lyon Mackenzie King
ריטשארד בעדפארד בענעט	Richard Bedford Bennett
ארטור מעגען	Arthur Meighen
ראבערט בארדן	Robert Borden
ווילפריד לאריער	Wilfrid Laurier
טשארלס טאפער	Charles Tupper
מאקעניזיע באוועל	Mackenzie Bowell
דזשאן טאמפסאן	John Thompson
דזשאן אבאט	John Abbott
דזשאן אלעקסאנדער מאקדאנאלד	John A. Macdonald
אלעקסאנדער מעקענזי	Alexander Mackenzie
ריקי מארטין	Ricky Martin
יצחק בן-צבי	Yitzhak Ben-Zvi
עזר ווייצמאן	Ezer Weizman
קלעמענט אטלי	Clement Attlee
טשערנאבל	Tjernobyl
פולקע	Lår
מאקבעט	Macbeth
קרעאציאניזם	Kreationism
קריג'ס געזעצן	Krigets lagar
אלאניס מאריסעט	Alanis Morissette
ריבענטראפ מאלאטאוו אפמאך	Molotov–Ribbentrop-pakten
וויליאם דער פערטער	Vilhelm IV av Storbritannien
דידזשיי	Discjockey
התקווה	Hatikvah
מנחם בעגין	Menachem Begin
רויטערס	Reuters
חנוכה	Chanukka
עדיפוס	Oidipus
קאלערי	Kalori
הארון אל-ראשיד	Harun al-Rashid
ראש השנה	Rosh hashana
מגילת אסתר	Esters bok
קהלת	Predikaren
ליסטע פון שטעט אין די פאראייניגטע שטאטן לויט באפעלקערונג	Lista över USA:s städer efter folkmängd
נאמינאטיוו	Nominativ
לופט פארפעסטיקונג	Luftföroreningar
בראונאו אם אין	Braunau am Inn
וויץ	Skämt
קאבאל	COBOL
וועב 2.0	Web 2.0
שווייסן	Svetsning
נעסטער	Dnestr
לינזן	Lins (växt)
מאנטיס	Bönsyrsor
װיקיפּעדיע:קוואלן פאר ביכער	Wikipedia:Bokkällor
ניי שקל	Shekel
היץ פאמפע	Värmepump
ארון הברית	Förbundsarken
מיסוראטאה	Misratah
זשענעט זשעקסאן	Janet Jackson
באם	Hemlöshet
פראפעסיאנעלע ראנגלען	Fribrottning
אינטערנאציאנאלע דאטע ליניע	Datumgränsen
כאליפאט	Kalifat
ווורשט	Korv
קאמעמבערט	Camembert
ERP	Affärssystem
פארמער	Bonde
אפמאך	Traktat
שטאַל	Gård
מעראן	Merano
ספר עזרא	Esra
רעזערוואואר	Vattenmagasin
האנטוך	Handduk
פלוטאקראטיע	Plutokrati
ספר טוביה	Tobit
פארפום	Parfym
גרעסטער געמיינזאמער טיילער	Största gemensamma delare
אידעע	Idé
גומע	Gummi
פאנטאזיע	Fantasy
שינזא אבע	Shinzo Abe
פערמא'ס לעצטער טעארעם	Fermats stora sats
Grand Theft Auto (סעריע גאמעס)	Grand Theft Auto (spelserie)
אדמיראל	Amiral
גרינלענדישער ים	Grönlandshavet
וויאטשעסלאוו מאלאטאוו	Vjatjeslav Molotov
ליפט	Hiss
יום כיפור	Jom kippur
מאזשיארן	Ungrare
שמואל יוסף עגנון	Samuel Agnon
בראך	Bråck
פארהאנדלונג באציאונגען	Public relations
באקסהארן	Bockhornsklöver
מוסלעם ברידערשאפט	Muslimska brödraskapet
קאסינא	Kasino
רוקן	Rygg
שבט (געזעלשאפט)	Stam (samhällsvetenskap)
גרענעץ	Gräns
כנסת	Knesset
טאל פון די מלכים	Konungarnas dal
שטאטס שטאַט	Stadsstat
רב	Rabbin
בריוו	Brev
לערנען	Studieteknik
אליהו הנביא	Elia
נארמאלע פארטיילונג	Normalfördelning
ערשטע הילף	Första hjälpen
ערעקשאן	Erektion
כינעזישער קאלענדאר	Kinesiska kalendern
מבול וואסער	Syndafloden
ציינבערשטל	Tandborste
זשאנאס ברידער	Jonas Brothers
קוואדראט ווארצל	Kvadratrot
פרעפאזיציע	Adposition
טייס	Tisza
יוסיפון	Josefus
בלעק אייד פיס	Black Eyed Peas
סינגל	Singel
פאסיק	Bälte (kläddetalj)
ארטישאק	Kronärtskocka
עקסעטער	Exeter
קאמיל פיסארא	Camille Pissarro
אילת	Eilat
קאקטייל	Cocktail
כותל	Västra muren
פרעפיקס	Prefix
אפמאך פון ווערדון	Fördraget i Verdun
שאמפאניע	Champagne
ביבליאגראפיע	Bibliografi
טראן דאק לואנג	Tran Duc Luong
אטלאנטיק סיטי	Atlantic City
פראנצויזישער מאנדאט	Franska mandatet för Syrien och Libanon
בריסק	Brest, Vitryssland
יושב ראש	Ordförande
גראף (מאטעמאטיק)	Graf (grafteori)
אראבישע לענדער	Arabvärlden
קארלא ברוני	Carla Bruni
דאטיוו	Dativ
יוסף	Josef, Jakobs son
אקוזאטיוו	Ackusativ
מונקאטש	Mukatjeve
קאניאק (בראנפן)	Brandy (spritdryck)
לינדז	Lins (öga)
כוסיין קעניג פון יארדאניע	Hussein av Jordanien
טשארטקאוו	Tsjortkiv
מאנאך	Monastisk
ברונא שולץ	Bruno Schulz
קוילקרייז	Småcirkel
קאסעטע	Kassettband
אתרוג	Suckatcitron
דזשארדזש קארלין	George Carlin
לאנדאנער בארא פון בארנעט	London Borough of Barnet
ספינקס	Sfinx
װיקיפּעדיע:וויאזוי צו רעדאקטירן א בלאט	Wikipedia:Redigering
ציפי ליבני	Tzipi Livni
באגריף	Koncept
טבריה	Tiberias
אירענא סענדלער	Irena Sendler
בוריק	Sockerbeta
גלח	Pastor
טרעבלינקע	Treblinka (förintelseläger)
געטא	Getto
בערנארד מאנטגאמערי	Bernard Montgomery
יאן אנטאנעסקו	Ion Antonescu
מסטיסלאוו ראסטראפאוויטש	Mstislav Rostropovitj
באיער	Bayer AG
BP	BP
טייק דעט	Take That
באנקראטירונג	Konkurs
אש	Aska
קאנצענטראציע לאגער	Koncentrationsläger
וואנע	Badkar
שווארצער סעפטעמבער	Svarta september (organisation)
סטריפיז	Striptease
על ליסיצקי	El Lisitskij
עדווארד בענעש	Edvard Beneš
שאנדע	Skamkänsla
אראם כאטשאטוריאן	Aram Chatjaturjan
איסאראקו יאמאמאטא	Isoroku Yamamoto
בית שאן	Bet She'an
דימונה	Dimona
גבעתיים	Givatayim
כפר סבא	Kfar Saba
יאנוש קורטשאק	Janusz Korczak
בית שמש	Bet Shemesh
בני ברק	Bnei Brak
הרצליה	Herzliya
מאנטל	Jacka
פרייע פראנקרייך	Fria Frankrike
צומי	Napp
סאביבאר	Sobibór
ראול וואלענבערג	Raoul Wallenberg
לאטקע	Raggmunk
ראטנבורג	Rothenburg ob der Tauber
לחיים	Skål (gest)
גארנישט	Ingenting
פראנסוא אראגא	François Arago
ווארשעווער געטא	Warszawas getto
רפאל פארגעשריטענע פארטיידיקונג סיסטעמען	Rafael Advanced Defense Systems
ישיבה	Yeshiva
קארל מאריע פאן וועבער	Carl Maria von Weber
עוזי	Uzi
איגאר טאם	Igor Jevgenjevitj Tamm
פארמעזאן	Parmesan
שפייעכץ	Saliv
בן סירא	Jesus Syraks vishet
אייראסטאר	Eurostar (järnvägslinje)
נאז לעכער	Näshåla
עקסאן-מאביל	Exxon Mobil
מתושלח	Methusalem
עטיאלאגיע	Etiologi
מנשה מלך יהודה	Manasse (kung)
קעלטער	Vineri
יד ושם	Yad Vashem
קאוולע	Kovel
אונגוואר	Uzjhorod
זשיטאמיר	Zjytomyr
ראוונע	Rivne
פאלטאווע	Poltava
יהודי מענוחין	Yehudi Menuhin
מאנמעטה	Monmouth
סאמועל האנעמאן	Samuel Hahnemann
דינגען	Hyra
ישראל אוימאן	Robert Aumann
טריסקעוויץ	Truskavets
קאסאוו	Kosiv
באריסלאוו	Boryslav
פאנטאנאל	Pantanal
טשערנאוויץ	Tjernivtsi
מעלות	Dygd
זאפאראזשיע	Zaporizjzja
פירסינג	Piercing
פיעטרקאוו	Piotrków Trybunalski
ראמאללא	Ramallah
דיאספער	Kaki
פייסעליס	Lyktörtssläktet
װאשינגטאניא	Washingtonia
קאליפארניער מאנרענדל	Sömntuta
ראדאמסק	Radomsko
בערדיטשעוו	Berdytjiv
פאפירוס	Papyrus (växt)
מייק הוקאבי	Mike Huckabee
עי די על	Anti-Defamation League
דראהביטש	Drohobytsj
ירמיהו	Jeremia
הארנמאן	Hornvallmosläktet
דיריגענט	Dirigent
סטרי	Stryj
נינא האגען	Nina Hagen
עקאנאמיע	Ekonomi
אבסטראקטע אלגעברע	Abstrakt algebra
רוסישע־יאפאנעזער מלחמה	Rysk-japanska kriget
צווילינג	Tvillingar
פינק	Pink
מאגלעוו באן	Maglevtåg
פלוין	Slätt
וויע	Ögonfrans
מיידאנעק	Majdanek
באל-פאוינט פעדער	Kulspetspenna
מאטהויזען	Mauthausen
חיים סוטין	Chaim Soutine
בעלזשיץ פארטיליקונג לאגער	Bełżec
מארק ראטקא	Mark Rothko
כעלמנא פארטיליקונג לאגער	Förintelselägret Chełmno
יעווגעני קיסין	Jevgenij Kissin
זשאסעף ליבערמאן	Joseph Lieberman
פייל קרייץ	Pilkorsrörelsen
ווארשעווער געטא אויפשטאנד	Upproret i Warszawas getto
נארמאן פינקעלשטיין	Norman Finkelstein
דער שטירמער	Der Stürmer
דאטשע	Datja
אסיפ צאדקין	Ossip Zadkine
טערעזנשטאט	Theresienstadt (koncentrationsläger)
האס	Hat
אוניווערסיטעט פון עדינבורג	Edinburghs universitet
פראספער מערימע	Prosper Mérimée
קאליקסט דער דריטער	Calixtus III
מישעל באקמאן	Michele Bachmann
וואלדיוויא	Valdivia
וואלס מיט באשיר	Waltz with Bashir
שרויפן-ציער	Skruvmejsel
מאנסטער פרוכט	Monstera
קרעדיט קארטל	Kreditkort
קיבוץ	Kibbutz
מגן דוד	Davidsstjärna
קאלעג צו קאלעג	P2P-nätverk
היסטאריע פון רוסלאנד	Rysslands historia
אקעאנוס	Okeanos
אפטאלמאלאגיע	Oftalmologi
צירונג	Smycken
שעפעטיווקע	Sjepetivka
כוואסטוב	Fastiv
מילכווילף	Sidenörtssläktet
קויציע	Borgen (straffprocess)
אנקאלאגיע	Onkologi
אולטראשאל	Ultraljud
אקאדעמיע	Akademi
מאזשינא ליניע	Maginotlinjen
נגב	Negev
זיגל	Sigill
פעטראלאגיע	Petrologi
צידון	Sayda
דרוזן	Druser
העלענע	Helena (mytologi)
לעמבערגער גובערניע	Lviv oblast
מוזיקאלאגיע	Musikvetenskap
בינארישע אפעראציע	Binär operator
שינקאנסען	Shinkansen
אונגארישע רעוואלוציע	Ungernrevolten
איבערלעבונג	Erfarenhet
קארי	Curry
מאכאמעד אמין על כוסייני	Haj Amin al-Husseini
וואל סטריט זשורנאל	The Wall Street Journal
פאפקארן	Popcorn
הדס	Myrtensläktet
מייוווד (אילינויס)	Maywood, Illinois
טורקיז	Turkos
קירבעס	Pumpa
אומגלייכהייט	Olikhet
פעדער	Penna
דער אייביגער יודע	Den evige juden
Windows Movie Maker	Windows Movie Maker
StarCraft	Starcraft
שפיאנאזש	Spioneri
ווינער אוניווערסיטעט	Wiens universitet
בלוטשטורץ	Blödning
France 24	France 24
אינפעקציע	Infektion
קאנדענסירונג	Kondensering
ראמזיי מאקדאנאלד	Ramsay MacDonald
הערבערט הענרי אסקוויט	H.H. Asquith
פארלאמענטארע דעמאקראטיע	Parlamentarism
שפאקטיוו	Förstoringsglas
קארפאראציע	Korporation
ערלוי	Eger
נעשונאל זשיאגראפיק	National Geographic Society
באטאנישער גארטן	Botanisk trädgård
פעלשער	Falskmyntarna
נצרת עילית	Nasaret Illit
יבנה	Javne
וואהלינער גובערניע	Volyn oblast
מודיעין עילית	Modi'in Illit
אינטערנעט פארום	Internetforum
חברון	Hebron
הונגער	Hungersnöd
בטלמיוס	Ptolemaios I Soter
גאלף פון סועץ	Suezviken
קארניע	Hornhinna
ביהייוויאריזם	Behaviorism
שאפראן	Sopron
גייסטליכקייט	Andlighet
טריפאלי (לבנון)	Tripoli, Libanon
דזשעסיקא סימפסאן	Jessica Simpson
הענטשקע	Handskar
דיסקרימינאציע	Diskriminering
אומעט	Sorgsenhet
אריאל	Ariel (stad)
אַלטינאָ אַראַנטעס בנין	Edifício Altino Arantes
פיזיקער	Fysiker
סימפטאם	Symtom
וואלד פייער	Skogsbrand
אוניווערסיטעט פון לאנדאן	University of London
ארקאדיע	Arkadien
קאנװערט	Kuvert
יאכט	Yacht
סיטואציע קאמעדיע	Situationskomedi
איי-קיו	Intelligenskvot
עם 16	M16 (automatkarbin)
קארלאס סלים	Carlos Slim Helú
פאסעיק	Passaic
מנורה	Menora
זעגלשיף	Segelfartyg
שינקען	Skinka
גלאסטער	Gloucester
אגאדיר	Agadir
פאראדיע	Parodi
באלקאן	Balkong
לאכן	Skratt
נענסי פעלאוסי	Nancy Pelosi
רעפובליק פון טעקסעס	Republiken Texas
איטאליע בנין	Edifício Itália
געגאסענע בליי אפעראציע	Gazakriget (2008–2009)
נס	Mirakel
מאטעמאטיקער	Matematiker
ריבית	Ränta
גאסטראנאמיע	Gastronomi
טאבו	Tabu
בלאגער	Blogger
חסידות	Chassidism
נירעדהאז	Nyíregyháza
קאמף פון טראפאלגאר	Slaget vid Trafalgar
קאראל	Koralldjur
אקצידענט	Olycka
אשדוד	Ashdod
גראפנשאפטן פון ענגלאנד	Englands grevskap
בלעקבערי	Blackberry
אלפרעד דרייפוס	Alfred Dreyfus
אלדא מארא	Aldo Moro
מענעלאוס	Menelaos
מידלזברא	Middlesbrough
נעקטאר	Nektar
קאנצעסיע	Franchise
יוחנן וואלאך	Yochanan Vollach
חיים ווייצמאן	Chaim Weizmann
ארצידיאצעז פון קאנסעפסיאן	Concepcións ärkestift
דאטן גראבן	Datautvinning
אינטעליגענטע אויספלאנעווען	Intelligent design
צפון וויעטנאם	Nordvietnam
בעזים	Kvast
בראנכן אנצינדונג	Bronkit
אגראנאמיע	Lantbruksvetenskap
שפיראכץ	Sinne
כוזרים	Khazarer
שווארצאפל	Pupill
געדרוקטער שטראמקרייז	Mönsterkort
לוויה	Gravskick
סיסקא	Cisco Systems
בלאז אינסטרומענטן	Blåsinstrument
האנט גראנאט	Handgranat
וושט	Matstrupe
לופטקילער	Luftkonditionering
פארוויילונג	Underhållning
ראדיוס	Radie
רעגענט	Regent
העברעאישער אוניווערסיטעט אין ירושלים	Hebreiska universitetet i Jerusalem
B-52 סטראטופארטרעס	Boeing B-52 Stratofortress
לאנדאנער שולע פון עקאנאמיק	London School of Economics
V-1 און V-2 ראקעטן	V-2
ווילא אלעמאנא	Villa Alemana
מייקל מאור	Michael Moore
טעקע סיסטעם	Filsystem
בעסאראביע	Bessarabien
הענגען	Hängning
קאנטרי	Landsbygd
װיקיפּעדיע:אויסשפארן פאליסי	Wikipedia:Blockeringar
עקיבא אייגער	Akiba Eger
לופטרער	Luftstrupe
מעט דעימאן	Matt Damon
וויטאמין D	Vitamin D
פאביע	Fobi
רעסעסיע	Recession
זינגער	Sångare
זון (משפחה)	Son
מיינפריים	Stordator
אסאציאטיוויטעט	Associativitet
פאראפין	Paraffin
פאגראם	Pogrom
טראטואר	Trottoar
סטערויד	Steroid
קאנאלא אויל	Raps
טייג	Deg
ליבידא	Libido
קעטשאפ	Ketchup
אבסעסיוו קאמפאלסיוו דיסארדער	Tvångssyndrom
שכיר חרב	Legosoldat
סברה	Förnuft
עופות	Fjäderfä
ניר שטיין	Njursten
גראמען	Rim
ליקער	Likör
פאטאך	Fatah
קוקי	Webbkaka
בערזע	Börs
אראן בור	Aaron Burr
אלמן	Änka
בלוט פארגליווערונג	Blodkoagulering
איינקונפט שטייער	Inkomstskatt
אינפיניטיוו	Infinitiv
דזיאוואני דא פאלעסטרינא	Giovanni Pierluigi da Palestrina
סיטי פון וועסטמינסטער	City of Westminster
מאסאזש	Massage
סאפטוועיר באג	Bugg (dator)
סטאטוע	Staty
זכריה הנביא	Sakarja
באאט	Baathpartiet
פאלעאגראפיע	Paleografi
איוב	Ayub
עיר פארס וואן	Air Force One
פערגי	Fergie (artist)
חלשות	Svimning
גאליציע	Galizien
פורים	Purim
פאטימא	Fatima
יפו	Jaffa
פערסישער קאלענדאר	Persiska kalendern
מיסט מאנאזשעריע	Avfallshantering
וואפיטי	Wapitihjort
אמבולאנס	Ambulans
צימער	Sal (rum)
מאנדלען	Tonsill
דרום וויעטנאם	Sydvietnam
באריס זשאנסאן	Boris Johnson
פאטשיילע	Sjalett
סטיוון זשעי גאלד	Stephen Jay Gould
געפעכט	Konflikt
בעדואינער	Beduiner
קאמפיוטער ווארעם	Internetmask
די מיזעראבלער	Samhällets olycksbarn
ציאן	Cyan
טרורא	Truro
דאו דשאונס אידאסטריאלער עוורעדזש	Dow Jones Industrial Average
היינעקען אינטערנאציאנאל	Heineken
כארעאגראפיע	Koreografi
פרייצייט	Fritid
אבו מוסאב אל-זארקאווי	Abu Musab az-Zarqawi
פראנקפורטער	Varmkorv
סאאיד כאסאן נאסראללא	Hassan Nasrallah
שאצער קאנט	Suceava (județ)
בן גוריון פליפעלד	Ben Gurions internationella flygplats
דארלינג טייך	Darling (flod)
פאציענט	Patient
מאגאזין (סקלאד)	Lagerbyggnad
אליעזר בן יהודה	Eliezer Ben-Jehuda
ליסטע פון שטעט אין אונגארן	Lista över orter i Ungern
משה קצב	Moshe Katsav
מערב האלבקיילעך	Västra halvklotet
קרעדיט (פינאנץ)	Kredit
גארטל הערפעס	Bältros
ווערטיקאל	Vertikal
סוכות	Sukkot
צאל (שטייעראמט)	Tullmyndighet
ען קא ווע דע	NKVD
כנבוזי דער צווייטער	Kambyses II
רוסטאווי	Rustavi
כיראמאנטיע	Kiromanti
ניוט גינגריטש	Newt Gingrich
פלארעסענט באלב	Lysrör
פ.ג. ראָסטאָוו	FK Rostov
עלען דערשאוויץ	Alan Dershowitz
ארטור רובינשטיין	Arthur Rubinstein
פאהאד בין אבדול אזיז	Fahd bin Abdul Aziz
ספרעדשיט	Kalkylprogram
באנק פון ענגלאנד	Bank of England
ניו עידזש	New Age
טעריטאריע	Territorium
באר (באדייטן)	Bar
באפי די וואמפיר יעגערין	Buffy och vampyrerna
מישעל ראדריגעז	Michelle Rodríguez
צדקיהו	Sidkia
יצחק שמיר	Yitzhak Shamir
ניבול פה	Svordom
מעד	Mjöd
קאבל-טעלעוויזיע	Kabel-TV
קארע	Bark
אידיאם	Idiom (språk)
צעהן מכות	Egyptens tio plågor
סטארטפאס	Landningsbana
טארף	Torv
ערעקטייל דיספאנקשען	Impotens
קרב מגע	Krav Maga
סימבאל פון ישראל	Israels statsvapen
היסטאגראם	Histogram
איוואן קאניעוו	Ivan Konev
שפרינגען מיט א טיטשקע	Stavhopp
גאון	Geni
וואזעלין	Vaselin
פוקס	Vulpes
מילכיגס	Mejeriprodukt
כרמל בארג	Karmelberget
סי-פי-אר	Hjärt-lungräddning
סאטמאר (שטאט)	Satu Mare
אמסטעל	Amstel
וויליאם דזשיימס אדאמס	Will.i.am
האנטגעלענק	Handled
מלחמה קעגן טעראר	Kriget mot terrorismen
פילאנטראפ	Filantropi
טראפן (פליסיגקייט)	Droppe
נייטראלער עלעמענט	Neutralt element
אנאלאגיע	Analogi (psykologi)
חיפה דיסטריקט	Haifa (distrikt)
מופטי	Mufti
Fox News	Fox News Channel
פארטאל	Webbportal
סייסמישע כוואליעס	Seismisk våg
פעך	Tjära
איימאן על-זאוואהירי	Ayman az-Zawahiri
באראט	Borat (film)
ניו דיל	New Deal
קראנקן שוועסטער	Sjuksköterska
אנגינע	Halsfluss
פאראזיט	Parasitism
קאשע	Gröt
איבל	Illamående
ליכוד	Likud
פיליפ ראטה	Philip Roth
עקאנאמישע געאגראפיע	Ekonomisk geografi
לאביאונג	Lobbying
באלפורס דעקלאראציע	Balfourdeklarationen (1917)
ביסטריץ	Bistrița
אלכסנדר קארעלין	Aleksandr Karelin
סידרא איינגאס	Sidrabukten
ווינדל	Blöja
כאבאר	Muta
שענק	Barlokal
באקלאווא	Baklava
זעל מיללער	Zell Miller
עמיגראציע	Emigration
קבר-קירך	Heliga gravens kyrka
פיטבול	Pitbull (artist)
זומערשפרענקלעך	Fräknar
פראזע (לינגוויסטיק)	Fras (grammatik)
פאבריקאציע	Tillverkningsindustri
דיסטריבוטיוו	Distributivitet
א סכנה'דיגע מעטאד	A Dangerous Method
צפת	Safed
פאקט	Faktum
IMAX	IMAX
קאמין	Eldstad
הוידלקע	Gunga
קנאה	Avundsjuka
דרום דיסטריקט (ישראל)	Södra distriktet
משה דיין	Moshe Dayan
צענטער דיסטריקט (ישראל)	Centrala distriktet
פאלאפעל	Falafel
פילגש	Konkubinat
דעוויד שווימער	David Schwimmer
שחיטה אין ווירזשיניע-טעק	Virginia Tech-massakern
קעניגלעכע בארא פון קענזינגטאן און טשעלסי	Royal Borough of Kensington and Chelsea
פאקטאריזאציע	Faktorisering
מאראמאראשער דיסטריקט	Maramureș (județ)
LDAP	Lightweight Directory Access Protocol
ווייב	Maka (äktenskap)
וואלונטיר	Volontär
פעלד	Åker
קישקע קענסער	Tjocktarmscancer
ישראל נאציאנאלע ביבליאטעק	National Library of Israel
קאלעדזש	College
טראנסזשענדער	Transperson
קנאות	Seloter
לאטעריע	Lotteri
אקאדעמישע דיפלאמע	Examen
באָרג	Lån
פארב	Färgämne
צפון דיסטריקט (ישראל)	Norra distriktet
אסיפ מאנדעלשטאם	Osip Mandelstam
אקאדעמיע פאר דער העברעישער שפראך	Akademin för det hebreiska språket
אלעמאל-גרין	Städsegrön
סאבאלטש-סאטמאר-בערעג	Szabolcs-Szatmár-Bereg
סופרים קארט	Högsta domstolen
BDSM	BDSM
הערש	Gaseller
שטיוול	Stövlar
טרענסעקסואליזם	Transsexualism
דזשונגל	Djungel
אלטקייט	Ålderdom
טאן	Ton (metriskt)
לוי אשכול	Levi Eshkol
כשרות	Kosher
דועל	Duell
CFA פראנק	CFA-franc
פאדאליע	Podolien
אפאלגאטיקע	Apologetik
סדרדיקע צאל	Ordinaltal
לשון הרע	Förtal
משניות	Mishna
חולון	Holon
קאטיושא	Katiusja (vapen)
נתניה	Netanya
ירושלים דיסטריקט	Jerusalem (distrikt)
סיודאד דעל עסטע	Ciudad del Este
איך האב א חלום	I Have a Dream
האנגאר	Hangar
פוערטעווענטורא	Fuerteventura
לימביק סיסטעם	Limbiska systemet
מימיקרי	Mimikry
ווירטועל מאשין	Virtuell maskin
ראפיק על כארירי	Rafiq Hariri
אבדאללא קעניג פון יארדאניע	Abdullah I av Jordanien
פאנטשקע	Munk (bakverk)
גלית	Goljat
ראבערט וואדלאוו	Robert Pershing Wadlow
רמת גן	Ramat Gan
תל אביב דיסטריקט	Tel Aviv (distrikt)
ריב אייזן	Rivjärn
סייענס (זשורנאל)	Science
הורדוס אנטיפס	Herodes Antipas
מינסקער גובערניע	Minsks voblasts
הייבריד אויטא	Hybridbil
הר הבית	Tempelberget
היינט	Nutid
מלך פון פוילן	Lista över Polens statsöverhuvuden
ווען	Skåpbil
געוויסן	Samvete
אסימילאציע	Assimilation (sociologi)
קייט רייען	Kate Ryan
בריטישער מאנדאט	Brittiska Palestinamandatet
פלשתים	Filistéer
הר תבור	Tabor
קאמעניץ, אוקראינע	Kamjanets-Podilskyj
מוכאמעד אמאר	Mohammed Omar
ווידעא קליפ	Musikvideo
יחזקאל	Hesekiel
קארליק	Dvärgväxt
MS Freedom of the Seas	M/S Freedom of the Seas
ווערט	Värdering (sociologi)
פארקויפן	Försäljning
סודעטן	Sudetenland
זשאנגלירן	Jonglering
שרה	Sara (Bibeln)
די באוועגונג	Hatnuah
Windows Explorer	Utforskaren
מיקראסקאפ	Mikroskop
פעלץ	Päls (klädesplagg)
אייער ברויט	Fattiga riddare
היסטאריע פון פוילן	Polens historia
אוניווערסיטעט פון קאנסעפסיאן	Universidad de Concepción
יונה סאלק	Jonas Salk
פשוטע ענגלישע וויקיפעדיע	Simple English Wikipedia
ווידרע	Uttrar
ירושה	Arv
וועלט היסטאריע	Världens historia
שיצפאס	Säkerhetsbälte
סעודה	Fest
גיאם דע מאשא	Guillaume de Machaut
שם	Sem
משנה תורה	Mishné Torá
ראשון לציון	Rishon LeZion
שבועות	Shavuot
דאנא אינטערנאשיאנאל	Dana International
סלוצק	Slutsk
פאווע	Påfåglar
היסטאריע פון וויסנשאפט	Vetenskapshistoria
סטאטוס קווא	Status quo
היפאקריטיע	Hycklare
סאניק	Sanok
לאנדאנער בארא פון לאמבעט	London Borough of Lambeth
לאנדאנער בארא פון קאמדן	London Borough of Camden
פאס דו איגוואסו	Foz do Iguaçu
לבנון טאל	Bekaadalen
רשימה פון מדרשים	Midrash
ראמאן, רומעניע	Roman (stad)
דזשעסיקא סוטא	Jessica Sutta
קאנסענסוס	Konsensus
פאלאשן	Beta Israel
בראהמאגופטא	Brahmagupta
איינס קרייז	Enhetscirkel
מצבה	Gravsten
מערת המכפלה	Makpelagrottan
גיחון קוואל	Gihonkällan
גאז קאמער	Gaskammare
צענטראלע ליניע	Central line
לאנדאנער בארא פון בארקינג און דעגנהעם	London Borough of Barking and Dagenham
קין	Kain
אבשלום	Absalom
ערפינדער	Uppfinnare
גרינוויטש וויליזש	Greenwich Village
אלוועלטלעכע ציוניסטישע באוועגונג	Sionistiska Världsorganisationen
זוהר	Zohar
אלגעברעישע סטרוקטור	Algebraisk struktur
צפורה	Sippora
קאנסערוואטיוו יידנטום	Konservativ judendom
סטינגרעי	Spjutrockor
לאנדאנער בארא פון האקני	London Borough of Hackney
לאנדאנער בארא פון הילינגדן	London Borough of Hillingdon
לאנדאנער בארא פון איזלינגטאן	London Borough of Islington
פיאדאר יעמעליאנענקא	Fjodor Jemeljanenko
טאלאנט	Färdighet
שיכרות	Berusning
הר הזיתים	Olivberget
גוגל ביכער	Google Böcker
הר הרצל	Herzlberget
ביאמאלעקול	Biomolekyl
אלישע	Elisha
איזאפאד	Gråsuggor och tånglöss
ציריכער אוניווערסיטעט	Zürichs universitet
סימפאזיום	Symposium
ALS	Amyotrofisk lateralskleros
פייזער	Pfizer
דורכגאס פון סיציליע	Siciliensundet
סנחריב	Sanherib
לאנדאנער בארא פון ברענט	London Borough of Brent
לאנדאנער בארא פון בעקסלי	London Borough of Bexley
לאנדאנער בארא פון אילינג	London Borough of Ealing
באברויסק	Babrujsk
כבוד	Heder
הענגאווער	Bakfylla
קאלא-קאלא	Club Social y Deportivo Colo-Colo
רחל	Rakel (Bibeln)
וויספע	Holme
לוד	Lod (stad)
מוזיקאלישע קאמפאזיציע	Komposition
פיקאדילי ליניע	Piccadilly line
בלאדי מערי	Bloody Mary (drink)
אצ"ל	Irgun
עריק ראבערטס	Eric Roberts
גוואנטאנאמע בעי	Guantánamobukten
גאלד (קאליר)	Guld (färg)
לאנדאנער בארא פון נייהעם	London Borough of Newham
לאנדאנער בארא פון טאר האמלעטס	London Borough of Tower Hamlets
כתובים	Skrifterna
ניסן	Abib
פארגעניגן	Njutning
אב	Ab (månad)
סאברא און שאטילא	Massakern i Sabra och Shatila
לאנדאנער בארא פון בראמלי	London Borough of Bromley
בעדפארד	Bedford
לעשאויטא	Brandbil
גראן טשאקא	Gran Chaco
עיל	Ale (öltyp)
ספערויד	Rotationsellipsoid
קראי	Karaitisk judendom
פשעמישל	Przemyśl
אדום	Edom
משה שרת	Moshe Sharett
סנהדרין	Sanhedrin
לבנון ברודער קריג	Inbördeskriget i Libanon
פרעמיער מיניסטער פון ישראל	Israels premiärminister
אל על	El Al
אומאן	Uman
גראד (ווינקל)	Gon
בת ים	Bat Yam
לאנדאנער בארא פון רעדברידזש	London Borough of Redbridge
ישראלישע אקאדעמיע פון וויסנשאפטן	Israel Academy of Sciences and Humanities
ביאלע	Biała Podlaska
דינדיש	Gyöngyös
אינטערפרעטאציע	Tolkning (översättning)
לאנדאנער בארא פון הארוי	London Borough of Harrow
לאנדאנער בארא פון ענפילד	London Borough of Enfield
לאנדאנער בארא פון וואנדזווערט	London Borough of Wandsworth
פסיכיאטער	Psykiater
תשעה באב	Tisha beav
מקווה	Mikve
איסאאק לעװיטאן	Isaak Levitan
מצה	Matza
פרינציפ	Princip
בלעך	Plåt
פולין גדול	Storpolen
ניו יארק פאסט	New York Post
סאאיד קטב	Sayyid Qutb
פארקויף מאשין	Varuautomat
רחבעם	Rehabeam
שלונגן	Sväljning
סייקס-פיקא פארשטענדעניש	Sykes-Picot-avtalet
בלוט צעל	Blodkropp
אריאן	Orion (rymdfarkost)
גאלף	Golf (olika betydelser)
ענטעבע	Entebbe
באצילן	Bacill
מאנארך פלאטערל	Monark (fjäril)
אייר	Ijar
פייסל דער ערשטער	Faisal I av Irak
רודאלף זשוליאני	Rudy Giuliani
מאניקע לעווינסקי	Monica Lewinsky
סטיווען קאלבערט	Stephen Colbert
קלעזמער	Klezmer
פארטיזאנער	Partisan (militär)
טלית	Tallit
חנוך	Enok
ווילקאמיר	Ukmergė
רשימה:פיזיקער	Lista över fysiker
לערי קינג	Larry King
געשעפט	Butik
עסן	Ätande
לאנדאנער בארא פון הארינגיי	London Borough of Haringey
שמעון דובנאוו	Simon Dubnov
שפינדל	Slända (textil)
לאנדאנער בארא פון האונסלא	London Borough of Hounslow
שכם	Nablus
שטאף	Material
שמשון הגיבור	Simson
גלעד שליט	Gilad Shalit
סעגוויי	Segway
היטש	Liftning
לעטיסיע	Leticia
דראמאטורג	Dramatiker
לאנדאנער בארא פון לואישעם	London Borough of Lewisham
לאנדאנער בארא פון העווערינג	London Borough of Havering
עטיאפישער קאלענדאר	Etiopiska kalendern
פידעל ראמאס	Fidel Ramos
מוזיקאלישע טרופע	Musikgrupp
שוים	Skum
קאפל	Kippa
הר חרמון	Hermon
דזשערי סיינפעלד	Jerry Seinfeld
לוי	Levi
שטים בענדער	Stämläppar
ווייסוויידל הערש	Vitsvanshjort
יצחק פערלמאן	Itzhak Perlman
דאקלאנדס לייכטע באן	Docklands Light Railway
ריבניץ	Rîbnița
גייטסהעד	Gateshead
טיין	Tyne
נביאים	Profeterna
כסלו	Kislev
הארץ (צייטונג)	Haaretz
אדלערפיש	Havsgösfiskar
דונאם	Dunam
סעקולאריזם	Sekularism
ראמזאן קאדיראוו	Ramzan Kadyrov
אראקל	Orakel
תמוז	Tammuz (månad)
טבת	Tevet
Sky News	Sky News
דעיוויד לעטערמאן	David Letterman
דער ניו יארקער	The New Yorker
זשאן עדווארדס	John Edwards (politiker)
זעלבסטמארד אטאקע	Självmordsattack
עלעקטרא	Electro
טשעסטער נימיץ	Chester W. Nimitz
אמעריקאנער מוזיי פון נאטירלעכער היסטאריע	American Museum of Natural History
ווילסאן	Wilson
לארענס סטערן	Laurence Sterne
איבונגען	Träning
פאול וואלפאוויטש	Paul Wolfowitz
ריימאנד קארווער	Raymond Carver
קינגס קראס באן סטאנציע	King's Cross station
דארף מענטשן	Village People
עמא בונטאן	Emma Bunton
גוגל ווידעא	Google Videos
קריגס פירער	Krigsherre
טייוול אינזל	Djävulsön
גוגל אנאליטיקס	Google Analytics
רעכטס און לינקס פארקער	Höger- och vänstertrafik
דיגיטאלישע אונטערשריפט	Digital signatur
אנגון	Anggun
רמלה	Ramle
סופיט	Innertak
לאנדישער אויטאנאמישער אוניווערסיטעט פון מעקסיקא	Universidad Nacional Autónoma de México
ליסטע פון אייראפעישע לענדער לויטן שטח	Lista över Europas länder i storleksordning
טשערעפאכע	Sköldpaddor
Microsoft Exchange Server	Microsoft Exchange Server
בית"ר ירושלים	Beitar Jerusalem
מכבי תל אביב	Maccabi Tel Aviv FC
ווייסבוך	Vitbok (skrift)
גסיסה	Hjärndöd
סנדק	Fadder
מין	Sex (olika betydelser)
VOA	Voice of America
אונטערארעם	Underarm
שאפונג	Skapelse
ישראלדיקער ספארטלער אומקום ביי דער מינכן אלימפיאדע	Münchenmassakern
שרה זילבערמאן	Sarah Silverman
אקט אף יוניאן	Unionsakt
חם	Ham
מלכות ישראל	Kungariket Israel
דעיל קארנעגי	Dale Carnegie
גראד (נומער)	Jämna och udda tal
געלע זשורנאליזם	Guljournalism
אוניווערסיטעט פון טשילע	Universidad de Chile
מעטרישע סיסטעם	Metersystemet
יוני 2007	Juni 2007
בעני דעפארטמענט	Beni
סעמינאר	Teologiskt seminarium
יולי 2006	Juli 2006
פעברואר 2007	Februari 2007
מערץ 2009	Mars 2009
קאטשאבאמבא דעפארטמענט	Cochabamba (departement)
טאריכא דעפארטמענט	Tarija (departement)
פעני	Penny
באנגאר	Bangor
ישראל (באדייטן)	Israel (olika betydelser)
ניאוף	Hor
מערץ 2007	Mars 2007
האדזש	Hajj
בראדוויי טעאטער	Broadway (teater)
סאנטא קרוז (דעפארטמענט אין באליוויע)	Santa Cruz (departement)
טשוקיסאקא דעפארטמענט	Chuquisaca
פאנדא דעפארטמענט	Pando
עפיגלאטיס	Struplock
נאוועמבער 2006	November 2006
אפריל 2007	April 2007
מײַ 2007	Maj 2007
אחאב	Achav
קעלצער פאגראם	Pogromen i Kielce
יוני 2006	Juni 2006
פאטאסי דעפארטמענט	Potosí (departement)
שלום עליכם (שרייבער)	Sholem Aleichem
על אריש	Al-Arish
אמעריקאנער חורבן אייראפע מוזיי	United States Holocaust Memorial Museum
90 (נומער)	90 (tal)
שלמה אבן גבירול	Salomo ben Jehuda ibn Gabirol
דייוויד דער צווייטער, מלך פון שאטלאנד	David II av Skottland
מאקעווע	Makó
שלומבערגערא	Julkaktussläktet
מן	Manna
לידא	Lida, Vitryssland
קאטשקע (מאסקאווי)	Myskand
קעגן לבנון בערג	Antilibanon
קאוואדא דער ערשטער	Kavadh I
ארקילאוס	Herodes Archelaos
חזקיהו	Hiskia
קאמיקער	Komiker
וואַך	Vakenhet
מזוזה	Mezuza
שטודיע	Studio (olika betydelser)
מאטערסדארף	Mattersburg
רויטע ארמיי	Röda armén
האלאווין	Halloween
הגנה	Haganah
לאגער (ביר)	Lageröl
קרימער מלחמה	Krimkriget
מעטריקע	Folkbokföring
פארע	Ånga
ייווא	YIVO
גראזשניידער	Gräsklippare
קאפירעכט	Upphovsrätt
ניוגראונדס	Newgrounds
סאדע וואסער	Bordsvatten
מצווה	Mitzva
C-base	C-base
חוה אלבערשטיין	Chava Alberstein
ירדנה ארזי	Yardena Arazi
העטהער מיללס	Heather Mills
שירי מיימון	Shiri Maimon
שלומציון המלכה	Salome Alexandra
ען קאלטער	Ann Coulter
באטעריע	Batteri
ארבעט	Arbete
טעלעמארקעטינג	Telefonförsäljning
דאן ריקלס	Don Rickles
לאנדאנער זאא	London Zoo
דיג	Digg
אברהם אבן עזרא	Abraham ibn Ezra
אויגוסט 2006	Augusti 2006
קאלטקייט	Kyla
בת שבע	Batseba
פרעסע קאנפערענץ	Presskonferens
אפריל 2006	April 2006
יאסוהירא יאמאשיטא	Yasuhiro Yamashita
לא פאז (דעפארטמענט אין באליוויע)	La Paz (departement)
סוספענדירונג	Fjädringssystem
ברעך-נוס	Rävkaketräd
מארטיני	Dry Martini
דער עניאגראם פון דער פערזענלעכקייט	Personlighetsenneagrammet
אר קעלי	R. Kelly
בר כוכבא	Simon bar Kokhba
פראטעסט	Protest
אבים	Aviam
דעזש	Dej (stad)
פאלם OS	Palm OS
התבודדות	Ensamhet
קייסער סאלאט	Caesarsallad
מאסאווע	Massawa
גאנצע ליקוי חמה פונעם 22סטן יולי 2009	Solförmörkelsen 22 juli 2009
פאל ראד	Paul Rudd
לייסיק	LASIK
ווילנער גאון	Elijah ben Solomon
מיעט פעקינג דיסטריקט	Meatpacking District
געארג דער זעקסטער	Georg VI av Storbritannien
סאציעלע פאביע	Social fobi
43 (נומער)	43 (tal)
יהודה	Juda
יעדוואבנע	Jedwabne
בוסק	Busk
טשעט	Chatt
אגנאסטיציזם	Agnosticism
שונא	Fiendskap
יעקב אבינו	Jakob (patriark)
לח"י	Sternligan
חיים הערצאג	Chaim Herzog
איניגא דזשאנס	Inigo Jones
אסימא	ASIMO
פרעד טאמפסאן	Fred Thompson
ריטא	Rita Yahan-Farouz
בילי קאנאלי	Billy Connolly
זלמן שזר	Zalman Shazar
יהודה הלוי	Yehuda Halevi
שבתי צבי	Sabbatai Zvi
טעדי קאלעק	Teddy Kollek
בלוט מאראנץ	Blodapelsin
אבא אבן	Abba Eban
טאכטער	Dotter
אנאנימיטעט	Anonymitet
פארצוימטע באוועגונג	Stop motion
אוניווערסיטעט פון סאלאמאנקע	Universitetet i Salamanca
דעאדאראנט	Deodorant
פלאן	Planering
סאפארא	Soforasläktet
קראקעווער געטא	Krakóws getto
אפאסטיל	Apostille
דייוויד קוק	David Cook
מתתיהו מיללער	Matisyahu
רבן גמליאל הזקן	Gamaliel
דזשעסי דזשעקסאן	Jesse Jackson
דעניס קוסיניטש	Dennis Kucinich
גלען בעק	Glenn Beck
שאגי	Shaggy
רבי עקיבא	Akiba ben Josef
ביל אריילי	Bill O'Reilly
סעמי שילט	Semmy Schilt
קארל ראוו	Karl Rove
שמעון וויזענטאל צענטער	Simon Wiesenthal-centret
יצחק נבון	Yitzhak Navon
RSVP	Om svar anhålles
טשיאנאפודזשי מיצוגו	Chiyonofuji Mitsugu
מאיר לענסקי	Meyer Lansky
מירענדע ווארענונג	Mirandavarningen
עיִן תחת עיִן	Talionprincipen
אחזיהו (מלך יהודה)	Achasja (kung i Juda)
יהורם (מלך יהודה)	Joram
עוזיהו	Ussia
ירבעם בן נבט	Jerobeam
יאשיהו	Josia
יהואש (מלך יהודה)	Joash
אמציה	Amasja
אסא	Asa (kung)
אמון	Amon (kung)
דזשעף גארדאן	Jeff Gordon
וואסילי גראסמאן	Vasilij Grossman
באשיר זשומייעל	Bashir Gemayel
קאמאדיטי	Handelsvara
זילבער (קאליר)	Silver (färg)
יגאל אלון	Yigal Allon
אלה	Ela
יגאל עמיר	Yigal Amir
יהויקים	Kung Jojakim
הושע בן אלה	Hosea (kung)
יהויכין	Jojakin
טייהא קאקי	Taihō Kōki
בעל שם טוב	Israel ben Eliezer
קהאליד שייך מוכאמעד	Khalid Sheikh Mohammed
ראש לימבאו	Rush Limbaugh
באב דאול	Bob Dole
על פרענקען	Al Franken
דן חלוץ	Dan Halutz
מייקל דוקאקיס	Michael Dukakis
אלכסנדר ינאי	Alexander Jannaeus
קריסטאפער דאד	Christopher Dodd
נתן הנביא	Natan
אלעקס זשאונס	Alex Jones
בערי גאלדוואטער	Barry Goldwater
חיים טאפאל	Chaim Topol
שעלדאן איידלסאהן	Sheldon Adelson
בועז מעודה	Boaz Mauda
הלל הזקן	Hillel
פראכט	Last (transport)
גוש דן	Gush Dan
קסרי	Caesarea Maritima
יאנואר 2006	Januari 2006
שעדליץ	Siedlce
זאב זשאבאטינסקי	Zeev Jabotinsky
לאנדאנער בארא פון סאטן	London Borough of Sutton
צאפ	Fläta
אפשוואכן קריג	Utnötningskriget
עקאנאמיע פון דעם פאראייניגטן קעניגרייך	Storbritanniens ekonomi
אינטעריגאציע	Förhör
שלאכט פון אאכן	Slaget vid Aachen
אגענטור	Myndighet
שערן	Frisyr
לאדזשער געטא	Łódź getto
קעזמארק	Kežmarok
האלדזן	Kram
אמין זשומייעל	Amine Gemayel
מערץ 2006	Mars 2006
פעברואר 2006	Februari 2006
דעל.איס.אס	Delicious
געלע לאטע	Judestjärnan
קישקונהאלאש	Kiskunhalas
אברהם בים	Abraham Beame
ראצפערט	Újfehértó
פאראמעדיקער	Paramedicin
אברהם זכות	Abraham Zacuto
קבר	Begravning
אויק פארק (אילינויס)	Oak Park
געמיט	Humör
פלוראליזם	Pluralism (politisk filosofi)
טעכניאן	Technion
לבנון בארג	Libanonberget
זשאנסאן & זשאנסאן	Johnson & Johnson
קאסאם	Qassam-raket
סיגעט	Sighetu Marmației
געזונט פארזיכערונג	Sjukförsäkring
אבו האמזא	Abu Hamza al-Masri
ראיעל קענעדיען מאונטעד פאליציי	Kanadas ridande polis
M4a	MP4
יהואחז	Joahas
ראדני קינג	Rodney King
טאנגא	Tango
מוילאייזל הערש	Svartsvanshjort
אר"י הקדוש	Isaac Luria
אדא	Ada, Serbien
אדמו"ר	Rebbe
מתתיהו אנטיגונוס דער צווייטער	Antigonos II Mattathias
שאול מופז	Shaul Mofaz
מענדעלע מוכר ספרים	Schalom Jakob Abramovitj
יגאל ידין	Yigael Yadin
חיים נחמן ביאליק	Chajim Nachman Bialik
מוכאמאד סאאיד אל-סאהאף	Mohammed Said as-Sahaf
אדוניהו	Adonia
מישעל אאון	Michel Aoun
מהר"ל מפראג	Judah Loew ben Bezalel
פעדרא דע בעטאנקור	Pedro de Betancur
ווויטעך טוקא	Vojtech Tuka
שליוואוויץ	Slivovits
יו-עס קאסטומס ענד בארדער פראטעקשן	United States Customs and Border Protection
נייטרע טייך	Nitra (flod)
ארדשיר	Ardashir I Papagan
מעמאריעל דעי	Memorial Day
עמלק	Amalek
אקוואמארין (קאליר)	Akvamarin (färg)
בייבל קריטיק	Textkritisk bibelforskning
טשיטאגאנג	Chittagong
דרעטל	Häftklammer
מעמד הר סיני	Sinaiberget
וויליאם באקלי	William F. Buckley, Jr.
אתגר קרת	Etgar Keret
אדווערב	Adverb
דאדולא	Dadullah Akhund
שב"כ	Shin Bet
עמאנציפאציע	Emancipation
איגאר פאווליוק	Ihor Pavljuk
אחד העם	Ahad Ha'am
זשאק ליפשיץ	Jacques Lipchitz
על שארפטאן	Al Sharpton
ברוך גאלדשטיין	Baruch Goldstein
וואליד זשומבלאט	Walid Jumblatt
שלום אש	Sholem Asch
לואיס ליבי	Lewis Libby
דזשאן קארזיין	Jon Corzine
מסורה (טעקסט)	Masoretiska bibeltexten
ארגאניש עסן	Ekologisk mat
שבועה	Ed (juridik)
סקאטש וויסקי	Skotsk whisky
כראניש	Kronisk sjukdom
ארטאדאקס	Ortodoxi
שאפליפטינג	Snatteri
קאבל אינטערנעט	Kabelmodem
קאנסטרוקציע	Byggnadskonstruktion
פלמ"ח	Palmach
מאזיר	Mazyr
פויקער	Trumslagare
היט ענד ראן	Obehörigt avvikande från olycksplats
תלמוד ירושלמי	Talmud jerushalmi
װיקיפּעדיע:נאכפאלג ליסטע	Wikipedia:Bevakningslistan
װיקיפּעדיע:באוועגן	Wikipedia:Flytta sida
אגודת ישראל	Agudat Yisrael
פערספעקטיוו	Förkortning (måleri)
סקול בארד	Skolstyrelse
האלבקיילעך	Jordens halvklot
סובסטאנץ	Substance
לאפעראמיד	Loperamid
עסצילאטאפראם	Escitalopram
יצחק לייבוש פרץ	Isaac Leib Peretz
ReadyBoost	Readyboost
10000 (נומער)	10000 (tal)
וויאלעט	Violett
ראזע	Rosa (färg)
אפער וועסט סייד	Upper West Side
נצרת	Nasaret
שמחת תורה	Simchat Torah
27 (נומער)	27 (tal)
35 (נומער)	35 (tal)
64 (נומער)	64 (tal)
99 (נומער)	99 (tal)
אפער איסט סייד	Upper East Side
רובי ריוולין	Reuven Rivlin
הפועל חיפה	Hapoel Haifa FC
ליטאני טייך	Litani
מיני ישראל	Mini Israel
ארפכשד	Arpakshad
זיסקייט	Sötma
מאיא פּליסעצקאיא	Maja Plisetskaja
גאלאנטא	Galanta
בענדין	Będzin
סאהא	SoHo
Cbc	Canadian Broadcasting Corporation
ווייט פלעינס, ניו יארק	White Plains, New York
נאריש און נארישער	Dum & dummare
סינדי שעהין	Cindy Sheehan
עתליה	Atalja
ברעזנא	Brezno
עיפאק	American Israel Public Affairs Committee
היסטאריע פון טעכנאלאגיע	Teknikhistoria
הימל ליניע	Stadssiluett
עמאקא	Amoco
קאנווענץ פאר קינדער-רעכט	Barnkonventionen
שרית חדד	Sarit Hadad
Thalys	Thalys
שלמה מיכאלס	Solomon Mikhoels
פיער זשומייעל	Pierre Gemayel
יעקב דורי	Yaakov Dori
עד קאטש	Ed Koch
סאעמו טאיאדא	Soemu Toyoda
דייוויד דינקינס	David Dinkins
יוסף קארו	Josef Caro
חיים בר-לב	Haim Bar-Lev
דוד האלבערשטאם (שרייבער)	David Halberstam
נחמן מברסלב	Nachman av Breslov
לענא העלמסלי	Leona Helmsley
רודאלף ווערבע	Rudolf Vrba
הרוגי מלכות פונעם ראטנפארבאנד	De mördade poeternas natt
פראסטיץ	Prostějov
טאמי לאפיד	Josef Lapid
זשעק אבראמאף	Jack Abramoff
אידענטיטעט גניבות	Identitetsstöld
חדרה	Hadera
דע בירס	De Beers
סידור	Siddur
סייף	Kassaskåp
עמיר פרץ	Amir Peretz
מאקס נארדוי	Max Nordau
השכלה	Haskala
אנטיק	Antikvitet
סטאק מארקעט	Aktiemarknad
קאנקורענץ	Tävling
פסיכאלאגיע פון מוזיק	Musikpsykologi
קערפער שפראך	Kroppsspråk
די לוסטיגע אלמנה	Glada änkan
קאריטיבע פוטבאל גרופע	Coritiba Foot Ball Club
אמסטערדאם (באדייטן)	Amsterdam (olika betydelser)
אמסטערדאם (שטאט), ניו יארק	Amsterdam, New York
הידראגען עקאנאמיע	Väteekonomi
מערב וועלט	Västerländsk kultur
רוקן ביין	Ryggrad
אלבאם	Musikalbum
ראציאנאליזם	Rationalism
Windows 98	Windows 98
פּלאַנאָיסע	Planoise
גווען סטעפעני	Gwen Stefani
זשאנער	Genre
קעלי קלערקסאן	Kelly Clarkson
וואל-מארט	Walmart
סוניס	Sunni
פאלא פערנאנדעס	Paula Fernandes
Windows 2000	Windows 2000
שינדלערס ליסטע	Schindler's List
מיסטער בין	Mr. Bean
אויטאנאמיע	Autonomi
נאציאנאלער הימען פון טשילע	Himno nacional de Chile
Windows Me	Windows ME
סקינהעד	Skinnskalle
אוואירו	Aveiro
CRM	Customer relationship management
איסטמאן קאדאק	Eastman Kodak
פידלער אויפן דאך	Spelman på taket
דראט-רעקארדירן	Trådspelare
אייער ליקער	Advocaat
טאבעלע	Tabell
רשימה:פרוכט	Lista över frukter
טאמעס און פריינט	Thomas och vännerna
שטילקייט	Tystnad
זשאני וואקער	Johnnie Walker
מעלה אדומים	Ma'ale Adummim
פאלאנגען	Falangistpartiet (Libanon)
עבר	Ever
ווייכביין	Brosk
גוי	Goj
געהיימע דינסט פון די פאראייניגטע שטאטן	United States Secret Service
פראטאפלאנעטארישער דיסק	Protoplanetär skiva
סופר	Sofer
שטריימל	Shtreimel
וועגן מאפע	Färdplanen för fred
אלטער בחור	Ungkarl
היקעמע	Pachyrhizus erosus
גערשטן	Kornsläktet
זאבלאטאוו	Zabolotiv
רי"ף	Isaac Alfasi
טריאו	Palm Treo
איוואן גאל	Yvan Goll
מיידיי	Air Crash Investigation
בלאט שניידער בין	Buksamlarbin
אליגאטאר	Alligatorer
סאפיע (באדייטן)	Sophia
טישטיך	Bordsduk
דאמינעטריקס	Dominatrix
עגלע בענדיקייטע	Eglė Bendikaitė
בערבעין	Bourbon (dryck)
29 (נומער)	29 (tal)
מארך ביין	Benmärg
פלאטילע	Flottilj
20/20 זעהקראפט	Synskärpa
רודאלף קאסטנער	Rudolf Kasztner
ישראל יהושע זינגער	Israel Joshua Singer
שאן הענעטי	Sean Hannity
רעי נעיגין	Ray Nagin
קניידלעך	Kneidlach
וועטשערע	Supé
קלימאקס (געשעניש)	Klimax
מייפל סטארי	Maplestory
באליידיגונג	Förolämpning
טראפיק טיקעט	Felparkeringsavgift
יהונתן אייבעשיץ	Jonathan Eybeschütz
שמואל זיגלבוים	Szmul Zygielbojm
אנטי-פעמיניזם	Antifeminism
מגן דוד אדום	Magen David Adom
כעמישע ענערגיע	Kemisk energi
באזעצונג	Israeliska bosättningar
אנטי ציוניזם	Antisionism
מזל טוב	Mazel tov
תרח	Terach
28 (נומער)	28 (tal)
נאטאליי הארלער	Natalie Horler
כעמיקער	Kemist
הילטאן האטעלס	Hilton Hotels
עד טאונס	Edolphus Towns
באלעסטיגן	Missbruk
38 (נומער)	38 (tal)
האנדל	Handel
פּאַן-אייראפעישער פארבאנד	Paneuropeiska unionen
ראדיא גא גא	Radio Ga Ga
האנד טארמאז	Bromssystem
שטעטל	Shtetl
ראבערט קאטשאריאן	Robert Kotjarjan
אפטייקעריי	Farmaci
זבולן	Sebulon
שידוך	Äktenskapsförmedling
טעיזם	Teism
פראבלעם	Problem
באונטי האנטערס	Prisjägare
פאו'ס געזעץ	Poes lag
שטעלונג	Attityd
הגדה של פסח	Haggada
ראובן	Ruben (Bibeln)
דינער (סעודה)	Bankett
סווינגינג	Swinging
לעבן פארזיכערונג	Livförsäkring
ניו יארק דיילי ניוז	Daily News (New York)
45 (נומער)	45 (tal)
קאני איילענד	Coney Island
שולד	Skuld (etik)
מיישא	Kiskunmajsa
קעטסקילס	Catskillbergen
קאמפאט	Kompott
קארל לוץ	Carl Lutz
מוזיקער	Musiker
גזירת ת"ח ות"ט	Chmelnitskij-upproret
נטורי קרתא	Neturei Karta
קישקעריש	Kiskőrös
בונדיזם	Allmänna judiska Arbetarförbundet för Litauen, Polen och Ryssland
קווינסוויי אונטערגרונט סטאנציע	Queensway (tunnelbanestation)
המן	Haman (Bibeln)
יששכר	Isaskar
הארא	Hora (dans)
אנגעשטעלטער	Anställd
מיטאג	Kvällsmat
קערעסטיר	Bodrogkeresztúr
פריימעריס	Primärval
סדר נשים	Kiddushin
יצחק אבינו	Isak (Bibeln)
קליינווארדיין	Kisvárda
וויסנשאפט מוזיי	Science Museum (London)
הענרי דער זיבעטער פון ענגלאנד	Henrik VII av England
טעלאנגאנע	Telangana
אקספארד צירקוס אונטערגרונט סטאנציע	Oxford Circus (Londons tunnelbana)
בורשטין (קאליר)	Bärnsten (färg)
בערלין זאאלאגישער גארטן באן סטאנציע	Bahnhof Berlin Zoologischer Garten
טראנספארט פאר לאנדאן	Transport for London
אנוש	Enosh
ניקאלשבורג	Mikulov
קינדערטראנספארט	Kindertransport
ניו יארק מעטראפאליטען שטח	New Yorks storstadsregion
אומבאוועגלעכע גיטער	Fastighet
קערפער פלעק	Naevus
ריינקייט	Städning
ברוסט פיין	Bröstsmärta
לאנדאנער בארא פון גריניטש	Royal Borough of Greenwich
מזומן	Kontanter
קעטאלאגיע	Cetologi
1992 לאס אנדזשעלעס ראיאטן	Kravallerna i Los Angeles 1992
ראנאלד לאודער	Ronald Lauder
אדעס רציחה	Massakern i Odessa
עוויאן קאנפערענץ	Éviankonferensen
יעדוואבנער פאגראם	Massakern i Jedwabne
עמנואל רינגלבלום	Emanuel Ringelblum
פאנאר	Paneriai
קוואדראט קילאמעטער	Kvadratkilometer
גליד	Organ
80 (נומער)	80 (tal)
21 (נומער)	21 (tal)
22 (נומער)	22 (tal)
70 (נומער)	70 (tal)
50 (נומער)	50 (tal)
לימפאטישע סיסטעם	Lymfatiska systemet
41 (נומער)	41 (tal)
34 (נומער)	34 (tal)
33 (נומער)	33 (tal)
47 (נומער)	47 (tal)
31 (נומער)	31 (tal)
32 (נומער)	32 (tal)
44 (נומער)	44 (tal)
46 (נומער)	46 (tal)
49 (נומער)	49 (tal)
48 (נומער)	48 (tal)
37 (נומער)	37 (tal)
39 (נומער)	39 (tal)
36 (נומער)	36 (tal)
81 (נומער)	81 (tal)
69 (נומער)	69 (tal)
0.999...	0,999…
200 (נומער)	200 (tal)
מערב דייטשלאנד	Västtyskland
כרמלית (חיפה)	Haifas bergbana
144 (נומער)	144 (tal)
קאסטקא	Costco
121 (נומער)	121 (tal)
196 (נומער)	196 (tal)
169 (נומער)	169 (tal)
סט פאנקראס באן סטאנציע	St Pancras Station
מגילה	Bokrulle
אפמאך פון פאריז (1951)	Fördraget om upprättandet av Europeiska kol- och stålgemenskapen
נארלס בארקלי	Gnarls Barkley
64 באזע	Base64
שותפות	Enkelt bolag
לאשאנץ	Lučenec
כהן	Kohen
לאנדאנער בארא פון סאדארק	London Borough of Southwark
אסטראווצע	Ostrowiec Świętokrzyski
קדיש	Kaddish
משה מאנטיפיארי	Moses Montefiore
טאני סנאו	Tony Snow
מאלטע פערסאן	Malte Persson
רבן יוחנן בן זכאי	Jochanan Ben Sakkai
סאמיר דזשאדזשא	Samir Geagea
פנואל	Penuel
Windows Mail	Windows Mail
ווימבלדאן	Wimbledon, London
אינטימיטעט	Samlevnad
נאנאש	Hajdúnánás
עשרה בטבת	10 tevet
וואלקאוויסק	Volkovysk
אז	Oz (TV-serie)
נירן איבערפלאנץ	Njurtransplantation
מתנגדים	Mitnagdim
תלמוד תורה	Cheder
לאַכערייַקע	Sketch
אטוואצק	Otwock
װיקיפּעדיע:מיטא	Wikipedia:Meta
170 (נומער)	170 (tal)
פישטראן	Fiskleverolja
דאראג	Dorog
ט"ו בשבט	Tu Bishvat
דריטע שינע	Strömskena
ערבות	Borgen (juridik)
ספירת העומר	Sefirat omer
טאפלישאן	Topoľčany
מארטין לוטער קינג דיי	Martin Luther King-dagen
ניו יארק מאראטאן	New York City Marathon
דאקטאר (פילאסאפיע)	Filosofie doktor
לידער שרייבער	Låtskrivare
אנאנא	Annona atemoya
טראדיציע	Masoreter
Directory Service	Katalogtjänst
אויטאנאמישע רעפובליק פון קרים	Autonoma republiken Krim
דיים	Dime
רשימה:מאלערס	Wikipedia:Projekt konst/Lista över konstnärer
אגרת ירמיהו	Jeremias brev
אגער	Hingst
גערטנעריי	Trädgårdsmästare
יזרעאל טאל	Jezreelslätten
עלקוש	Olkusz
טרייבעקע	Tribeca
פראגראם	Program
פאות	Peyos
דרום אזיע	Sydasien
וויליאמסבורג, ברוקלין	Williamsburg, Brooklyn
זונפאנעל	Solpanel
רעכט	Rättighet
קאפאוואר	Kapuvár
פירמע	Företag
מארבל ארטש אונטערגרונט סטאנציע	Marble Arch (tunnelbanestation)
קרעיגסליסט	Craigslist
באלמאז אויוואראש	Balmazújváros
דעפארטמענט פון שטאט פון די פאראייניגטע שטאטן	USA:s utrikesdepartement
חלה	Barkis
ברעזשאן	Berezjany
וואטערלו באן סטאנציע	Waterloo Station
סאבאטאזש (פילם)	Sabotage (film)
ליווערפול סטריט סטאנציע	Liverpool Street station
בירזש	Biržai
באנק-מאנומענט באן סטאנציע	Bank & Monument (Londons tunnelbana)
גארדען סטעיט פארקוועי	Garden State Parkway
42 (נומער)	42 (tal)
בער סטערנס	Bear Stearns
רעספיראטאר (מעדיצין)	Respirator
געאמעטרישע פארעם	Geometrisk figur
בלינצע	Blinier
גאניק	Skärmtak
שווארצע	Svart (hudfärg)
ליריקער	Sångtextförfattare
שלחן ערוך	Shulchan aruch
האליפאקס	Halifax, West Yorkshire
קילאמעטער	Kilometer
Windows Sidebar	Windows sidpanel
טעמע	Subjekt (filosofi)
בית דין	Beth din
יודענראט	Judenrat
באניהאד	Bonyhád
הייזעריג	Heshet
קאאליציע	Koalitionsregering
גאלער	Aladåb
זשורי	Jury
גימטריא	Gematri
קאלאנסקאפי	Koloskopi
קארפאטשיא	Carpaccio
לבן	Laban (Bibeln)
געצנדינעריי	Avgud
גוגעל גרופעס	Google Grupper
קלאסיק	Klassisk
קאנסיסטואר	Konsistorium (Romersk-katolska kyrkan)
Windows Live	Windows Live
מאדקאן	Madcon
בריטישע מענטשן	Britter
דעטעקטיוו	Kriminalpolis
צענטראל-הייצונג	Centralvärme
בייזש	Beige
ספר היובלים	Jubileerboken
קינן	Kenan
רמת השרון	Ramat HaSharon
צוגאנדע	Cigánd
פאלק (פויגל)	Hökar
די זיבן מצוות בני נח	Noakidiska lagarna
לעיבער דעי	Labor Day
קידוש	Kiddush
ברית מילה	Berit mila
אינדיק	Tamkalkon
קאפטער	Huva
גד	Gad
ליל הסדר	Seder
Spanning tree protocol	Spanning tree protocol
קונה	Kund
עוף	Galloanserae
פאלם	Palm (företag)
טיף פרעגלען	Frityr
קאוואטשהאז	Mezőkovácsháza
טשענגער	Csenger
קאסקאדא	Cascada
שחיטה	Skäktning (slaktmetod)
דיעטע	Bantning
סלאנים	Slonim
קייטנעס	Caithness
ברכת המזון	Birkat hammazon
טשיינעטאון	Chinatown, Manhattan
השגחה פרטית	Försyn
עדיטאריעל	Ledarsida
גרופע	Grupp (sociologi)
גרופע טעאריע	Gruppteori
די טשיקאַווע אינצידענט פון דער הונט אין דער נאַכט-צייַט	Den besynnerliga händelsen med hunden om natten
קעמפ	Barnkoloni
רויז (אינפעקציע)	Cellulit
געיעג	Racing
פײזשאאדא	Feijoada
אקערן	Jordbearbetning
שלעפע באבע	Blindbock
באנד סטריט אונטערגרונט סטאנציע	Bond Street (tunnelbanestation)
ברכה	Bracha
רעקרוטירן	Rekrytering
הייפיש אטאקעס	Hajattack
ש"ס פארטיי	Shas
טראנסניסטריע	Transnistrien
נעטפליקס	Netflix
עירוני קריית שמונה	Hapoel Ironi Kiryat Shmona FC
קאנטערטעראריזם	Kontraterrorism
דינאוו	Dynów
טאמאשאוו	Tomaszów Lubelski
הילף:אינהאלט	Wikipedia:Hjälp
וואונדער פרוכט	Synsepalum dulcificum
זשומייעל	Gemayel
דגל התורה	Degel HaTorah
כלב בן יפונה	Kaleb
סיירת מטכל	Sayeret Matkal
וואלט קאר	Chevrolet Volt
ירד	Jered
צד"ל	Sydlibanesiska armén
דאקטער ספעציאליסט	Specialiseringstjänstgöring
צדקה	Allmosa
פוסק	Posek
עמענטאל	Emmentaler
דריידל	Dreidel
שמיני עצרת	Shemini atzeret
לארן	Larne
אבאזשור	Lampskärm
רעיסינג ביציקל	Racercykel
פארטי קוועבעקווא	Parti Québécois
מנין	Minjan
צינגאלע	Joint
נאציאנאלע ביבליאטעק פון שוועדן	Kungliga biblioteket
גראגער	Harskramla
ראגאטשאוו	Rahatjoŭ
קאברין	Kobrin
דזשין	Gin
שלעגער	Schlager
אראסטאטיקע	Aerostatik
יידישע היסטאריע	Judendomens historia
סעפטעמבער 2006	September 2006
כעמיש בית הכסא	Kemisk toalett
אהבת ה'	Guds kärlek
גיארגי אוגולאווא	Giorgi Ugulava
אלבערט מאל	Albert Mol
נערוון בראך	Nervöst sammanbrott
פארמל	Formel
רבינו גרשום	Gerschom ben Jehuda
שלמה בובער	Salomon Buber
רשב"א	Salomo ben Abraham Adret
דעניס פרעגער	Dennis Prager
דזשערעמיא רייט	Jeremiah Wright
יצחק הערצאג	Isaac Herzog
אדער	Blodkärl
שווארצע שאכטל	Svarta lådan
C-SPAN	C-SPAN
ווראהאוויצע	Vrahovice
CNBC	CNBC
מאגן	Magsäck
קאנאל סטריט	Canal Street
העטראסעקסואליטעט	Heterosexualitet
וועסט עדמאנטאן מאלל	West Edmonton Mall
דרום קענזינגטאן	South Kensington
דזשונדאלא	Folkets motståndsrörelse i Iran
ישיבה אוניווערסיטעט	Yeshiva University
פראספעקט פארק	Prospect Park
פינאנציעלער דיסטריקט	Finansdistriktet, Manhattan
לאנג איילענד אייז טיי	Long Island Iced Tea
נסיון	Frestelse
טריבונע נאמען	Artistnamn
פלאשינג, ניו יארק	Flushing, Queens
חמץ	Chametz
ארורא דעפארטמענט	Oruro (departement)
ביליאנער	Miljardär
דעלפין מעשה	Dolphin Tale
חזנות	Chazzan
טשעלסי	Chelsea, Manhattan
פרישוואסער פיש	Sötvattensfisk
נירמאדע	Nyírmada
עגיפטישע באוואפנטע קרעפטן	Egyptiska väpnade styrkor
מיליאנער	Miljonär
גענעראל פארזאמלונג	Årsstämma
בענזין אלטערנאטיוון	Alternativa drivmedel
פעטענהאז	Petneháza
עליזאבעט טיודאר	Elisabet Tudor
טאש	Nyírtass
אוב	Seans
אנדרוגינוס	Intersexualism
קליאטשע	Sto
גארטן	Trädgård
אוואד	Boskapsbroms
עליסא	Elissa
קאלינג קארד	Telefonkort
טריכאם	Trikom
עשרת השבטים	Israels tio försvunna stammar
דעסיידיאוס	Lövfällande
געטריישאפט	Lojalitet
גרינע ליניע	Gröna linjen (Israel)
אבנר בן נר	Avner
פאנצערגלאז	Skottsäkert glas
רעפארם יידנטום	Reformjudendom
זאל	Farstu
שייטת 13	Shayetet 13
מורה נבוכים	Moré nebuchim
שטאט אוניווערסיטעט פון ניו יארק	State University of New York
מעדיקעיד	Medicaid
רעפובליקאנער פארטיי פון ארמעניע	Armeniens republikanska parti
לבנון קרעפטן	Al Qouwat al Lubnania
פאפיר טייגער	Papperstiger
נאכט העמד	Nattlinne
געפילטע פיש	Gefilte fisch
ישראל מיליטערישע אינדוסטריעס	Israel Military Industries
קארפאטארוס	Transkarpatien
קוואדער	Quarter
הייליגקייט	Helig
אָראַ	Aura
פאליסי	Policy
בעדפארד סטייוועסענט	Bedford-Stuyvesant
אינגבער-וואסער	Ginger Ale
MLB	Major League Baseball
מאפלער	Ljuddämpare (motorfordon)
עיר דוד	Davids stad
דעלאטין	Deljatyn
דעלטע (באדייטן)	Delta (olika betydelser)
סליחות	Selichot
װיקיפּעדיע:אמבאסאדע	Wikipedia:Ambassaden
עמבער אלערט	AMBER Alert
דעצעמבער 2006	December 2006
קליינע שווארצע בוך	Alla hans ex
ארום די וועלט אין 80 טעג	Jorden runt på 80 dagar
דייטשע לענדער	Tysklands förbundsländer
צעטיילונג	Division (matematik)
ראציאנאלע צאל	Rationella tal
פליפעלד	Flygplats
ספין	Spin (PR)
מסכת נזיר	Nasir
יציאת מצרים	Uttåget ur Egypten
דראדזש רעפארט	Drudge Report
מייקל סעוועזש	Michael Savage
שומרון	Samarien
עמערגענץ צימער	Akutmottagning
אנקלאגע	Juridisk process
קאמפיוטער נעצווערק	Datornätverk
כל ישראל חברים	Alliance Israélite Universelle
דערציילונג	Berättelse
איינגאס	Bukt
מונינג	Moona
זעקל	Väska
טוקאן	Tukaner
סטאטוס	Status
ספא	Spa
מיכל	Mikal
תוספתא	Tosefta
פארזעצונג	Följetong
פרירונג ברי	Köldskada
אַגנעס מאָניקאַ	Agnes Monica
מערהייט	Kvalificerad majoritet
קעש ביי דעליווערי	Postförskott
וואשינגטאן הייטס	Washington Heights
אחשוורוש	Ahasverus (Bibeln)
קינג דייוויד האטעל	Hotel King David
יעקב בן אשר	Jakob ben Ascher
ראסל סקווער אונטערגרונט סטאנציע	Russell Square (Londons tunnelbana)
עוואלואציע	Utvärdering
עקסאדוס	S/S Exodus
300 (נומער)	300 (tal)
מאלאדערא אינסאנאביליס	Maladera insanabilis
שמעון שמואל פרוג	Semjon Frug
סאלאמאן שעכטער	Solomon Schechter
שמואל דוד לוצאטו	Samuel David Luzzatto
ארעסט	Gripande
קאַטעגאָריע:מענער	Kategori:Män
קאַטעגאָריע:דייטשלאנד	Kategori:Tyskland
קאַטעגאָריע:איטאליע	Kategori:Italien
קאַטעגאָריע:פאראייניגטע שטאטן	Kategori:USA
קאַטעגאָריע:רוסלאנד	Kategori:Ryssland
קאַטעגאָריע:קאנאדע	Kategori:Kanada
קאַטעגאָריע:פאראייניקטע קעניגרייך	Kategori:Storbritannien
קאַטעגאָריע:שפאניע	Kategori:Spanien
קאַטעגאָריע:יאפאן	Kategori:Japan
קאַטעגאָריע:אויסטראליע	Kategori:Australien
קאַטעגאָריע:מעקסיקא	Kategori:Mexiko
קאַטעגאָריע:אינדיע	Kategori:Indien
קאַטעגאָריע:ישראל	Kategori:Israel
קאַטעגאָריע:וואטיקאן	Kategori:Vatikanstaten
קאַטעגאָריע:טערקיי	Kategori:Turkiet
קאַטעגאָריע:דרום אפריקע	Kategori:Sydafrika
קאַטעגאָריע:עגיפטן	Kategori:Egypten
קאַטעגאָריע:איראן	Kategori:Iran
קאַטעגאָריע:ניו זילאנד	Kategori:Nya Zeeland
קאַטעגאָריע:ארגענטינע	Kategori:Argentina
ערליכקייט	Fromhet
קאסערנע	Tyghus
פדיון הבן	Pidjon habben
הייסע טאדי	Toddy
ניוקאסטל	Newcastle upon Tyne
פארשפרעכונג	Löfte
לייוונט	Linne (textil)
לאנקאסטער גייט אונטערגרונט סטאנציע	Lancaster Gate (tunnelbanestation)
טאטנהאם קארט ראד אונטערגרונט סטאנציע	Tottenham Court Road (Londons tunnelbana)
האבארן אונטערגרונט סטאנציע	Holborn (Londons tunnelbana)
רוה טאג	Helgdag
מפא"י	Mapai
קאַטעגאָריע:אפגאניסטאן	Kategori:Afghanistan
קאַטעגאָריע:עסטרייך	Kategori:Österrike
קאַטעגאָריע:קובא	Kategori:Kuba
קאַטעגאָריע:עטיאפיע	Kategori:Etiopien
קאַטעגאָריע:איראק	Kategori:Irak
קאַטעגאָריע:ניגעריע	Kategori:Nigeria
קאַטעגאָריע:פאקיסטאן	Kategori:Pakistan
קאַטעגאָריע:פוילן	Kategori:Polen
קאַטעגאָריע:פארטוגאל	Kategori:Portugal
קאַטעגאָריע:סינגאפור	Kategori:Singapore
קאַטעגאָריע:שווייץ	Kategori:Schweiz
קאַטעגאָריע:טאנזאניע	Kategori:Tanzania
קאַטעגאָריע:אוקראינע	Kategori:Ukraina
קאַטעגאָריע:וויעטנאם	Kategori:Vietnam
קאַטעגאָריע:זויגערס	Kategori:Däggdjur
קאַטעגאָריע:רעפטילן	Kategori:Kräldjur
קאַטעגאָריע:אמפיביעס	Kategori:Groddjur
קאַטעגאָריע:פויגלען	Kategori:Fåglar
קאַטעגאָריע:פאנגי	Kategori:Svampar
קאַטעגאָריע:באקטעריעס	Kategori:Bakterier
קאַטעגאָריע:ווירוסן	Kategori:Virus
קאַטעגאָריע:פלאנצן	Kategori:Växter
קאַטעגאָריע:פיזיק	Kategori:Fysik
קאַטעגאָריע:נאטור-וויסנשאפטן	Kategori:Naturvetenskap
קאַטעגאָריע:ביאלאגיע	Kategori:Biologi
קאַטעגאָריע:כעמיע	Kategori:Kemi
קאַטעגאָריע:ערד וויסנשאפטן	Kategori:Geovetenskap
קאַטעגאָריע:היסטאריע	Kategori:Historia
קאַטעגאָריע:געאגראפיע	Kategori:Geografi
קאַטעגאָריע:געזעלשאפט	Kategori:Samhälle
קאַטעגאָריע:רעליגיע	Kategori:Religion
קאַטעגאָריע:ספארט	Kategori:Sport
קאַטעגאָריע:וויסנשאפט	Kategori:Vetenskap
קאַטעגאָריע:פאראייניגטע פעלקער	Kategori:Förenta nationerna
קאַטעגאָריע:אייראפעישער פארבאנד	Kategori:Europeiska unionen
קאַטעגאָריע:פילם	Kategori:Film
קאַטעגאָריע:וועלט ירושה ערטער	Kategori:Världsarv
קאַטעגאָריע:געביידעס	Kategori:Byggnader
קאַטעגאָריע:קאמוניקאציע	Kategori:Kommunikation
קאַטעגאָריע:ערד	Kategori:Jorden
קאַטעגאָריע:אינפארמאציע	Kategori:Information
יהדות התורה	Torahpartiet
נדה	Nidda (judendom)
טישו פאפיר	Mjukpapper
היסטאריע פון דער וועלט, ערשטער טייל	Det våras för världshistorien del 1
מיסירלו	Misirlou
לאוער איסט סייד	Lower East Side
המן טאש	Hamantaschen
טעלעגראם	Telegram
באלאנץ	Balanssinne
גיי מרחץ	Bastuklubb
400 (נומער)	400 (tal)
אומזינסט	Gratis
פאפריקע	Paprika
באריום ענימע	Coloningjutning
אטשאקאטשי	Achacachi
טוינעץ	Drosera capensis
רפואה	Läkning
פאליציי אויטא געיעג	Biljakt
יאנואר 2007	Januari 2007
דארא גובערניע	Dar'a (provins)
מאל	Nattfjärilar
אוראלט רוים	Romerska riket
אינטיפאדע	Intifada
אורטייל	Döma till brottspåföljd
לעגאליטעט	Legalitetsprincipen
דיר יאסין	Deir Yassin
שמעון	Simon (israelisk stamfader)
נחשון בן עמינדב	Nacheshon
קרעדיט פונקטן	Betalningsanmärkning
זייגן	Sugning
סטרונע אינסטרומענטן	Stränginstrument
הייסע לופט סיסטעם	VVS
נאטינג היל גייט אונטערגרונט סטאנציע	Notting Hill Gate (tunnelbanestation)
באסטיל	Bastiljen
מיי 2006	Maj 2006
מעטראפאליטען שטח	Storstadsområde
זשורנאליסט	Journalist
הייזשעקונג	Kapning
האולוויט	Fullkorn
טערמין	Begrepp
קאַטעגאָריע:עקאלאגיע	Kategori:Ekologi
זעיל	Självet
קאַטעגאָריע:באדייטן	Kategori:Förgreningssidor
קאַטעגאָריע:פילאסאפיע	Kategori:Filosofi
קאַטעגאָריע:פסיכאלאגיע	Kategori:Psykologi
קאַטעגאָריע:קריסטנטום	Kategori:Kristendom
קאַטעגאָריע:איסלאם	Kategori:Islam
קאַטעגאָריע:יידישקייט	Kategori:Judendom
אקטאבער 2006	Oktober 2006
אראנזש (באדייטן)	Orange (olika betydelser)
ארגאן	Organ (olika betydelser)
איזשביצע	Izbica
האלדז ווייטאג	Faryngit
אנאפאליס קאנפערענץ	Toppmötet i Annapolis
גמ"ח	Gemach
אדלער	Örnar
מכבי חיפה	Maccabi Haifa FC
קלענסטער געמיינזאמער דענאמינאטאר	Minsta gemensamma nämnare
קלייד	Kjol
פארראט	Förräderi
באנעם	Kognition
מוסטער:שפראך-ta	Mall:Lang-ta
סיון	Sivan
סאפיע (גארטן)	Sofiaparken i Uman
רומבולער הריגה	Rumbula
בת מצוה	Bat mitzva
כולל	Kollel
באכאטניץ	Bochotnica
אייסיס	Islamiska staten
פאלק	Folk
פארטיידיגונגס מיניסטעריום	Försvarsminister
רעזשיסאר	Filmregissör
IPv6	IPv6
בודאפעשטער געטא	Budapests getto
פארק סלאופ	Park Slope
געזעלשאפט	Associationsrätt
יד לשריון	Pansarkårens museum
ווייזערל	Stylus
שיינהייט קעניגען	Skönhetstävling
היסטאריע פון מדינת ישראל	Israels historia
גניבה	Stöld
אנערקענונג	Tacksamhet
ניוקליז	Kärna
תלמוד בבלי	Talmud bavli
דודו פישער	Dudu Fisher
פארטאל:ליטעראטור	Portal:Litteratur
נשות הכותל	Women of the Wall
שטויב	Pulver
דוד לאנדא	David Landau (journalist)
שוואגער	Svärfamilj
אידענטיטעט פאליטיק (יידנטום)	Identitetspolitik
אונטערהעמד	Undertröja
חנוכה געלט	Chokladpeng
עגונה	Aguna
אהרן קליין	Aaron Klein
חברה הצלה	Hatzolah
פירערשאפט	Management
קאַטעגאָריע:שטומף	Kategori:Stubbar
קאַטעגאָריע:וויקיפעדיע אדמיניסטראציע	Kategori:Wikipedia:Administration
קאַטעגאָריע:פלאנעטן	Kategori:Planeter
קאַטעגאָריע:מוזיק שטומף	Kategori:Musikstubbar
קאַטעגאָריע:קולטור	Kategori:Kultur
קאַטעגאָריע:קאטעגאריעס	Kategori:Kategorier
קאַטעגאָריע:יארן	Kategori:Årtal
קאַטעגאָריע:גייסט וויסנשאפט	Kategori:Humaniora
קאַטעגאָריע:וויסן	Kategori:Kunskap
קאַטעגאָריע:קאנטינענטן	Kategori:Världsdelar
קאַטעגאָריע:געאלאגיע	Kategori:Geologi
קאַטעגאָריע:רשימות	Kategori:Listor
קאַטעגאָריע:ארטיקלען וואס פעלן מקורות	Kategori:Artiklar som behöver enstaka källor
קאַטעגאָריע:וויקיפעדע אפהאנדעלונגן	Kategori:Wikipedia:Essäer
צוועלף יאר א קנעכט (פילם)	12 Years a Slave
װיקיפּעדיע:נאמען פון ארטיקל	Wikipedia:Artikelnamn
װיקיפּעדיע:וויקיפעד	Wikipedia:Användare
הייצונג	Oljepanna
הילף:לעצטע ענדערונגען	Wikipedia:Senaste ändringar
הארטקייט	Hårdhet
פארשטאפטער נאז	Nästäppa
סטאוו	Damm (vattenansamling)
מאדזשענטא	Magenta
סדום	Sodom
קאַטעגאָריע:טרופעס	Kategori:Musikgrupper
שווארמא	Shawarma
שוויצן	Svettning
מיר זענען די מילערס	Familjetrippen
שטיצבארע לעבן	Hållbar livsstil
אוניווערסיטעט פון טשילע מעטרא סטאנציע	Universidad de Chile (station)
קדש הקדשים	Allra heligaste
װיקיפּעדיע:עטיקעט	Wikipedia:Etikett
סואווערענער שטאט	Suverän stat
שליים	Slem
קאַטעגאָריע:וויקיפעדיע באטס	Kategori:Wikipedia:Robotar
צייכן	Skylt
כוסיין	Hussein
אפעראציע (מאטעמאטיק)	Operation (matematik)
בית המקדש	Jerusalems tempel
װיקיפּעדיע:קוואליטעט אטאקע	Wikipedia:Veckans samarbete
מוסטער:ביכער	Mall:Auktoritetsdata
װיקיפּעדיע:זיי דרייסט אין פארבעסערן ארטיקלן	Wikipedia:Var djärv
ברוקווע	Majrova
מוסטער:ציטירן	Mall:Citat
קאַטעגאָריע:דייטשן	Kategori:Tyskar
קאַטעגאָריע:אמעריקאנער	Kategori:Amerikaner
קאַטעגאָריע:אקטיארן	Kategori:Skådespelare
קאַטעגאָריע:בריטישע מענטשן	Kategori:Britter
קאַטעגאָריע:פראנצויזן	Kategori:Fransmän
קאַטעגאָריע:דענער	Kategori:Danskar
קאַטעגאָריע:איטאליענער	Kategori:Italienare
קאַטעגאָריע:טייכן אין אייראפע	Kategori:Vattendrag i Europa
קאַטעגאָריע:ראמאנען	Kategori:Romaner
קאַטעגאָריע:סצענאר שרייבער	Kategori:Manusförfattare
מוסטער:מל	Mall:Mall
מיינונג	Åsikt
הינריכטונג	Avrättning
קאַטעגאָריע:גוגל	Kategori:Google
קאַטעגאָריע:בלעטערערס	Kategori:Webbläsare
מוסטער:אויסדערוויילטע ארטיקלען	Portal:Huvudsida/Aktuella händelser
װיקיפּעדיע:טעכנישע פראגעס	Wikipedia:Wikipediafrågor
קאַטעגאָריע:פרייע ווייכווארג	Kategori:Fri programvara och öppen källkod
קאַטעגאָריע:געזעץ	Kategori:Juridik
קאַטעגאָריע:לענדער	Kategori:Världens länder
קאַטעגאָריע:אדמיניסטראציע	Kategori:Förvaltning
קאַטעגאָריע:עקאנאמיע	Kategori:Nationalekonomi
װיקיפּעדיע:אדמיניסטראטארן	Wikipedia:Administratörer
קאַטעגאָריע:קאזאכסטאן	Kategori:Kazakstan
קאַטעגאָריע:פערזענלעכקייטן	Kategori:Personer
װיקיפּעדיע:קאנדידאטורן	Wikipedia:Ansökan om administrativ behörighet
װיקיפּעדיע:ביוראקראט	Wikipedia:Byråkrater
קאַטעגאָריע:פאכן	Kategori:Yrken
קאַטעגאָריע:מענטשן לויטן פאך	Kategori:Personer efter verksamhetsområde
װיקיפּעדיע:באט	Wikipedia:Robotar
קאַטעגאָריע:באהאלטענע קאטעגאריעס	Kategori:Dolda kategorier
װיקיפּעדיע:טשעקיוזער	Wikipedia:IP-kontrollanter
קאַטעגאָריע:צייט	Kategori:Tid
קאַטעגאָריע:נאטור	Kategori:Natur
קאַטעגאָריע:אינטערנעט	Kategori:Internet
קאַטעגאָריע:באטאניק	Kategori:Botanik
קאַטעגאָריע:אינזשעניריע	Kategori:Ingenjörsvetenskap
קאַטעגאָריע:מאטעריאלן	Kategori:Material
װיקיפּעדיע:100 נייטיקע	Wikipedia:100 viktiga artiklar
װיקיפּעדיע:קאנטראלירן בלעטער	Wikipedia:Projekt wikifiering/Syntaxfel
קאַטעגאָריע:היסטארישע לענדער אין אייראפע	Kategori:Historiska länder och riken i Europa
קאַטעגאָריע:אנאטאמיע	Kategori:Anatomi
קאַטעגאָריע:מעדיצין	Kategori:Medicin
װיקיפּעדיע:אינטערשפראך לינקען	Wikipedia:Interwikilänkar
קאַטעגאָריע:פאליטיק	Kategori:Politik
קאַטעגאָריע:חינוך	Kategori:Utbildning
קאַטעגאָריע:אפטיק	Kategori:Optik
קאַטעגאָריע:קונסט	Kategori:Konst
קאַטעגאָריע:ווייכווארג	Kategori:Datorprogram
קאוונע	Kaunas
בוך האלטעריי	Redovisning
עגיפטן	Egypten
װיקיפּעדיע:זאקן פאפעט	Wikipedia:Marionetter
װיקיפּעדיע:באדייטן	Wikipedia:Särskiljning
װיקיפּעדיע:קאטעגאריזאציע	Wikipedia:Strukturering
קאַטעגאָריע:פילאסאפן	Kategori:Filosofer
קאַטעגאָריע:סטאטיסטיק	Kategori:Statistik
קאַטעגאָריע:וואלן	Kategori:Val
מוסטער:באט	Mall:Bot
פינאקיא (1940 פילם)	Pinocchio (1940)
װיקיפּעדיע:וואס וויקיפעדיע איז נישט	Wikipedia:Vad Wikipedia inte är
קאנאדע	Kanada
קאַטעגאָריע:אונגארן	Kategori:Ungern
קאַטעגאָריע:בעלגיע	Kategori:Belgien
קאַטעגאָריע:טשעכיי	Kategori:Tjeckien
קאַטעגאָריע:דענמארק	Kategori:Danmark
קאַטעגאָריע:פינלאנד	Kategori:Finland
קאַטעגאָריע:גריכנלאנד	Kategori:Grekland
קאַטעגאָריע:לעטלאנד	Kategori:Lettland
קאַטעגאָריע:איסלאנד	Kategori:Island
קאַטעגאָריע:לוקסעמבורג	Kategori:Luxemburg
קאַטעגאָריע:ליטע	Kategori:Litauen
קאַטעגאָריע:שוועדן	Kategori:Sverige
קאַטעגאָריע:סלאוואקיי	Kategori:Slovakien
קאַטעגאָריע:סלאוועניע	Kategori:Slovenien
קאַטעגאָריע:אירלאנד	Kategori:Irland
װיקיפּעדיע:קאפירעכטן	Wikipedia:Upphovsrätt
קאַטעגאָריע:רעקאמענדירטע ארטיקלען	Kategori:Wikipedia:Utmärkta artiklar
װיקיפּעדיע:וועגן	Wikipedia:Om
פעלקעררעכט	Internationell rätt
קאר סיט	Bilbarnstol
געפאנצערטער סאלדאטן טראנספארט	Pansarskyttefordon
קאַטעגאָריע:כעמיקער	Kategori:Kemister
דימענסיע	Dimension
מוסטער:גוגל	Mall:Google
קאַטעגאָריע:ווידעא שפילעריי	Kategori:Datorspel
קאַטעגאָריע:שפילעריי	Kategori:Spel
קאַטעגאָריע:מייקראסאפט	Kategori:Microsoft
הילף:קורץ ווארט	Wikipedia:Sammanfattningsfältet
פארטאל:וויסנשאפט	Portal:Naturvetenskap
װיקיפּעדיע:בקשות פון די סיסאפן	Wikipedia:Kommentarer om administrationen av Wikipedia
קאַטעגאָריע:לענדער אין אייראפע	Kategori:Europas länder
קאַטעגאָריע:אייראפע	Kategori:Europa
קאַטעגאָריע:וויקיפעדיע הילף	Kategori:Wikipedia:Hjälp
קאַטעגאָריע:קאטעגאריעס לויט טעמעס	Kategori:Kategorier efter ämne
װיקיפּעדיע:שמועס	Wikipedia:Diskussionssidor
װיקיפּעדיע:באניצער בלאט	Wikipedia:Användarsidor
װיקיפּעדיע:פרעפערענצן	Wikipedia:Inställningar
פארטאל:אקטועלע געשעענישן	Portal:Aktuella händelser
װיקיפּעדיע:באטס/בקשות פאר הסכמה	Wikipedia:Robotansökan
קאַטעגאָריע:וויקיפעדיע אויסמעקן	Kategori:Wikipedia:Raderingar
װיקיפּעדיע:ארטיקל באשיצונג	Wikipedia:Skrivskydd
קאַטעגאָריע:וויקיפעדיע קאטעגאריע אריבערפירן	Kategori:Kategoriomdirigeringar
קאַטעגאָריע:פֿאַרשלאָסענע אַרטיקלען	Kategori:Halvlåsta sidor
דאקטאר	Doktor
װיקיפּעדיע:איי אר סי טשענעלס	Wikipedia:IRC
קאַטעגאָריע:באנוצער קאטעגאריעס	Kategori:Wikipedia:Användare
װיקיפּעדיע:קאנסענסוס	Wikipedia:Konsensus
װיקיפּעדיע:קיין פערזענלעכע אטאקעס	Wikipedia:Inga personangrepp
װיקיפּעדיע:קאנטאקט אונדז	Wikipedia:Kontakt
װיקיפּעדיע:פארלאמענט	Wikipedia:Deltagarportalen
קאַטעגאָריע:באַניצער	Kategori:Användare efter språk
װיקיפּעדיע:פאליסיס און אנווייזונגען	Wikipedia:Policy och riktlinjer
װיקיפּעדיע:פינף זיילן	Wikipedia:Grundprinciperna
קאַטעגאָריע:וויקיפעדיע אפיציעלער פאליסי	Kategori:Wikipedia:Policy
װיקיפּעדיע:נייטראל	Wikipedia:Neutral synvinkel
װיקיפּעדיע:קיין אריגינעלע פארשונג	Wikipedia:Ingen originalforskning
װיקיפּעדיע:דריי-מאל צוריקדרייען	Wikipedia:Tredje återställningen gillt
װיקיפּעדיע:מערקווערדיג	Wikipedia:Relevans
װיקיפּעדיע:דרויסענדיגע לינקען	Wikipedia:Externa länkar
װיקיפּעדיע:אונטערשרייבן	Wikipedia:Signera diskussionsinlägg
װיקיפּעדיע:שטומף	Wikipedia:Stubbar
װיקיפּעדיע:דן זיין לכף זכות	Wikipedia:Förutsätt att andra har goda avsikter
װיקיפּעדיע:ביאגראפיעס פון לעבעדיגע פערזענליכקייטן	Wikipedia:Artiklar om nu levande personer
װיקיפּעדיע:וואנדאליזם	Wikipedia:Klottersanering
הילף:באהעפטן	Wikipedia:Dubblettartiklar
װיקיפּעדיע:בעטן ארטיקלען	Wikipedia:Önskelista
סלעש	Snedstreck
װיקיפּעדיע:רעדאקטירונג מלחמה	Wikipedia:Redigeringskrig
אריה ווארשל	Arieh Warshel
ביזנעס	Näringsliv
װיקיפּעדיע:ווייטערפירונג	Wikipedia:Omdirigeringar
מוסטער:Softredirect	Mall:Mjuk omdirigering
װיקיפּעדיע:וויקידאטן	Wikipedia:Wikidata
מוסטער:שנעל אויסמעקן	Mall:Radera
קאַטעגאָריע:וויקיפעדיע קאפירעכט	Kategori:Wikipedia:Upphovsrätt
קאַטעגאָריע:טעכנאלאגיע	Kategori:Teknologi
ביל די בלאזיא	Bill de Blasio
ליגן	Lögn
קאַטעגאָריע:שפראכן	Kategori:Språk
קאַטעגאָריע:גראמאטיק	Kategori:Grammatik
קאַטעגאָריע:גענעאלאגיע	Kategori:Genealogi
קאַטעגאָריע:קאלענדארן	Kategori:Kalendrar
קאַטעגאָריע:ימים טובים	Kategori:Högtider
הילף:אנהייבן א נייעם בלאט	Wikipedia:Skriv en ny artikel
קאַטעגאָריע:וויקיפעדיע	Kategori:Wikipedia
קאַטעגאָריע:וויקיפעדיעס אין אנדערע שפראכן	Kategori:Wikipediautgåvor
װיקיפּעדיע:קלארשטעלונג	Wikipedia:Allmänt förbehåll
קאַטעגאָריע:בלעטער מיט צעבראכענע טעקע לינקען	Kategori:Sidor med trasiga fillänkar
קאַטעגאָריע:געשטעלטע צו מעקן	Kategori:Sidor föreslagna för radering
װיקיפּעדיע:מוסטערן	Wikipedia:Meddelandemall
מאנומענט	Minnesmärke
סאלדאט	Soldat
קאַטעגאָריע:אקטועלע ארטיקלן	Kategori:Pågående
קאַטעגאָריע:שטעט אין אייראפע	Kategori:Städer i Europa
קאַטעגאָריע:שטעט לויט לענדער	Kategori:Städer efter land
װיקיפּעדיע:סטאטיסטיק	Wikipedia:Statistik
װיקיפּעדיע:פריוואטקייט פאליסי	Wikipedia:Integritetspolicy
װיקיפּעדיע:נאמענטייל	Wikipedia:Namnrymder
װיקיפּעדיע:שרייבן און סטיל אנווייזונגען	Wikipedia:Stilguide
װיקיפּעדיע:אויסמעקן פאליסי	Wikipedia:Raderingar
מוסטער:נאוויגאציע גרופעס	Mall:Navbox
קענגורו	Känguru
יוסטיץ	Rättvisa
קאַטעגאָריע:געגנטן	Kategori:Stadsdelar
קאַטעגאָריע:שטעט אין איראן	Kategori:Orter i Iran
הילף:לינק	Wikipedia:Wikilänkar
נייע צייט	Tidigmoderna tiden
קאַטעגאָריע:לעבעדיגע מענטשן	Kategori:Levande personer
קאַטעגאָריע:ארטיקלן וואס זייער נייטראלקייט איז אין מחלוקת	Kategori:POV
קאַטעגאָריע:געשטעלטע צו פאראייניקן	Kategori:Sidor föreslagna för infogning eller sammanslagning
קאַטעגאָריע:וויקיפעדיע אויפהאלטונג	Kategori:Kvalitetskontroll
קאַטעגאָריע:קאמפיוטעריי	Kategori:Datasystem
מוסטער:!	Mall:!
קאַטעגאָריע:פאן מוסטערן	Kategori:Flaggmallar
מוסטער:=	Mall:=
מוסטער:טינעוובאר	Mall:Navbar
קאַטעגאָריע:פארמאט מוסטערן	Kategori:Formaterings- och funktionsmallar
מוסטער:קלאווישדרוק	Mall:Knapp
מוסטער:אויבערשטראך	Mall:Overline
בטחון	Tro
מוסטער:קליין	Mall:Small
מוסטער:עמוד-שפאלט	Mall:Col-break
מוסטער:עמוד-אנהייב	Mall:Col-begin
מוסטער:עמוד-סוף	Mall:Col-end
מוסטער:נישט וויקלען	Mall:Nowrap
מוסטער:Bots	Mall:Bots
מוסטער:Anchor	Mall:Ankare
G-string	Stringtrosor
װיקיפּעדיע:וויכטיגע ארטיקלען	Wikipedia:Artiklar som bör finnas på Wikipedia
קאַטעגאָריע:אפריקע	Kategori:Afrika
קאַטעגאָריע:יולי	Kategori:Juli
קאַטעגאָריע:נומערן	Kategori:Tal
קאַטעגאָריע:יוני	Kategori:Juni
קאַטעגאָריע:עלעקטראניק	Kategori:Elektronik
קאַטעגאָריע:דאקומענטן	Kategori:Dokument
קאַטעגאָריע:ביכער	Kategori:Böcker
קאַטעגאָריע:מאנאטן	Kategori:Månader
מוסטער:באבעל	Mall:Babel
מוסטער:Link GA	Mall:Link GA
קאַטעגאָריע:שפיטעלער	Kategori:Sjukhus
קאַטעגאָריע:פילם אקטיארן	Kategori:Filmskådespelare
קאַטעגאָריע:וויקיפעדיע סטיל	Kategori:Wikipedia:Stilguide
װיקיפּעדיע:מקורות	Wikipedia:Källhänvisningar
װיקיפּעדיע:זוכן	Wikipedia:Sökning
װיקיפּעדיע:אויסגעקליבענער ארטיקל	Wikipedia:Kriterier för utvalda artiklar
קאַטעגאָריע:תקופות אין געשיכטע	Kategori:Historiska epoker
מוסטער:User ar-1	Mall:Användare ar-1
מוסטער:User eo-1	Mall:Användare eo-1
מוסטער:User da-2	Mall:Användare da-2
מוסטער:User eo-3	Mall:Användare eo-3
מוסטער:User de	Mall:Användare de
מוסטער:User de-1	Mall:Användare de-1
מוסטער:User es	Mall:Användare es
מוסטער:User de-3	Mall:Användare de-3
מוסטער:User en-3	Mall:Användare en-3
מוסטער:User en-1	Mall:Användare en-1
מוסטער:User en-2	Mall:Användare en-2
מוסטער:User en-4	Mall:Användare en-4
מוסטער:User fi	Mall:Användare fi
מוסטער:User en	Mall:Användare en
מוסטער:User de-2	Mall:Användare de-2
מוסטער:User es-1	Mall:Användare es-1
מוסטער:User fr-1	Mall:Användare fr-1
קאַטעגאָריע:חומר	Kategori:Materia
קאַטעגאָריע:לעבן	Kategori:Liv
קאַטעגאָריע:אוניווערס	Kategori:Universum
מוסטער:User he-2	Mall:Användare he-2
מוסטער:User he-1	Mall:Användare he-1
האריזאנטאל	Horisontell
מוסטער:User fr-2	Mall:Användare fr-2
מוסטער:User ja	Mall:Användare ja
מוסטער:User it-1	Mall:Användare it-1
מוסטער:User fr	Mall:Användare fr
מוסטער:נישט געחתמעט	Mall:Signatur
מוסטער:User he	Mall:Användare he
קאַטעגאָריע:טוריזם	Kategori:Turism
קאַטעגאָריע:האר	Kategori:Hår
קאַטעגאָריע:פעברואר	Kategori:Februari
קאַטעגאָריע:נאוויגאציע מוסטערן	Kategori:Navigationsrutor
קאַטעגאָריע:אינסעקטן	Kategori:Insekter
קאַטעגאָריע:מאלדאווע	Kategori:Moldavien
קאַטעגאָריע:אזיע	Kategori:Asien
קאַטעגאָריע:טשילע	Kategori:Chile
קאַטעגאָריע:21סטער י"ה	Kategori:2000-talet
קאַטעגאָריע:אויפהאלטונג מוסטערן	Kategori:Åtgärdsmallar
קאַטעגאָריע:באַניצער uk	Kategori:Användare uk
קאַטעגאָריע:דרום אמעריקע	Kategori:Sydamerika
קאַטעגאָריע:באַניצער uk-N	Kategori:Användare uk-N
קאַטעגאָריע:עסנווארג	Kategori:Mat
קאַטעגאָריע:פוסבאל	Kategori:Fotboll
מוסטער:Mod	Mall:Mod
מוסטער:User sv	Mall:Användare sv
מוסטער:User it	Mall:Användare it
מוסטער:User uk	Mall:Användare uk
מוסטער:User es-2	Mall:Användare es-2
קאַטעגאָריע:ענציקלאפעדיעס	Kategori:Uppslagsverk
מוסטער:שלום עליכם	Mall:Nybörjare
קאַטעגאָריע:וועבלינק מוסטערן	Kategori:Externa länkmallar
קאַטעגאָריע:טעג	Kategori:Veckodagar
קאַטעגאָריע:לבנה	Kategori:Månen
קאַטעגאָריע:שטעט אין בעלארוס	Kategori:Orter i Vitryssland
קאַטעגאָריע:ארגאניזאציעס	Kategori:Organisationer
קאַטעגאָריע:באַניצער ms	Kategori:Användare ms
קאַטעגאָריע:לינגוויסטיק	Kategori:Lingvistik
קאַטעגאָריע:מאטראסן	Kategori:Sjömän
קאַטעגאָריע:פארבינדונג מוסטערן	Kategori:Länkmallar
מוסטער:Wikivar	Mall:Wikivar
קאַטעגאָריע:באַניצער fr-1	Kategori:Användare fr-1
מוסטער:בילד קלעבל	Mall:Image label
קאַטעגאָריע:רעגירונג זינגלידער	Kategori:Nationalsånger
מוסטער:אפריקע	Mall:Afrika
קאַטעגאָריע:מענטשן פון ניו יארק	Kategori:Personer från delstaten New York
קאַטעגאָריע:נאציס	Kategori:Nazister
מוסטער:נישט פארטיק	Mall:Pågår
מוסטער:קיין בילד	Mall:Illustrationsbehov
קאַטעגאָריע:פראווינצן	Kategori:Provinser
מוסטער:מדינה	Mall:Landsfakta
מוסטער:פאליסיליסטע	Mall:Policylista
קאַטעגאָריע:פילם פראדוצירער	Kategori:Filmproducenter
מוסטער:Windows	Mall:Windows
מוסטער:וויסנשאפטלער	Mall:Infobox forskare
מוסטער:אוניווערסיטעט	Mall:Universitet
קאַטעגאָריע:אזארטשפילן	Kategori:Hasardspel
מוסטער:שפראך-ar	Mall:Lang-ar
מוסטער:רעקאמענדירטער ארטיקל	Mall:Utmärkt
פארטאל:קעסטל-קאפ	Portal:Box-header
קאַטעגאָריע:פאריז	Kategori:Paris
קאַטעגאָריע:באַניצער en-4	Kategori:Användare en-4
קאַטעגאָריע:באַניצער en	Kategori:Användare en
קאַטעגאָריע:באַניצער zh	Kategori:Användare zh
קאַטעגאָריע:קראאטיע	Kategori:Kroatien
קאַטעגאָריע:באַניצער en-2	Kategori:Användare en-2
קאַטעגאָריע:פרעמיער מיניסטארן פון ישראל	Kategori:Israels premiärministrar
מוסטער:לעגענדע	Mall:Legend
קאַטעגאָריע:פרעמיער מיניסטארן פון טערקיי	Kategori:Turkiets premiärministrar
קאַטעגאָריע:ביורא געצייג	Kategori:Kontorsvaror
מוסטער:אקטועל	Mall:Pågående
מוסטער:לאטיינישער אלפאבעט	Mall:Svenska alfabetet
קאַטעגאָריע:ביאגראפיע	Kategori:Biografier
קאַטעגאָריע:אוויאציע	Kategori:Flyg
קאַטעגאָריע:קאטעגאריעס לויט לענדער	Kategori:Kategorier efter land
קאַטעגאָריע:נעמען	Kategori:Namn
קאַטעגאָריע:שטעט אין טערקיי	Kategori:Orter i Turkiet
מוסטער:GeoTemplate	Mall:GeoTemplate
קאַטעגאָריע:עסנווארג און געטראנקען	Kategori:Mat och dryck
קאַטעגאָריע:מאגאזינען	Kategori:Tidskrifter
מוסטער:Coor URL	Mall:Coor URL
קאַטעגאָריע:איבערזעצונג	Kategori:Översättande
מוסטער:User nl-1	Mall:Användare nl-1
מוסטער:באן ליניע אפטיילונג	Mall:BS
מוסטער:User nl-2	Mall:Användare nl-2
מוסטער:באן ליניע אפט3	Mall:BS3
קאַטעגאָריע:רוימער	Kategori:Romare
קאַטעגאָריע:ספרים זאמלער	Kategori:Boksamlare
קאַטעגאָריע:לאנדווירטשאפט	Kategori:Jordbruk
קאַטעגאָריע:חורבן אייראפע	Kategori:Förintelsen
קאַטעגאָריע:שטעט אין קאזאכסטאן	Kategori:Orter i Kazakstan
קאַטעגאָריע:וואסער טראנספארט	Kategori:Sjöfart
קאַטעגאָריע:באַניצער hi	Kategori:Användare hi
קאַטעגאָריע:באַניצער ms-M	Kategori:Användare ms-N
קאַטעגאָריע:מיקראביאלאגיע	Kategori:Mikrobiologi
מוסטער:אפריקע-געא-שטומף	Mall:Geografistub-Afrika
קאַטעגאָריע:פרעזידענטן	Kategori:Presidenter
קאַטעגאָריע:בערג	Kategori:Berg
מוסטער:User ru	Mall:Användare ru
קאַטעגאָריע:20סטער י"ה	Kategori:1900-talet
מוסטער:IPA	Mall:IPA
מוסטער:באן ליניע אפט2	Mall:BS2
קאַטעגאָריע:פאליטיקער	Kategori:Politiker
מוסטער:יתום	Mall:Föräldralös
קאַטעגאָריע:אמעריקע	Kategori:Amerika
מוסטער:אנדערע באדייטן	Mall:Olika betydelser
קאַטעגאָריע:געווירצן	Kategori:Kryddor och kryddblandningar
קאַטעגאָריע:זיכערהייט	Kategori:Säkerhet
קאַטעגאָריע:פעלקער	Kategori:Personer efter nationalitet
קאַטעגאָריע:פאלעסטינע	Kategori:Palestina
קאַטעגאָריע:איבערזעצער	Kategori:Översättare
מוסטער:פרעזידענטן פון די פאראייניגטע שטאטן	Mall:USA:s presidenter
קאַטעגאָריע:באנוצער שפראך מוסטערן	Kategori:Babelmallar
קאַטעגאָריע:נביאים	Kategori:Profeter
קאַטעגאָריע:וואשינגטאן	Kategori:Washington
מוסטער:הויפטשטעט אין אפריקע	Mall:Huvudstäder i Afrika
קאַטעגאָריע:מאס	Kategori:Mått
מוסטער:MONTHNAME	Mall:MÅNADSNAMN
מוסטער:קאטעגאריע אריבערפירן	Mall:Kategoriomdirigering
מוסטער:מאטעמאטיק-שטומף	Mall:Matematikstub
קאַטעגאָריע:ביאגראפיע שטומף	Kategori:Personstubbar
מוסטער:איקאן	Mall:Ikon
קאַטעגאָריע:יידן	Kategori:Personligheter inom judendomen
קאַטעגאָריע:19טער י"ה	Kategori:1800-talet
קאַטעגאָריע:שרייבער	Kategori:Författare
קאַטעגאָריע:מיליטער	Kategori:Militärväsen
קאַטעגאָריע:פילאנטראפן	Kategori:Filantroper
מוסטער:שפראך-cs	Mall:Lang-cs
מוסטער:שפראך-he	Mall:Lang-he
טעאריע פון משמעותדיקייט	Sannolikhetsteori
קאַטעגאָריע:יאנואר	Kategori:Januari
מוסטער:שפראך-fa	Mall:Lang-fa
קאַטעגאָריע:רעזשיסארן	Kategori:Regissörer
מוסטער:User pl	Mall:Användare pl
מוסטער:User nl	Mall:Användare nl-N
קאַטעגאָריע:שפיאנאזש אגענטורן	Kategori:Underrättelseorgan
מוסטער:בילד קלעבל סוף	Mall:Image label end
מוסטער:גאנצע צאל	Mall:Heltal
מוסטער:קערפער סיסטעמען	Mall:Organsystem
מוסטער:ביאלאגיע פיסל	Mall:Grenar inom biologi
מוסטער:אינפאקעסטל באן סטאנציע	Mall:Järnvägsstation
קאַטעגאָריע:מאלעריי	Kategori:Måleri
מוסטער:שפראך-de	Mall:Lang-de
קאַטעגאָריע:פארטן	Kategori:Hamnar
קאַטעגאָריע:געפילן	Kategori:Känslor
קאַטעגאָריע:קאסמאלאגיע	Kategori:Kosmologi
קאַטעגאָריע:פרעזידענטן פון לענדער	Kategori:Statschefsämbeten efter land
קאַטעגאָריע:ווערטער	Kategori:Ord
מוסטער:שפראך-af	Mall:Lang-af
קאַטעגאָריע:קערפער פון וואסער	Kategori:Vattenansamlingar
װיקיפּעדיע:איבערקוקן	Wikipedia:Artikelgranskningar
אינדעך	Indigo (färg)
קאַטעגאָריע:פירמעס	Kategori:Företag
קאַטעגאָריע:מידות	Kategori:Etik
מוסטער:User pl-1	Mall:Användare pl-1
מוסטער:בילד קלעבל קליין	Mall:Image label small
קאַטעגאָריע:צלם-בלומיקע	Kategori:Brassicaceae
מוסטער:User fr-3	Mall:Användare fr-3
קאַטעגאָריע:אויסדרוקן	Kategori:Ordspråk och talesätt
קאַטעגאָריע:שטעט אין יאפאן	Kategori:Orter i Japan
קאַטעגאָריע:געצייג	Kategori:Utrustning
וואכטל	Vaktlar
מוסטער:באן ליניע קעפל	Mall:Railway line header
מוסטער:TOCgeohack	Mall:TOCgeohack
מוסטער:User de-0	Mall:Användare de-0
מוסטער:User SUL Box	Mall:SUL Box
מוסטער:טעג פון דער וואך	Mall:Veckodagar
קאַטעגאָריע:בלאגס	Kategori:Bloggar
קאַטעגאָריע:כעמישע סובסטאנצן	Kategori:Kemiska substanser
קאַטעגאָריע:פילמען לויט שפראך	Kategori:Filmer efter språk
קאַטעגאָריע:שטעט אין די פאראייניגטע שטאטן פון אמעריקע	Kategori:Orter i USA
מוסטער:PDF	Mall:PDF
מוסטער:שפראך-ru	Mall:Lang-ru
קאַטעגאָריע:מוזיק זשאנערס	Kategori:Musikgenrer
קאַטעגאָריע:אימפעריעס	Kategori:Imperier
קאַטעגאָריע:פארט שטעט	Kategori:Hamnstäder
קאַטעגאָריע:מקומות הקדושים	Kategori:Heliga platser
מוסטער:רוימישע נומערן	Mall:Romerska siffror
קאַטעגאָריע:שטעט אין שװעדן	Kategori:Sveriges städer
מוסטער:באדייטן	Mall:Förgrening
קאַטעגאָריע:פלעצער פון תנ"ך	Kategori:Platser i Bibeln
קאַטעגאָריע:אינפאבאקס מוסטערן	Kategori:Faktamallar
קאַטעגאָריע:מעדיצינישע באהאנדלונגען	Kategori:Sjukvårdsbehandlingar
קאַטעגאָריע:מוסקל סיסטעם	Kategori:Muskuloskeletala systemet
קאַטעגאָריע:ישובים אין ישראל	Kategori:Orter i Israel
קאַטעגאָריע:מיטל מזרח	Kategori:Mellanöstern
קאַטעגאָריע:צייטונגען	Kategori:Tidningar
קאַטעגאָריע:פאליציי	Kategori:Polis
קאַטעגאָריע:נאציזם	Kategori:Nazism
קאַטעגאָריע:לאנדאנער באראס	Kategori:London boroughs
מוסטער:פילאסאפיע	Mall:Filosofi navigation
קאַטעגאָריע:קעז	Kategori:Ost
קאַטעגאָריע:שפראך מוסטערן	Kategori:Språkmallar
קאַטעגאָריע:זיסווארג	Kategori:Godis
קאַטעגאָריע:מאלצייטן	Kategori:Måltider
קאַטעגאָריע:שטעט אין לבנון	Kategori:Orter i Libanon
מוסטער:שפראך-uk	Mall:Lang-uk
מוסטער:אדם ביז נח	Mall:Adam till David
קאַטעגאָריע:טעאלאגיע	Kategori:Teologi
קאַטעגאָריע:מאנאטעיזם	Kategori:Monoteism
קאַטעגאָריע:חיפה	Kategori:Haifa
קאַטעגאָריע:קאמפיוטער נעצווערקן	Kategori:Datornätverk
קאַטעגאָריע:ארכיטעקטור	Kategori:Arkitektur
מוסטער:סלאווישע שפראכן	Mall:Slaviska språk
מוסטער:הויפטשטעט אין דרום אמעריקע	Mall:Huvudstäder i Sydamerika
מוסטער:Harvnb	Mall:Harvnb
קאַטעגאָריע:מאנגאליי	Kategori:Mongoliet
קאַטעגאָריע:באן טראנספארט	Kategori:Spårtrafik
צוגאב און אראפנעם צייכנס	Plustecken
קאַטעגאָריע:פארדייאונג סיסטעם	Kategori:Matsmältningssystemet
מוסטער:וויקיפעדיע	Mall:Interwiki
קאַטעגאָריע:שטעט אין האלאנד	Kategori:Orter i Nederländerna
מוסטער:אלף בית	Mall:Hebreiska bokstäver
קאַטעגאָריע:גאסן	Kategori:Gator
קאַטעגאָריע:וויין	Kategori:Vin
מוסטער:Coord	Mall:Coord
מוסטער:Citation/make link	Mall:Link
מוסטער:לענדער פון אייראפע	Mall:Europa
מוסטער:ביאלאגיע-שטומף	Mall:Biologistub
קאַטעגאָריע:מוסטער דאקומענטאציע	Kategori:Malldokumentation
קאַטעגאָריע:באַניצער eo	Kategori:Användare eo
קאַטעגאָריע:באַניצער fr	Kategori:Användare fr
קאַטעגאָריע:באַניצער ja	Kategori:Användare ja
קאַטעגאָריע:באַניצער la	Kategori:Användare la
קאַטעגאָריע:באַניצער nn	Kategori:Användare nn
קאַטעגאָריע:באַניצער pt	Kategori:Användare pt
קאַטעגאָריע:באַניצער ro	Kategori:Användare ro
קאַטעגאָריע:באַניצער sv	Kategori:Användare sv
קאַטעגאָריע:באַניצער cs-3	Kategori:Användare cs-3
קאַטעגאָריע:באַניצער fr-3	Kategori:Användare fr-3
קאַטעגאָריע:באַניצער nl-3	Kategori:Användare nl-3
קאַטעגאָריע:באַניצער nl-1	Kategori:Användare nl-1
קאַטעגאָריע:באַניצער pl-1	Kategori:Användare pl-1
קאַטעגאָריע:באַניצער ro-1	Kategori:Användare ro-1
קאַטעגאָריע:באַניצער ar-1	Kategori:Användare ar-1
קאַטעגאָריע:באַניצער da-2	Kategori:Användare da-2
קאַטעגאָריע:באַניצער fr-2	Kategori:Användare fr-2
קאַטעגאָריע:באַניצער hi-2	Kategori:Användare hi-2
קאַטעגאָריע:באַניצער nl-2	Kategori:Användare nl-2
קאַטעגאָריע:באַניצער ar-2	Kategori:Användare ar-2
קאַטעגאָריע:באַניצער cs-N	Kategori:Användare cs-N
קאַטעגאָריע:באַניצער fr-M	Kategori:Användare fr-N
קאַטעגאָריע:באַניצער is-N	Kategori:Användare is-N
קאַטעגאָריע:באַניצער it-N	Kategori:Användare it-N
קאַטעגאָריע:באַניצער nl-N	Kategori:Användare nl-N
קאַטעגאָריע:באַניצער ru-N	Kategori:Användare ru-N
קאַטעגאָריע:פארוויילונג	Kategori:Nöjen
קאַטעגאָריע:פלעצער	Kategori:Ortnamn
קאַטעגאָריע:ביזנעס	Kategori:Näringsliv
קאַטעגאָריע:שריפט	Kategori:Skrift
קאַטעגאָריע:באַניצער ar	Kategori:Användare ar
קאַטעגאָריע:ביאלאגיע אינפאבאקס מוסטערן	Kategori:Biologifaktamallar
קאַטעגאָריע:יידיש	Kategori:Jiddisch
קאַטעגאָריע:באַניצער cs	Kategori:Användare cs
קאַטעגאָריע:אינדזלען	Kategori:Öar
קאַטעגאָריע:היסטאריקער	Kategori:Historiker
קאַטעגאָריע:באַניצער da	Kategori:Användare da
קאַטעגאָריע:פאציפישער אקעאן	Kategori:Stilla havet
קאַטעגאָריע:באַניצער de	Kategori:Användare de
קאַטעגאָריע:באַניצער de-2	Kategori:Användare de-2
קאַטעגאָריע:באַניצער de-3	Kategori:Användare de-3
קאַטעגאָריע:באַניצער de-N	Kategori:Användare de-N
מוסטער:דעפארטמענטן פון באליוויע	Mall:Bolivias departement
קאַטעגאָריע:באַניצער en-3	Kategori:Användare en-3
קאַטעגאָריע:באַניצער en-N	Kategori:Användare en-N
קאַטעגאָריע:באַניצער eo-1	Kategori:Användare eo-1
קאַטעגאָריע:באַניצער eo-2	Kategori:Användare eo-2
קאַטעגאָריע:באַניצער eo-3	Kategori:Användare eo-3
קאַטעגאָריע:באַניצער eo-N	Kategori:Användare eo-N
קאַטעגאָריע:באַניצער es	Kategori:Användare es
קאַטעגאָריע:באַניצער es-1	Kategori:Användare es-1
מוסטער:EU מיטגלידער	Mall:EU
קאַטעגאָריע:רבנים	Kategori:Rabbiner
קאַטעגאָריע:באַניצער es-2	Kategori:Användare es-2
קאַטעגאָריע:באַניצער es-3	Kategori:Användare es-3
קאַטעגאָריע:באַניצער es-N	Kategori:Användare es-N
קאַטעגאָריע:באַניצער fi	Kategori:Användare fi
קאַטעגאָריע:באַניצער fi-N	Kategori:Användare fi-N
קאַטעגאָריע:1680ער	Kategori:1680-talet
קאַטעגאָריע:באַניצער he	Kategori:Användare he
קאַטעגאָריע:באַניצער he-1	Kategori:Användare he-1
קאַטעגאָריע:באַניצער he-2	Kategori:Användare he-2
קאַטעגאָריע:באַניצער he-3	Kategori:Användare he-3
קאַטעגאָריע:באַניצער he-N	Kategori:Användare he-N
קאַטעגאָריע:באַניצער hu	Kategori:Användare hu
קאַטעגאָריע:באַניצער is	Kategori:Användare is
קאַטעגאָריע:באַניצער is-1	Kategori:Användare is-1
קאַטעגאָריע:באַניצער is-2	Kategori:Användare is-2
קאַטעגאָריע:באַניצער is-3	Kategori:Användare is-3
קאַטעגאָריע:טיטלען	Kategori:Titlar
קאַטעגאָריע:יידישע קיך	Kategori:Mat och dryck inom judendom
קאַטעגאָריע:מענטשן פון בני ברק	Kategori:Personer från Bnei Brak
אייגנטום	Egendom
קאַטעגאָריע:אלף בית	Kategori:Hebreiska alfabetet
קאַטעגאָריע:העברעיש	Kategori:Hebreiska
מוסטער:אייראפע-געא-שטומף	Mall:Geografistub-Europa
קאַטעגאָריע:פרעזידענטן פון ווענעזועלע	Kategori:Venezuelas presidenter
קאַטעגאָריע:באַניצער pl-N	Kategori:Användare pl-N
קאַטעגאָריע:שיאיטן	Kategori:Shia
קאַטעגאָריע:געאמעטריע	Kategori:Geometri
מוסטער:שפראך-be	Mall:Lang-be
קאַטעגאָריע:גארטן	Kategori:Trädgårdsskötsel
קאַטעגאָריע:קינסטלערס	Kategori:Konstnärer
מוסטער:נומערן	Mall:Tal
קאַטעגאָריע:באַניצער it	Kategori:Användare it
קאַטעגאָריע:באַניצער it-1	Kategori:Användare it-1
קאַטעגאָריע:וועבזייטלעך	Kategori:Webbplatser
קאַטעגאָריע:באַניצער ko	Kategori:Användare ko
קאַטעגאָריע:שטאטן אין די פאראייניגטע שטאטן	Kategori:USA:s delstater
קאַטעגאָריע:ארגאניזאציעס אין ישראל	Kategori:Organisationer i Israel
קאַטעגאָריע:באַניצער la-1	Kategori:Användare la-1
מוסטער:קליינסופ	Mall:Smallsup
קאַטעגאָריע:וואולקאנען	Kategori:Vulkaner
קאַטעגאָריע:שפיאנאזש	Kategori:Spioneri
קאַטעגאָריע:שטעט אין טשילע	Kategori:Chiles kommuner
מאלצייט	Måltid
קאַטעגאָריע:קאמפקונסט	Kategori:Kampsport
קאַטעגאָריע:באן טראנספארט מוסטערן	Kategori:Linjekartor
קאַטעגאָריע:וועטער	Kategori:Väder
קאַטעגאָריע:נאוועמבער	Kategori:November
קאַטעגאָריע:אפמאכן	Kategori:Internationella konventioner
קאַטעגאָריע:באַניצער ru-1	Kategori:Användare ru-1
װיקיפּעדיע:באבעל	Wikipedia:Babel
קאַטעגאָריע:פארברעכן	Kategori:Brott
מוסטער:User sv-1	Mall:Användare sv-1
קאַטעגאָריע:כעמישע פארבינדונגען	Kategori:Kemiska föreningar
קאַטעגאָריע:פארשטעלונגען	Kategori:Teaterstycken
קאַטעגאָריע:1970ער	Kategori:1970-talet
קאַטעגאָריע:1890ער	Kategori:1890-talet
קאַטעגאָריע:דיכטער	Kategori:Poeter
קאַטעגאָריע:אידישע משפחות	Kategori:Judiska släkter
קאַטעגאָריע:טעאריעס	Kategori:Teorier
קאַטעגאָריע:מערץ	Kategori:Mars (månad)
קאַטעגאָריע:פוילישע	Kategori:Polacker
קאַטעגאָריע:ענגלענדער	Kategori:Engelsmän
קאַטעגאָריע:סעפטעמבער	Kategori:September
קאַטעגאָריע:איטאליענישע היסטאריע	Kategori:Italiens historia
קאַטעגאָריע:דיפלאמאטן	Kategori:Diplomater
קאַטעגאָריע:השכלה	Kategori:Upplysningstiden
קאַטעגאָריע:אקטאבער	Kategori:Oktober
קאַטעגאָריע:באַניצער ms-2	Kategori:Användare ms-2
קאַטעגאָריע:לאטיינישער אלפאבעט	Kategori:Latinska alfabetet
קאַטעגאָריע:ימען	Kategori:Hav
קאַטעגאָריע:שטעט און שטעטלעך אין פוילן	Kategori:Städer i Polen
קאַטעגאָריע:דעצעמבער	Kategori:December
קאַטעגאָריע:אויגוסט	Kategori:Augusti
קאַטעגאָריע:מיי	Kategori:Maj
קאַטעגאָריע:אויטאמאביל פירמעס	Kategori:Bilmärken
קאַטעגאָריע:דראגס	Kategori:Droger
גלוסט	Lust
וואקאבולאר	Ordförråd
קאַטעגאָריע:ענגלאנד	Kategori:England
קאַטעגאָריע:מעטאלורגיע	Kategori:Metallurgi
קאַטעגאָריע:קאנגרעסלייט	Kategori:Ledamöter av USA:s representanthus
עקספלאראציע	Upptäcktsresa
קאַטעגאָריע:מאדעלן	Kategori:Fotomodeller
קאַטעגאָריע:אפריל	Kategori:April
קאַטעגאָריע:פרייצייט	Kategori:Fritid
קאַטעגאָריע:מחשבה	Kategori:Tänkande
קאַטעגאָריע:קאנפערענצן	Kategori:Konferenser
קאַטעגאָריע:מיטל מזרח קאנפליקט	Kategori:Arab-israeliska-konflikten
מוסטער:שפראך-ko	Mall:Lang-ko
קאַטעגאָריע:קאמפיוטער וויסנשאפט	Kategori:Datavetenskap
מוסטער:באן ליניע איבערדעק	Mall:BS-overlap
קאַטעגאָריע:זשאנערס	Kategori:Litterära genrer
קאַטעגאָריע:זון סיסטעם	Kategori:Solsystemet
קאַטעגאָריע:אינטערנאציאנאלע ארגאניזאציעס	Kategori:Internationella organisationer
קאַטעגאָריע:ענטאמאלאגיע	Kategori:Entomologi
קאַטעגאָריע:רעגירונג מיניסטארן	Kategori:Ministrar
קאַטעגאָריע:אינדוסטריע	Kategori:Industri
קאַטעגאָריע:ערפינדערס	Kategori:Uppfinnare
קאַטעגאָריע:וואסער	Kategori:Vatten
קאַטעגאָריע:קאפ און גענאק	Kategori:Huvud och hals
מוסטער:Sfn	Mall:Sfn
גיין	Gång
קאַטעגאָריע:געטראנקען	Kategori:Drycker
קאַטעגאָריע:זאאלאגיע	Kategori:Zoologi
קאַטעגאָריע:קאגניציע	Kategori:Kognition
װיקיפּעדיע:מולטי שפראך סטאטיסטיקס	Wikipedia:Lista över Wikipedias språkversioner
קאַטעגאָריע:ישראל'דיגע מוסטערן	Kategori:Israelmallar
קאַטעגאָריע:קרעדיט	Kategori:Kreditväsen
קאַטעגאָריע:פרעמיעס	Kategori:Priser
קאַטעגאָריע:סימבאלן	Kategori:Symboler
קאַטעגאָריע:טעאטערס	Kategori:Teatrar
קאַטעגאָריע:סאציאל וויסנשאפט	Kategori:Samhällsvetenskap
קאַטעגאָריע:בעלארוס	Kategori:Vitryssland
קאַטעגאָריע:מאסאטשוסעטס	Kategori:Massachusetts
קאַטעגאָריע:ראיאנען	Kategori:Regioner
קאַטעגאָריע:לענדער אין אפריקע	Kategori:Afrikas länder
מוסטער:קאנאדישע פראווינצן	Mall:Kanada
קאַטעגאָריע:1940ער	Kategori:1940-talet
קאַטעגאָריע:1900ער	Kategori:1900-talet (decennium)
קאַטעגאָריע:1910ער	Kategori:1910-talet
קאַטעגאָריע:1920ער	Kategori:1920-talet
קאַטעגאָריע:1930ער	Kategori:1930-talet
קאַטעגאָריע:1950ער	Kategori:1950-talet
קאַטעגאָריע:1960ער	Kategori:1960-talet
קאַטעגאָריע:1980ער	Kategori:1980-talet
קאַטעגאָריע:1990ער	Kategori:1990-talet
קאַטעגאָריע:2000ער	Kategori:2000-talet (decennium)
קאַטעגאָריע:2010ער	Kategori:2010-talet
מוסטער:באן ליניע אנווייזונגען	Mall:Railway line legend
מוסטער:ארגאניזאציע פאר עקאנאמישע קאאפעראציע און אנטוויקלונג	Mall:OECD
װיקיפּעדיע:געצייג	Wikipedia:Externa hjälpmedel
קאַטעגאָריע:לימפאטישע סיסטעם	Kategori:Lymfatiska systemet
מוסטער:User cs	Mall:Användare cs
מוסטער:User es-3	Mall:Användare es-3
קאַטעגאָריע:באַניצער ro-2	Kategori:Användare ro-2
קאַטעגאָריע:באַניצער ro-3	Kategori:Användare ro-3
קאַטעגאָריע:באַניצער ro-N	Kategori:Användare ro-N
קאַטעגאָריע:באַניצער ru	Kategori:Användare ru
קאַטעגאָריע:באַניצער ru-2	Kategori:Användare ru-2
קאַטעגאָריע:באַניצער ru-3	Kategori:Användare ru-3
קאַטעגאָריע:באַניצער sv-1	Kategori:Användare sv-1
קאַטעגאָריע:באַניצער sv-N	Kategori:Användare sv-N
קאַטעגאָריע:באַניצער uk-4	Kategori:Användare uk-4
קאַטעגאָריע:באַניצער yi	Kategori:Användare yi
קאַטעגאָריע:מוזיקער	Kategori:Musiker
קאַטעגאָריע:מאלערס	Kategori:Målare
װיקיפּעדיע:בילדער	Wikipedia:Illustrationer
קאַטעגאָריע:צווייטע וועלט מלחמה רעגירער	Kategori:Personer i andra världskriget
קאַטעגאָריע:טערמינאלאגיע	Kategori:Terminologi
קאַטעגאָריע:ביימער	Kategori:Träd
קאַטעגאָריע:סאציאלאגיע	Kategori:Sociologi
קאַטעגאָריע:סיסטעמען	Kategori:System
קאַטעגאָריע:1560ער	Kategori:1560-talet
קאַטעגאָריע:1820ער	Kategori:1820-talet
קאַטעגאָריע:1670ער	Kategori:1670-talet
קאַטעגאָריע:1770ער	Kategori:1770-talet
קאַטעגאָריע:1760ער	Kategori:1760-talet
קאַטעגאָריע:1710ער	Kategori:1710-talet
קאַטעגאָריע:1650ער	Kategori:1650-talet
קאַטעגאָריע:1610ער	Kategori:1610-talet
קאַטעגאָריע:1810ער	Kategori:1810-talet
קאַטעגאָריע:1640ער	Kategori:1640-talet
קאַטעגאָריע:1850ער	Kategori:1850-talet
קאַטעגאָריע:17טער י"ה	Kategori:1600-talet
קאַטעגאָריע:1880ער	Kategori:1880-talet
קאַטעגאָריע:1720ער	Kategori:1720-talet
קאַטעגאָריע:1750ער	Kategori:1750-talet
קאַטעגאָריע:1870ער	Kategori:1870-talet
קאַטעגאָריע:1780ער	Kategori:1780-talet
קאַטעגאָריע:1860ער	Kategori:1860-talet
קאַטעגאָריע:1790ער	Kategori:1790-talet
קאַטעגאָריע:1730ער	Kategori:1730-talet
קאַטעגאָריע:1800ער	Kategori:1800-talet (decennium)
קאַטעגאָריע:1700ער	Kategori:1700-talet (decennium)
קאַטעגאָריע:פאבריקאציע	Kategori:Tillverkning
מוסטער:אזיע-געא-שטומף	Mall:Geografistub-Asien
קאַטעגאָריע:מענטשליכע אויפפירונג	Kategori:Mänskligt beteende
קאַטעגאָריע:מענטשן	Kategori:Människor
קאַטעגאָריע:קאטעגאריע קעפל מוסטערן	Kategori:Kategorimallar
קאַטעגאָריע:Windows	Kategori:Microsoft Windows
קאַטעגאָריע:2014	Kategori:2014
מוסטער:בריטישע מאנארכן	Mall:Storbritanniens regenter
מוסטער:ברוקלין	Mall:Brooklyn
מוסטער:User sv-3	Mall:Användare sv-3
קאַטעגאָריע:האנדל און פינאנץ	Kategori:Handel
קאַטעגאָריע:פארטאל	Kategori:Portaler
קאַטעגאָריע:ביאכעמיע	Kategori:Biokemi
קאַטעגאָריע:באן טראנספארט אין פראנקרייך	Kategori:Järnväg i Frankrike
קאַטעגאָריע:קאמפיוטער פראגראמירן	Kategori:Programmering
קאַטעגאָריע:וויטאמינען	Kategori:Vitaminer
קאַטעגאָריע:צירונגען	Kategori:Smycken
מוסטער:שפראך-hi	Mall:Lang-hi
מוסטער:אנווייז צום הויפט ארטיקל	Mall:Huvudartikel
קאַטעגאָריע:איידעלע גאזן	Kategori:Ädelgaser
קאַטעגאָריע:ניו יארק	Kategori:Delstaten New York
קאַטעגאָריע:ניו זשערסי	Kategori:New Jersey
קאַטעגאָריע:אהאיא	Kategori:Ohio
קאַטעגאָריע:קאליפארניע	Kategori:Kalifornien
קאַטעגאָריע:קאנעטיקעט	Kategori:Connecticut
קאַטעגאָריע:מאדע	Kategori:Mode
קאַטעגאָריע:צווייטע וועלט מלחמה	Kategori:Andra världskriget
קאַטעגאָריע:ערשטע וועלט מלחמה	Kategori:Första världskriget
קאַטעגאָריע:ציטירן מוסטערן	Kategori:Källmallar
קאַטעגאָריע:פאפ זינגערס	Kategori:Popsångare
מוסטער:היסט-שטומף	Mall:Historiestub
קאַטעגאָריע:ישראל פילמען	Kategori:Israeliska filmer
קאַטעגאָריע:טעקסטיל	Kategori:Textilier
קאַטעגאָריע:שטעט אין ענגלאנד	Kategori:Orter i England
קאַטעגאָריע:אמעריקאנער שרייבער	Kategori:Amerikanska författare
קאַטעגאָריע:דראמאטורגן	Kategori:Dramatiker
מוסטער:ישראל פרעזידענטן	Mall:Israelpres
מוסטער:צענטראלע ליניע סטאנציעס	Mall:Central line
קאַטעגאָריע:ארכיטעקטן	Kategori:Arkitekter
קאַטעגאָריע:גאבאן	Kategori:Gabon
קאַטעגאָריע:קאמערון	Kategori:Kamerun
קאַטעגאָריע:ליביע	Kategori:Libyen
קאַטעגאָריע:מאראקא	Kategori:Marocko
קאַטעגאָריע:היסטאריע פון פוילן	Kategori:Polens historia
קאַטעגאָריע:בריטישע אינזלען	Kategori:Brittiska öarna
מוסטער:Citation/core	Mall:Citation/core
קאַטעגאָריע:טראנספארט אין ישראל	Kategori:Transport i Israel
קאַטעגאָריע:יידן און יידישקייט	Kategori:Judaica
קאַטעגאָריע:2006	Kategori:2006
קאַטעגאָריע:2007	Kategori:2007
קאַטעגאָריע:2008	Kategori:2008
קאַטעגאָריע:2009	Kategori:2009
קאַטעגאָריע:2010	Kategori:2010
קאַטעגאָריע:2011	Kategori:2011
פארטאל:עסנווארג	Portal:Mat och dryck
מוסטער:באן ליניע אפט4	Mall:BS4
קאַטעגאָריע:געלט	Kategori:Valutor
קאַטעגאָריע:טייכן	Kategori:Vattendrag
קאַטעגאָריע:ארץ ישראל	Kategori:Israels geografi
מוסטער:User he-3	Mall:Användare he-3
מוסטער:User ro-2	Mall:Användare ro-2
מוסטער:User ru-1	Mall:Användare ru-1
מוסטער:User uk-4	Mall:Användare uk-4
קאַטעגאָריע:היסטאריע פון רוסלאנד	Kategori:Rysslands historia
קאַטעגאָריע:ספארט אין ישראל	Kategori:Sport i Israel
מוסטער:צייט זאנעס אין אייראפע	Mall:Europeiska tidszoner
קאַטעגאָריע:אסטראנויטן	Kategori:Astronauter
קאַטעגאָריע:אייראוויזיאן	Kategori:Eurovision Song Contest
קאַטעגאָריע:געזאנג	Kategori:Sång
קאַטעגאָריע:שוועדישע מענטשן	Kategori:Svenskar
קאַטעגאָריע:אינדיער	Kategori:Indier
קאַטעגאָריע:יאפאנעזער	Kategori:Japaner
קאַטעגאָריע:טעאטער	Kategori:Teater
קאַטעגאָריע:אינזשענירן	Kategori:Ingenjörer
קאַטעגאָריע:ביזנעסלייט	Kategori:Personer inom näringslivet
קאַטעגאָריע:לינגוויסטן	Kategori:Lingvister
קאַטעגאָריע:מחברי ספרים	Kategori:Fackboksförfattare
קאַטעגאָריע:קאמיקער	Kategori:Komiker
קאַטעגאָריע:פרעמיער מיניסטארן פון בריטאניע	Kategori:Storbritanniens premiärministrar
קאַטעגאָריע:פיליפינען	Kategori:Filippinerna
קאַטעגאָריע:ישראלדיקע זינגערס	Kategori:Israeliska sångare
קאַטעגאָריע:באַניצער nl	Kategori:Användare nl
קאַטעגאָריע:באַניצער no	Kategori:Användare no
קאַטעגאָריע:באַניצער zh-1	Kategori:Användare zh-1
קאַטעגאָריע:מעכאניק	Kategori:Mekanik
קאַטעגאָריע:דיפלאמען	Kategori:Akademiska titlar
קאַטעגאָריע:ארמעניע	Kategori:Armenien
קאַטעגאָריע:מלכי פרס	Kategori:Persiska rikets monarker
קאַטעגאָריע:מענטשלעכע אנאטאמיע	Kategori:Människans anatomi
קאַטעגאָריע:טעראר	Kategori:Terrorism
קאַטעגאָריע:אינטערנאציאנאלע באציאונגען	Kategori:Internationella relationer
מוסטער:שפראך-yi	Mall:Lang-yi
קאַטעגאָריע:פארזיכערונג	Kategori:Försäkringsväsen
קאַטעגאָריע:פובליק אינפארמאציע	Kategori:Public relations
קאַטעגאָריע:רעפראדוקציע	Kategori:Fortplantning
קאַטעגאָריע:מחנכים	Kategori:Pedagoger
קאַטעגאָריע:איבונגען	Kategori:Träning
קאַטעגאָריע:שרייבן	Kategori:Skrivande
קאַטעגאָריע:פינאנץ	Kategori:Finansväsen
קאַטעגאָריע:נאוויגאציע	Kategori:Navigation
קאַטעגאָריע:געריכט	Kategori:Domstolar
קאַטעגאָריע:אלטערנאטיווע מעדיצין	Kategori:Alternativmedicin
קאַטעגאָריע:קאמפף קונסט	Kategori:Kampsporter
קאַטעגאָריע:טעלעוויזיע	Kategori:Television
קאַטעגאָריע:וויקיפעדיע אינפארמאציע	Kategori:Wikipedia:Om Wikipedia
קאַטעגאָריע:סיריע	Kategori:Syrien
קאַטעגאָריע:באסקעטבאל	Kategori:Basket
קאַטעגאָריע:בעלגיער	Kategori:Belgare
קאַטעגאָריע:1550ער	Kategori:1550-talet
קאַטעגאָריע:1740ער	Kategori:1740-talet
קאַטעגאָריע:1840ער	Kategori:1840-talet
קאַטעגאָריע:סקולפטארן	Kategori:Skulptörer
קאַטעגאָריע:רוסישע פאליטיקער	Kategori:Ryska politiker
קאַטעגאָריע:16טער י"ה	Kategori:1500-talet
קאַטעגאָריע:18טער י"ה	Kategori:1700-talet
קאַטעגאָריע:נאציאנאליזם	Kategori:Nationalism
קאַטעגאָריע:ראסיזם	Kategori:Rasism
קאַטעגאָריע:טויט	Kategori:Döden
קאַטעגאָריע:פיאניסטן	Kategori:Pianister
קאַטעגאָריע:שיינקייט	Kategori:Skönhet
קאַטעגאָריע:האלבאינדזלען	Kategori:Halvöar
קאַטעגאָריע:דייטשע קאמפאזיטארן	Kategori:Tyska kompositörer
קאַטעגאָריע:וויעטנאמעזער	Kategori:Vietnameser
קאַטעגאָריע:אמעריקאנער פאליטיקער	Kategori:Amerikanska politiker
קאַטעגאָריע:רוסן	Kategori:Ryssar
קאַטעגאָריע:בריטישע פאליטיקער	Kategori:Brittiska politiker
קאַטעגאָריע:סקאטישע מענטשן	Kategori:Skottar
קאַטעגאָריע:ישראלישע פאליטיקער	Kategori:Israeliska politiker
קאַטעגאָריע:ישראלים	Kategori:Israeler
קאַטעגאָריע:טשעכן	Kategori:Tjecker
קאַטעגאָריע:פערסער	Kategori:Perser
קאַטעגאָריע:פיקטיווע כאראקטערן	Kategori:Fiktiva figurer
קאַטעגאָריע:דורכגאסן	Kategori:Sund
קאַטעגאָריע:קאמפיוטער פראגראמען	Kategori:Tillämpningsprogram
קאַטעגאָריע:קלאסישע מוזיק	Kategori:Klassisk musik
קאַטעגאָריע:אויג	Kategori:Ögat
קאַטעגאָריע:גלענדס	Kategori:Körtlar
קאַטעגאָריע:ציינדאקטעריי	Kategori:Odontologi
קאַטעגאָריע:פליפעלדער	Kategori:Flygplatser
קאַטעגאָריע:בויך	Kategori:Buken
קאַטעגאָריע:צענטראלבענק	Kategori:Centralbanker
קאַטעגאָריע:2012	Kategori:2012
קאַטעגאָריע:כעמישע עלעמענטן	Kategori:Grundämnen
קאַטעגאָריע:ניו יארק סיטי	Kategori:New York
קאַטעגאָריע:לעבאנעזער פאליטיקער	Kategori:Libanesiska politiker
קאַטעגאָריע:וויסנשאפטלער	Kategori:Forskare
קאַטעגאָריע:אויספארשערס	Kategori:Upptäcktsresande
קאַטעגאָריע:ראמאניסטן	Kategori:Romanförfattare
קאַטעגאָריע:משפחה נעמען	Kategori:Efternamn
קאַטעגאָריע:וויקיפעדיע גוטע ארטיקלען	Kategori:Wikipedia:Bra artiklar
קאַטעגאָריע:שטומף קאטעגאריעס	Kategori:Alla stubkategorier
קאַטעגאָריע:טראנספארט שטומף	Kategori:Transportstubbar
קאַטעגאָריע:מאטעמאטיק שטומף	Kategori:Matematikstubbar
קאַטעגאָריע:ביאלאגיע שטומף	Kategori:Biologistubbar
קאַטעגאָריע:געאגראפיע שטומף	Kategori:Geografistubbar
קאַטעגאָריע:עסנווארג און געטראנקען שטומף	Kategori:Matstubbar
קאַטעגאָריע:נאבעל פריז	Kategori:Nobelpriset
קאַטעגאָריע:אינציאטיוו מוסטערן	Kategori:Wikiprojektmallar
קאַטעגאָריע:קערפערליכע פליסיגקייט	Kategori:Kroppsvätskor
קאַטעגאָריע:גרוזיע	Kategori:Georgien
קאַטעגאָריע:כינעזער	Kategori:Kineser
קאַטעגאָריע:טעראריסטן	Kategori:Terrorister
קאַטעגאָריע:עסקנים	Kategori:Aktivister
קאַטעגאָריע:מטבעות	Kategori:Mynt
קאַטעגאָריע:וויעטנאמעזער פאליטיקער	Kategori:Vietnamesiska politiker
קאַטעגאָריע:איראנער פאליטיקער	Kategori:Iranska politiker
קאַטעגאָריע:פאקיסטאנער פאליטיקער	Kategori:Pakistanska politiker
קאַטעגאָריע:USA מיליטער	Kategori:USA:s militär
קאַטעגאָריע:רעדאקטארן	Kategori:Redaktörer
קאַטעגאָריע:זשורנאליסטן	Kategori:Journalister
קאַטעגאָריע:זשורנאליזם	Kategori:Journalistik
קאַטעגאָריע:קארעע	Kategori:Korea
קאַטעגאָריע:לבנון	Kategori:Libanon
קאַטעגאָריע:טורקמעניסטאן	Kategori:Turkmenistan
קאַטעגאָריע:אוזבעקיסטאן	Kategori:Uzbekistan
קאַטעגאָריע:דאקטוירים	Kategori:Läkare
קאַטעגאָריע:דייטשישע זינגערס	Kategori:Tyska sångare
קאַטעגאָריע:שפאניער	Kategori:Spanjorer
קאַטעגאָריע:פאראייניגטע קעניגרייך מוסטערן	Kategori:Storbritannienmallar
קאַטעגאָריע:אמעריקאנער מוסטערן	Kategori:USA-mallar
קאַטעגאָריע:ראטנפארבאנד	Kategori:Sovjetunionen
קאַטעגאָריע:איראקער פאליטיקער	Kategori:Irakiska politiker
קאַטעגאָריע:שפראך-מוסטערן	Kategori:Flerspråkiga stödmallar
קאַטעגאָריע:יוגאסלאוויע	Kategori:Jugoslavien
קאַטעגאָריע:וויקיפעדיע ניצלעכקייט מוסטערן	Kategori:Verktygsmallar
קאַטעגאָריע:טראנספארט מוסטערן	Kategori:Transportmallar
קאַטעגאָריע:פאליטיק שטומף	Kategori:Politikstubbar
קאַטעגאָריע:היסטאריע שטומף	Kategori:Historiestubbar
קאַטעגאָריע:אטמאספערע	Kategori:Atmosfär
קאַטעגאָריע:טעכנאלאגיע שטומף	Kategori:Teknikstubbar
קאַטעגאָריע:עקאנאמיק שטומף	Kategori:Ekonomistubbar
קאַטעגאָריע:וויילס	Kategori:Wales
קאַטעגאָריע:ברוקלין	Kategori:Brooklyn
קאַטעגאָריע:טשעכאסלאוואקיי	Kategori:Tjeckoslovakien
קאַטעגאָריע:מענטשן לויט רעליגיע	Kategori:Religiösa personligheter
קאַטעגאָריע:פרעזידענטן פון פראנקרייך	Kategori:Frankrikes presidenter
קאַטעגאָריע:USA פרעזידענטן	Kategori:USA:s presidenter
קאַטעגאָריע:פרעזידענטן פון איראן	Kategori:Irans presidenter
קאַטעגאָריע:אידישע היסטאריע	Kategori:Judisk historia
קאַטעגאָריע:היסטאריע פון אייראפע	Kategori:Europas historia
קאַטעגאָריע:היסטאריע פון וויסנשאפט	Kategori:Vetenskapshistoria
קאַטעגאָריע:נעווראלאגיע	Kategori:Neurologi
קאַטעגאָריע:יארדאניע	Kategori:Jordanien
קאַטעגאָריע:נארוועגיע	Kategori:Norge
קאַטעגאָריע:פאנאמא	Kategori:Panama
קאַטעגאָריע:אנדארע	Kategori:Andorra
קאַטעגאָריע:סערביע	Kategori:Serbien
קאַטעגאָריע:עקוואדאר	Kategori:Ecuador
קאַטעגאָריע:תימן	Kategori:Jemen
קאַטעגאָריע:באליוויע	Kategori:Bolivia
קאַטעגאָריע:לענדער אין אקעאניע	Kategori:Oceaniens länder
קאַטעגאָריע:פיש	Kategori:Fiskar
קאַטעגאָריע:מויל	Kategori:Munnen
קאַטעגאָריע:מיטאלאגיע	Kategori:Mytologi
קאַטעגאָריע:גרינסן	Kategori:Grönsaker
קאַטעגאָריע:מילכיקע פראדוקטן	Kategori:Mejeriprodukter
קאַטעגאָריע:פרוכט	Kategori:Frukter
קאַטעגאָריע:פאליטישע פארטייען	Kategori:Politiska partier
קאַטעגאָריע:בהמות	Kategori:Nötkreatur
קאַטעגאָריע:מוזייען	Kategori:Museer
קאַטעגאָריע:קערנפיזיק	Kategori:Kärnfysik
קאַטעגאָריע:קאטאסטראפע	Kategori:Olyckor
קאַטעגאָריע:2008 פילמען	Kategori:Filmer 2008
קאַטעגאָריע:היסטארישע לענדער	Kategori:Geografiska områden i historien
קאַטעגאָריע:קלימאטאלאגיע	Kategori:Klimatologi
קאַטעגאָריע:געאגראפישע נאוויגאציע מוסטערן	Kategori:Geografiska navigationsrutor
קאַטעגאָריע:ביליאנערן	Kategori:Miljardärer
קאַטעגאָריע:לאנדאנער אונטערגרונט	Kategori:Londons tunnelbana
קאַטעגאָריע:מיסטיק	Kategori:Mystik
קאַטעגאָריע:זען סיסטעם	Kategori:Syn
קאַטעגאָריע:אימון-סיסטעם	Kategori:Immunsystemet
קאַטעגאָריע:אפערירן סיסטעמען	Kategori:Operativsystem
קאַטעגאָריע:נומערן סיסטעם	Kategori:Talsystem
קאַטעגאָריע:פאליטישע וויסנשאפט	Kategori:Statsvetenskap
קאַטעגאָריע:קאנאדישע פראווינצן און טעריטאריעס	Kategori:Kanadas provinser och territorier
קאַטעגאָריע:לאנדאן	Kategori:London
קאַטעגאָריע:אמנאניים	Kategori:Ciklider
קאַטעגאָריע:פאנטאזיע	Kategori:Fantasy
קאַטעגאָריע:גריכיש	Kategori:Kultur i Grekland
קאַטעגאָריע:וויקימעדיע פונדאציע	Kategori:Wikimedia
קאַטעגאָריע:ראדיא	Kategori:Radio
קאַטעגאָריע:עוואלוציע	Kategori:Evolution
קאַטעגאָריע:סאציאליזם	Kategori:Socialism
קאַטעגאָריע:בעלי חיים	Kategori:Djur
קאַטעגאָריע:פאנעטיק	Kategori:Fonetik
קאַטעגאָריע:וואג	Kategori:Viktmått
קאַטעגאָריע:טאלן	Kategori:Dalar
קאַטעגאָריע:אויער	Kategori:Örat
מוסטער:אמעריקעמיל	Mall:USA:s försvar
קאַטעגאָריע:דעמאגראפיע	Kategori:Demografi
קאַטעגאָריע:מעדיצינישע טערמינען	Kategori:Medicinska termer
קאַטעגאָריע:ראשי תיבות	Kategori:Akronymer
קאַטעגאָריע:אברים	Kategori:Organ
קאַטעגאָריע:סימפטאמען	Kategori:Medicinska symtom
קאַטעגאָריע:געווער	Kategori:Vapen
קאַטעגאָריע:אייראוויזיאן באטייליקטערס	Kategori:Deltagare i Eurovision Song Contest
קאַטעגאָריע:מעבל	Kategori:Möbler
קאַטעגאָריע:ישראלישע פארטיידיגונג מיניסטארן	Kategori:Israels försvarsministrar
רייכערן	Tobaksrökning
קאַטעגאָריע:מוזיק אינסטרומענטן	Kategori:Musikinstrument
קאַטעגאָריע:איידלשטיינער	Kategori:Ädelstenar
קאַטעגאָריע:בליצפאסט	Kategori:E-post
קאַטעגאָריע:מעטעאראלאגיע	Kategori:Meteorologi
קאַטעגאָריע:צענטראלע אמעריקע	Kategori:Centralamerika
קאַטעגאָריע:אלקאהאלישע געטראנקען	Kategori:Alkoholdrycker
קאַטעגאָריע:קליידונג	Kategori:Kläder
קאַטעגאָריע:גראפנשאפטן אין ענגלאנד	Kategori:Englands grevskap
קאַטעגאָריע:ברענווארג	Kategori:Bränslen
קאַטעגאָריע:רוימישע מיטאלאגיע	Kategori:Romersk mytologi
קאַטעגאָריע:גריכישע מיטאלאגיע	Kategori:Grekisk mytologi
קאַטעגאָריע:געוועב	Kategori:Vävnader
קאַטעגאָריע:פלייש	Kategori:Kött
קאַטעגאָריע:לידער	Kategori:Sånger
קאַטעגאָריע:הויפטשטעט	Kategori:Huvudstäder
קאַטעגאָריע:שטעט אין גרוזיע	Kategori:Orter i Georgien
קאַטעגאָריע:שטעט אין רוסלאנד	Kategori:Orter i Ryssland
קאַטעגאָריע:שטעט אין אונגארן	Kategori:Orter i Ungern
חשבון	Elementär aritmetik
קאַטעגאָריע:לינדזן	Kategori:Linser
קאַטעגאָריע:בלוט	Kategori:Blod
קאַטעגאָריע:גאזן	Kategori:Gaser
קאַטעגאָריע:יידישע אויטאנאמע געגנט	Kategori:Judiska autonoma länet
קאַטעגאָריע:טעלעקאמוניקאציע	Kategori:Telekommunikation
קאַטעגאָריע:ארכעאלאגיע	Kategori:Arkeologi
קאַטעגאָריע:ווארט פראצעסארן	Kategori:Ordbehandlare
קאַטעגאָריע:נעצווערק פראטאקאלן	Kategori:Nätverksprotokoll
קאַטעגאָריע:קרענק	Kategori:Sjukdomar
קאַטעגאָריע:האטעלן	Kategori:Hotell
קאַטעגאָריע:עלעקטריע	Kategori:Elektricitet
קאַטעגאָריע:באַניצער pl	Kategori:Användare pl
קאַטעגאָריע:טראנספארט	Kategori:Transport
קאַטעגאָריע:טאנץ	Kategori:Dans
קאַטעגאָריע:כאליפן	Kategori:Kalifer
קאַטעגאָריע:משפחה	Kategori:Familjeliv
קאַטעגאָריע:1590ער	Kategori:1590-talet
קאַטעגאָריע:1620ער	Kategori:1620-talet
קאַטעגאָריע:1600ער	Kategori:1600-talet (decennium)
קאַטעגאָריע:1690ער	Kategori:1690-talet
קאַטעגאָריע:יוסטיץ	Kategori:Rättvisa
קאַטעגאָריע:אמונה	Kategori:Tro
קאַטעגאָריע:קאמוניזם	Kategori:Kommunism
קאַטעגאָריע:קוילנשטאף	Kategori:Kol
קאַטעגאָריע:שלענג	Kategori:Ormar
קאַטעגאָריע:קיסרים	Kategori:Kejsare
קאַטעגאָריע:טיילן פון רעדן	Kategori:Ordklasser
קאַטעגאָריע:לאגיק	Kategori:Logik
קאַטעגאָריע:לעגענדעס	Kategori:Legender
קאַטעגאָריע:ריכטער	Kategori:Domare
קאַטעגאָריע:נומערן טעאריע	Kategori:Talteori
קאַטעגאָריע:צפון אמעריקע	Kategori:Nordamerika
קאַטעגאָריע:זינגער	Kategori:Sångare
קאַטעגאָריע:מדבריות	Kategori:Öknar
קאַטעגאָריע:אזערעס	Kategori:Insjöar
קאַטעגאָריע:פאנען	Kategori:Flaggor
קאַטעגאָריע:אדוואקאטן	Kategori:Advokater
קאַטעגאָריע:באנקירן	Kategori:Bankirer
קאַטעגאָריע:פוסבאלערס	Kategori:Fotbollsspelare
קאַטעגאָריע:מאטעמאטיקער	Kategori:Matematiker
קאַטעגאָריע:פיזיקער	Kategori:Fysiker
קאַטעגאָריע:עקאנאמיסטן	Kategori:Nationalekonomer
קאַטעגאָריע:אקעאניע	Kategori:Oceanien
קאַטעגאָריע:שטעט אין דרום אמעריקע	Kategori:Städer i Sydamerika
קאַטעגאָריע:שטעט אין אפריקע	Kategori:Städer i Afrika
קאַטעגאָריע:1830ער	Kategori:1830-talet
קאַטעגאָריע:מעלות	Kategori:Dygder
קאַטעגאָריע:פיקציע	Kategori:Fiktion
קאַטעגאָריע:וואסערפאלן	Kategori:Vattenfall
קאַטעגאָריע:בוענאס איירעס	Kategori:Buenos Aires
קאַטעגאָריע:דעמאקראטיע	Kategori:Demokrati
קאַטעגאָריע:מענטשליכע באציאונגען	Kategori:Sociala relationer
קאַטעגאָריע:מוסולמענער	Kategori:Personligheter inom islam
קאַטעגאָריע:מעדיקאמענטן	Kategori:Läkemedel
קאַטעגאָריע:אויטאמאבילן	Kategori:Bilar
קאַטעגאָריע:לימביק סיסטעם	Kategori:Limbiska systemet
קאַטעגאָריע:USA רעגירונג	Kategori:USA:s administration
קאַטעגאָריע:הויפטשטעט אין צפון אמעריקע	Kategori:Nordamerikas huvudstäder
קאַטעגאָריע:ענגלישע יידן	Kategori:Personer inom judendomen i Storbritannien
קאַטעגאָריע:קיבוצים	Kategori:Kibbutzer
קאַטעגאָריע:הויפטשטעט אין דרום אמעריקע	Kategori:Sydamerikas huvudstäder
קאַטעגאָריע:הויפטשטעט אין אפריקע	Kategori:Afrikas huvudstäder
קאַטעגאָריע:שטעטלעך אין רומעניע	Kategori:Orter i Rumänien
קאַטעגאָריע:שטעט אין בעלגיע	Kategori:Belgiens kommuner
קאַטעגאָריע:שטעט אין שפאניע	Kategori:Orter i Spanien
קאַטעגאָריע:שטעט אין אוקראינע	Kategori:Orter i Ukraina
קאַטעגאָריע:שטעט אין איטאליע	Kategori:Orter i Italien
קאַטעגאָריע:רעגיי זינגערס	Kategori:Reggaemusiker
קאַטעגאָריע:חתונה	Kategori:Äktenskap
קאַטעגאָריע:רציחות	Kategori:Massakrer
קאַטעגאָריע:סקאטלאנד	Kategori:Skottland
קאַטעגאָריע:עסטרייכישע קיך	Kategori:Mat och dryck i Österrike
קאַטעגאָריע:בריסל	Kategori:Bryssel
קאַטעגאָריע:הויפטשטעט אין אייראפע	Kategori:Europas huvudstäder
קאַטעגאָריע:הויפטשטעט אין אזיע	Kategori:Asiens huvudstäder
קאַטעגאָריע:טעם	Kategori:Avsmakning
קאַטעגאָריע:טורעמס	Kategori:Torn
קאַטעגאָריע:רעסטאראנען	Kategori:Restauranger
מוסטער:אפיציעלע EU שפראכן	Mall:EU-språk
קאַטעגאָריע:באן	Kategori:Tåg
קאַטעגאָריע:באל שפילעריי	Kategori:Bollsport
קאַטעגאָריע:בענק	Kategori:Banker
הילף:בלעטער װעלכע פארבינדן אהער	Wikipedia:Sidor som länkar hit
קאַטעגאָריע:זשורנאלן	Kategori:Akademiska tidskrifter
קאַטעגאָריע:פערד	Kategori:Hästdjur
קאַטעגאָריע:ישראל פאלעסטינער קאנפליקט	Kategori:Israel-Palestina-konflikten
קאַטעגאָריע:בשותפות ווארג	Kategori:Sharewareprogram
מוסטער:פרעמיער מיניסטארן פון ישראל	Mall:Israels premiärministrar
קאַטעגאָריע:מיטל אלטער	Kategori:Medeltiden
קאַטעגאָריע:קאווקאז	Kategori:Kaukasus
קאַטעגאָריע:מוזיקפילמען	Kategori:Musikaler
קאַטעגאָריע:נאגערס	Kategori:Gnagare
מוסטער:יארצענדלינגקעסטל	Mall:Årtal decennium
קאַטעגאָריע:אייראפע געאגראפיע שטומף	Kategori:Geografistubbar-Europa
קאַטעגאָריע:אפריקע געאגראפיע שטומף	Kategori:Geografistubbar-Afrika
קאַטעגאָריע:אזיע געאגראפיע שטומף	Kategori:Geografistubbar-Asien
קאַטעגאָריע:רוחניות	Kategori:Andlighet
קאַטעגאָריע:מעדיטאציע	Kategori:Meditation
קאַטעגאָריע:שולעס	Kategori:Skolor
קאַטעגאָריע:געזונט	Kategori:Hälsa
קאַטעגאָריע:לעגענדע	Kategori:Sägner
הויפטקווארטיר	Högkvarter
מוסטער:שפראך-mk	Mall:Lang-mk
קאַטעגאָריע:פאליטישע פארטייען אין ישראל	Kategori:Politiska partier i Israel
קאַטעגאָריע:פאפ מוזיק	Kategori:Popmusik
קאַטעגאָריע:פארט שטעט אינעם פאראייניגטן קעניגרייך	Kategori:Hamnar i Storbritannien
קאַטעגאָריע:אלבאמען	Kategori:Musikalbum
גרופע סעקס	Gruppsex
מוסטער:שפראך-pl	Mall:Lang-pl
קאַטעגאָריע:וויצע פרעזידענטן	Kategori:Vicepresidenter
קאַטעגאָריע:צייטונגען ארויסגעגעבן אין ישראל	Kategori:Israeliska tidningar
קאַטעגאָריע:וויסנשאפט שטומף	Kategori:Vetenskapsstubbar
פארטאל:מאטעמאטיק	Portal:Matematik
קאַטעגאָריע:פיזיאלאגיע	Kategori:Fysiologi
מוסטער:וויסן-שטומף	Mall:Vetenskapsstub
מוסטער:בילדונג-שטומף	Mall:Utbildningsstub
קאַטעגאָריע:יידיש שפראך שרייבערס	Kategori:Jiddischspråkiga författare
גאטקעס	Kalsonger
קאַטעגאָריע:זאא-גערטנער	Kategori:Djurparker
קאַטעגאָריע:ציוניזם	Kategori:Sionism
קאַטעגאָריע:פראפעסארן	Kategori:Professorer
קאַטעגאָריע:קאמפאזיטארן	Kategori:Kompositörer
קאַטעגאָריע:שטעט אין עסטרייך	Kategori:Orter i Österrike
קאַטעגאָריע:לענדער אין אזיע	Kategori:Asiens länder
מוסטער:G8 שטאטן	Mall:G8
מוסטער:אלקאהאלישע געטראנקען	Mall:Alkoholdrycker
מוסטער:אנווייזונגען ליסטע	Mall:Riktlinjer
קאַטעגאָריע:Windows קאמפאנענטן	Kategori:Windows-komponenter
װיקיפּעדיע:באג באריכטן	Wikipedia:Felrapporter
קאַטעגאָריע:וויקיפעדיע סטאטיסטיק	Kategori:Wikipedia:Statistik
קאַטעגאָריע:וויקיפעדיע אינציאטיוון	Kategori:Wikipedia:Samarbeten
מוסטער:User hi-2	Mall:Användare hi-2
קאַטעגאָריע:ווייסע הויז	Kategori:Vita huset
מוסטער:שפראך-gd	Mall:Lang-gd
מוסטער:שפראך-fj	Mall:Lang-fj
מוסטער:שפראך-et	Mall:Lang-et
מוסטער:שפראך-es	Mall:Lang-es
מוסטער:שפראך-ca	Mall:Lang-ca
מוסטער:שפראך-bn	Mall:Lang-bn
קאַטעגאָריע:פרעמיער מיניסטארן פון רוסלאנד	Kategori:Rysslands premiärministrar
קאַטעגאָריע:טי ווי קאנאלן	Kategori:TV-kanaler
קאַטעגאָריע:וואשינגטאן די סי	Kategori:Washington, D.C.
קאַטעגאָריע:געזעצן	Kategori:Lagar
װיקיפּעדיע:ספעציעלע בלעטער	Wikipedia:Namnrymder/Special
קאַטעגאָריע:אלגעברע	Kategori:Algebra
קאַטעגאָריע:אריטמעטיק	Kategori:Aritmetik
קאַטעגאָריע:גענעאלאגן	Kategori:Genealoger
קאַטעגאָריע:בבל	Kategori:Babylon
קאַטעגאָריע:סעקס	Kategori:Sexualitet
קאַטעגאָריע:באנוצער מוסטערן	Kategori:Användarrutor
קאַטעגאָריע:בריקן	Kategori:Broar
קאַטעגאָריע:דארבי	Kategori:Derby
טערמינאלאגיע	Terminologi
קאַטעגאָריע:קריג	Kategori:Krig
קאַטעגאָריע:בילדונג שטומף	Kategori:Utbildningsstubbar
קאַטעגאָריע:הארטווארג	Kategori:Datorhårdvara
קאַטעגאָריע:נויטפאל מעדיצין	Kategori:Akutvård
קאַטעגאָריע:ענערגיע	Kategori:Energi
קאַטעגאָריע:סביבה	Kategori:Miljö
מוסטער:שפראך-zh	Mall:Zh
מוסטער:שפראך-sa	Mall:Lang-sa
מוסטער:שפראך-sc	Mall:Lang-sc
קאַטעגאָריע:פליגן	Kategori:Tvåvingar
קאווע שטיבל	Cafeteria
קאַטעגאָריע:שאסייען	Kategori:Motorvägar
קאַטעגאָריע:גערמאנישע שפראכן	Kategori:Germanska språk
קאַטעגאָריע:געטאס	Kategori:Getton under andra världskriget
מוסטער:Precision1	Mall:Precision1
קאַטעגאָריע:גריכישער אלפאבעט	Kategori:Grekiska alfabetet
קאַטעגאָריע:גרעגאריאנישער קאלענדאר	Kategori:Gregorianska kalendern
קאַטעגאָריע:היסטאריע פון ארץ ישראל	Kategori:Palestinas historia
קאַטעגאָריע:שחיטות אין דעם חורבן	Kategori:Pogromer
קאַטעגאָריע:חורבן אייראפע מוזייען	Kategori:Förintelsemuseer
קאַטעגאָריע:שארית הפליטה	Kategori:Förintelseöverlevare
קאַטעגאָריע:הארמאנען	Kategori:Hormoner
קאַטעגאָריע:הומאריסטן	Kategori:Humorister
קאַטעגאָריע:הומאר	Kategori:Humor
קאַטעגאָריע:ריינקייט	Kategori:Hygien
קאַטעגאָריע:אימפעריאליזם	Kategori:Imperialism
קאַטעגאָריע:אנארכיזם	Kategori:Anarkism
קאַטעגאָריע:ישראל שטומף	Kategori:Israelstubbar
װיקיפּעדיע:היסטאריע	Wikipedia:Versionshistorik
קאַטעגאָריע:ירושלים	Kategori:Jerusalem
קאַטעגאָריע:נגינה	Kategori:Judisk musik
קאַטעגאָריע:יידישקייט שטומף	Kategori:Judendomsstubbar
קאַטעגאָריע:שופטים	Kategori:Domare i Gamla Testamentet
קאַטעגאָריע:ביבליאטעקן	Kategori:Bibliotek
קאַטעגאָריע:בירגערמייסטערס	Kategori:Borgmästare
הילף:באנוצער'ס אלע טיילונגען	Wikipedia:Mina bidrag
קאַטעגאָריע:ראסע	Kategori:Människoraser
קאַטעגאָריע:באן טראנספארט אין בעלגיע	Kategori:Järnväg i Belgien
קאַטעגאָריע:באן סטאנציעס	Kategori:Järnvägsstationer
קאַטעגאָריע:ארטיקלען צו איבערקוקן	Kategori:Begäran om detaljgranskning
קאַטעגאָריע:קליינהאנדל	Kategori:Detaljhandel
קאַטעגאָריע:חסידי אומות העולם	Kategori:Rättfärdig bland folken
מוסטער:טעכ-שטומף	Mall:Teknikstub
קאַטעגאָריע:רוים	Kategori:Rom
קאַטעגאָריע:ארגאנישע כעמיע	Kategori:Organisk kemi
קאַטעגאָריע:כארדאטן	Kategori:Ryggsträngsdjur
קאַטעגאָריע:שיפן	Kategori:Fartyg
קאַטעגאָריע:לעבנסשטייגער	Kategori:Livsstil
קאַטעגאָריע:רויכערונג	Kategori:Rökning
קאַטעגאָריע:סאציאליסטן	Kategori:Socialister
קאַטעגאָריע:דיכטונגען	Kategori:Dikter
קאַטעגאָריע:פארט שטעט אין אייראפע	Kategori:Hamnstäder i Europa
קאַטעגאָריע:אמעריקאנער פרעזידענט וואלן 2008	Kategori:Presidentvalet i USA 2008
קאַטעגאָריע:קור ערטער	Kategori:Kurorter
קאַטעגאָריע:קילונג	Kategori:Kylning
קאַטעגאָריע:בירגערמייסטער פון ניו יארק	Kategori:Borgmästare i New York
קאַטעגאָריע:לאנדאנער אונטערגרונט סטאנציעס	Kategori:Londons tunnelbanestationer
קאַטעגאָריע:פוליצער פרייז	Kategori:Pulitzerpriset
קאַטעגאָריע:מאנטרעאל	Kategori:Montreal
קאַטעגאָריע:אנטיסעמיטיזם	Kategori:Antisemitism
קאַטעגאָריע:אמעריקאנער גובערנאטארן	Kategori:Amerikanska guvernörer
קאַטעגאָריע:פאראייניגטע שטאטן סענאטארן	Kategori:Ledamöter av USA:s senat
קאַטעגאָריע:תל אביב	Kategori:Tel Aviv
קאַטעגאָריע:טעלעפאניע	Kategori:Telefoni
קאַטעגאָריע:שולן	Kategori:Synagogor
קאַטעגאָריע:סאו פאולא	Kategori:São Paulo
קאַטעגאָריע:באהאמאס	Kategori:Bahamas
קאַטעגאָריע:קאלירן	Kategori:Färg
קאַטעגאָריע:אנטווערפן	Kategori:Antwerpen
קאַטעגאָריע:קאכן געצייג	Kategori:Köksredskap
קאַטעגאָריע:גלחים	Kategori:Präster
קאַטעגאָריע:אנגעווענדעטע וויסנשאפטן	Kategori:Tillämpade vetenskaper
קאַטעגאָריע:רייניגונגס געצייגן	Kategori:Städredskap
מוסטער:בילד קלעבל אנהייב	Mall:Image label begin
קאַטעגאָריע:אפיקורסים	Kategori:Ateister
קאַטעגאָריע:קרייז	Kategori:Cirklar
קאַטעגאָריע:פרעמיער מיניסטארן פון קאנאדע	Kategori:Kanadas premiärministrar
קאַטעגאָריע:פרעזידענטן פון ישראל	Kategori:Israels presidenter
קאַטעגאָריע:רעוואלוציעס	Kategori:Revolutioner
קאַטעגאָריע:הייצונג	Kategori:Uppvärmning
קאַטעגאָריע:שטעט	Kategori:Städer
קאַטעגאָריע:באַניצער en-1	Kategori:Användare en-1
קאַטעגאָריע:באַניצער de-1	Kategori:Användare de-1
קאַטעגאָריע:ווערקצייג	Kategori:Verktyg
מוסטער:ישראל-שטומף	Mall:Israelstub
מוסטער:מיל-שטומף	Mall:Militärstub
ליסטע פון קאלירן	Lista över färger
מהללאל	Mahalalel
מוסטער:פאראייניגטע שטאטן הויפטשטעט	Mall:USA:s delstatshuvudstäder
שונאים	The Haters
מוסטער:פרעמיער מיניסטארן פונעם פאראייניקטן קעניגרייך	Mall:Storbritanniens premiärministrar
ווינסטאן	Winston
װיקיפּעדיע:קאנטראלירן בלעטער/Translation	Wikipedia:Projekt wikifiering/Syntaxfel/Translation
מוסטער:י"ה-קעסטל	Mall:Årtal sekel
מוסטער:User ru-3	Mall:Användare ru-3
מוסטער:שפראך-hif	Mall:Lang-hif
מוסטער:User nl-3	Mall:Användare nl-3
מוסטער:צייכן	Mall:Symbol
מוסטער:שפראך-sco	Mall:Lang-sco
מאראמאראש	Maramureș
מוסטער:לאנדאנער באראס בילדמאפע	Mall:London boroughs imagemap
קלינטאן	Clinton (engelsk släkt)
באסטאנער מאראטאן אטאקע	Bombdåden vid Boston Marathon 2013
מוסטער:לענדער ארום דעם שווארצן ים	Mall:Svarta havet
װיקיפּעדיע:וויזועל-רעדאקטירער	Wikipedia:VisualEditor
װיקיפּעדיע:אקטועלע געשעענישן	Wikipedia:Hur sidan Aktuella händelser fungerar
ווינער שניצל	Schnitzel
פימפ	Hallick
פלאטערל	Dagfjärilar
מוסטער:Harvard citation/core	Mall:Harvard citation/core
מוסטער:קאנאדע פרעמיער מיניסטארן	Mall:Kanadas premiärministrar
מוסטער:סוף	Mall:Avsluta
נעקראפאל פון גיזע	Gizaplatån
עלעקטרישע הייצונג סיסטעם	Elvärme
מוסטער:Style/ril	Mall:Style/ril
כלל	Kollektiv
מוסטער:Style/IPA	Mall:Style/IPA
מוסטער:Style/yid	Mall:Style/yid
נאריש און נארישער אויך	Dum & dummare 2
אידא	Ida (film)
אהרן דאום	Ahron Daum
געדולד	Tålamod
באַזונדער:לעצטע ענדערונגען	Special:Senaste ändringar
נאטאליא פאקלאנסקאיא	Natalja Poklonskaja
אדאם טשערניאקאוו	Adam Czerniaków
א (אות)	Alef
פויסט	Knytnäve
On Suffocation	On Suffocation
שיסעריי אין דער רעדאקציע פון שארלי עבדא	Attentatet mot Charlie Hebdo
