阿非利加洲	Afrika
日本	Japan
挪威	Norge
英格蘭	England
蘇格蘭	Skottland
愛爾蘭共和國	Irland
匈牙利	Ungern
西班牙	Spanien
美國	USA
比利時	Belgien
盧森堡	Luxemburg
宇宙	Universum
坤輿	Jorden
死	Döden
人	Människa
華盛頓	George Washington
芬蘭	Finland
瑞典	Sverige
丹麥	Danmark
波蘭	Polen
立陶宛	Litauen
義大利	Italien
瑞士	Schweiz
奧地利	Österrike
希臘共和國	Grekland
土耳其	Turkiet
啤酒	Öl
葡萄牙	Portugal
歐羅巴洲	Europa
亞細亞洲	Asien
南極洲	Antarktis
維基大典	Wikipedia
荷蘭	Nederländerna
紐約市	New York
華盛頓哥倫比亞特區	Washington, D.C.
柏林	Berlin
電腦	Dator
共筆臺	Mediawiki
倫敦	London
巴黎	Paris
安卓	Android (operativsystem)
谷歌	Google
墨西哥	Mexiko
太平洋	Stilla havet
熒惑	Mars (planet)
衣索比亞	Etiopien
迦納	Ghana
法國	Frankrike
世界語	Esperanto
犬	Hund
英國	Storbritannien
貓	Katt
中華人民共和國	Kina
法蘭西語	Franska
維基爾雅	Wiktionary
乙醇	Etanol
巴西	Brasilien
醇	Alkoholer
俄羅斯	Ryssland
光導纖維	Fiberoptik
正方形	Kvadrat
圓周率	Pi
共筆	Wiki
魁北克	Québec
維基媒體基金會	Wikimedia Foundation
威霽彌	Jimmy Wales
德國	Tyskland
白俄羅斯	Vitryssland
德語	Tyska
冰島	Island
愛沙尼亞	Estland
鎮星	Saturnus
飛機	Flygplan
一	1 (tal)
二	2 (tal)
三	3 (tal)
〇	0 (tal)
無限	Oändlighet
拉脫維亞	Lettland
烏克蘭	Ukraina
捷克	Tjeckien
斯洛伐克	Slovakien
羅馬尼亞	Rumänien
保加利亞	Bulgarien
羅馬	Rom
馬其頓	Makedonien
格陵蘭	Grönland
哈薩克	Kazakstan
古巴	Kuba
印度尼西亞	Indonesien
莫扎特	Wolfgang Amadeus Mozart
貝多芬	Ludwig van Beethoven
南非	Sydafrika
商博良	Jean-François Champollion
阿爾及利亞	Algeriet
水	Vatten
電視	Television
智利	Chile
耶穌	Jesus
伽利略	Galileo Galilei
辰星	Merkurius
史	Historia
蘋果公司	Apple Inc.
太白	Venus
語言	Språk
愛	Kärlek
歲星	Jupiter
銀河	Vintergatan
大霹靂	Big Bang
天王星	Uranus
英文維基大典	Engelskspråkiga Wikipedia
海王星	Neptunus
新加坡	Singapore
格致	Vetenskap
冥王星	Pluto
列支敦士登	Liechtenstein
希特勒	Adolf Hitler
臉書	Facebook
第一次世界大戰	Första världskriget
第二次世界大戰	Andra världskriget
烏邦土	Ubuntu
數學	Matematik
拉丁語	Latin
巴林	Bahrain
塞爾維亞	Serbien
月	Månen
澳大利亞	Australien
物理	Fysik
阿根廷	Argentina
秘魯	Peru
生物學	Biologi
朝鮮民主主義人民共和國	Nordkorea
柬埔寨	Kambodja
古蘭經	Koranen
恐龍	Dinosaurier
回教	Islam
大英百科	Encyclopædia Britannica
歐羅巴聯盟	Europeiska unionen
朋友	Vänskap
馬里亞納海溝	Marianergraven
珠穆朗瑪峰	Mount Everest
拿破崙一世	Napoleon I
恆星	Stjärna
日	Solen
巴斯特	Louis Pasteur
光年	Ljusår
大洋洲	Oceanien
太陽系	Solsystemet
氫	Väte
氦	Helium
維基共享	Wikimedia Commons
鋰	Litium
鈹	Beryllium
日（曆法）	Dygn
東帝汶	Östtimor
夜	Natt
黑洞	Svart hål
穀神星	Ceres (dvärgplanet)
妊神星	Haumea (dvärgplanet)
鳥神星	Makemake (dvärgplanet)
鬩神星	Eris (dvärgplanet)
硼	Bor
碳	Kol
氮	Kväve
氧	Syre
行星	Planet
威尼斯	Venedig
火影忍者	Naruto
莫斯科	Moskva
氟	Fluor
義大利語	Italienska
氖	Neon
鈉	Natrium
鎂	Magnesium
鋁	Aluminium
紐西蘭	Nya Zeeland
印度	Indien
硅	Kisel
磷	Fosfor
鐵	Järn
硫	Svavel
東	Öster
氯	Klor
巴布亞新幾內亞	Papua Nya Guinea
莎士比亞	William Shakespeare
氬	Argon
鉀	Kalium
鈣	Kalcium
鉛	Bly
蒙古國	Mongoliet
鈧	Skandium
鈦	Titan
委內瑞拉	Venezuela
成吉思汗	Djingis khan
釩	Vanadin
鉻	Krom
阿姆斯特丹	Amsterdam
動物	Djur
錳	Mangan
哥倫比亞	Colombia
鈷	Kobolt
鎢	Volfram
鎳	Nickel
佛教	Buddhism
玻利維亞	Bolivia
銅	Koppar
千里達及托巴哥	Trinidad och Tobago
植物	Växt
鋅	Zink
真菌	Svampar
牙買加	Jamaica
夏威夷	Hawaii
海地	Haiti
伊朗	Iran
伊拉克	Irak
哥斯大黎加	Costa Rica
以色列	Israel
巴拿馬	Panama
科威特	Kuwait
老撾	Laos
馬爾地夫	Maldiverna
亞美利加洲	Amerika
馬來西亞	Malaysia
緬甸	Burma
尼泊爾	Nepal
阿曼	Oman
巴基斯坦	Pakistan
卡達國	Qatar
沙特阿拉伯	Saudiarabien
斯里蘭卡	Sri Lanka
斯大林	Josef Stalin
柏拉圖	Platon
鎵	Gallium
神奇寶貝	Pokémon
中華民國	Taiwan
鍺	Germanium
泰國	Thailand
砒	Arsenik
硒	Selen
溴	Brom
鉑	Platina
越南	Vietnam
大韓民國	Sydkorea
氪	Krypton
阿富汗	Afghanistan
江南風	Gangnam Style
銣	Rubidium
金	Guld
蘇彝士運河	Suezkanalen
孟加拉國	Bangladesh
蘇格拉底	Sokrates
安哥拉	Angola
不丹	Bhutan
汶萊	Brunei
汞	Kvicksilver
菲律賓	Filippinerna
中非	Centralafrikanska republiken
鉈	Tallium
南極	Sydpolen
北極	Nordpolen
牛頓	Isaac Newton
鍶	Strontium
釔	Yttrium
鉍	Vismut
尚比亞	Zambia
津巴布韋	Zimbabwe
北京市	Peking
南蘇丹	Sydsudan
海參崴	Vladivostok
波札那	Botswana
剛果民主共和國	Kongo-Kinshasa
吉布提	Djibouti
加蓬	Gabon
甘地	Mahatma Gandhi
利比亞	Libyen
馬達加斯加	Madagaskar
摩洛哥	Marocko
莫桑比克	Moçambique
納米比亞	Namibia
尼日利亞	Nigeria
烏干達	Uganda
索馬里	Somalia
凱撒	Julius Caesar
蘇丹	Sudan
斯威士蘭	Swaziland
鍀	Teknetium
天演	Evolution
聯合國	Förenta nationerna
地理學	Geografi
腦	Hjärna
布拉格	Prag
銀	Silver
錫	Tenn
鈾	Uran
鈈	Plutonium
碘	Jod
氙	Xenon
銫	Cesium
鐳	Radium
氡	Radon
賈坎德邦	Jharkhand
耶路撒冷	Jerusalem
印度洋	Indiska oceanen
科索沃	Kosovo
蕭邦	Frédéric Chopin
Category:類	Kategori:Topp
帕斯卡	Blaise Pascal
冬	Vinter
春	Vår
夏	Sommar
秋	Höst
薩達姆·海珊	Saddam Hussein
拉登	Usama bin Ladin
西班牙語	Spanska
巴赫	Johann Sebastian Bach
泉幣	Pengar
奧古斯都	Augustus
諾基亞	Nokia
德克薩斯州	Texas
布宜諾斯艾利斯	Buenos Aires
東京都	Tokyo prefektur
密西西比河	Mississippifloden
錫金	Sikkim
尼爾杭思朗	Neil Armstrong
斯德哥爾摩	Stockholm
墓誌	Epitafium
里加	Riga
聖經	Bibeln
金邊	Phnom Penh
真耶穌教會	The True Jesus Church
英語	Engelska
曼谷	Bangkok
臺北市	Taipei
鎇	Americium
康賽普西翁	Concepción, Chile
緬尼托巴	Manitoba
孔斯科沃拉	Końskowola
公元二千年	2000
二〇〇三年	2003
二〇〇二年	2002
二〇〇一年	2001
二〇一二年	2012
二〇一一年	2011
二〇一〇年	2010
二〇〇九年	2009
二氧化碳	Koldioxid
二〇一三年	2013
二〇一四年	2014
二〇一五年	2015
二〇〇八年	2008
二〇〇四年	2004
二〇〇五年	2005
二〇〇六年	2006
二〇〇七年	2007
一氧化碳	Kolmonoxid
戴高樂	Charles de Gaulle
一九九二年	1992
一九九一年	1991
一九九〇年	1990
一九九三年	1993
一九九四年	1994
一九九五年	1995
一九九六年	1996
可縮放矢量圖形	Scalable Vector Graphics
萊比錫	Leipzig
一九九七年	1997
一九九八年	1998
一九九九年	1999
食物	Mat
光速	Ljusets hastighet
公曆一月一日	1 januari
公曆一月二日	2 januari
公曆一月三日	3 januari
公曆一月四日	4 januari
矮行星	Dvärgplanet
公曆一月五日	5 januari
公曆一月六日	6 januari
電子	Elektron
公曆一月七日	7 januari
公曆一月八日	8 januari
公曆一月九日	9 januari
公曆一月十日	10 januari
公曆一月十一日	11 januari
公曆一月十二日	12 januari
公曆一月十三日	13 januari
公曆一月十四日	14 januari
公曆一月十五日	15 januari
工業革命	Industriella revolutionen
苯	Bensen
微軟	Microsoft
質子	Proton
庫魯夫	Kurów
公曆二月五日	5 februari
公曆二月八日	8 februari
化學	Kemi
中子	Neutron
公曆二月廿九日	29 februari
公曆三月十四日	14 mars
一九八九年	1989
一九八八年	1988
一九八七年	1987
一九八六年	1986
一九八五年	1985
一九八四年	1984
一九八三年	1983
一九八二年	1982
一九八一年	1981
一九八〇年	1980
一九七〇年	1970
一九七一年	1971
一九七二年	1972
一九七三年	1973
一九七四年	1974
一九七五年	1975
一九七六年	1976
一九七七年	1977
一九七八年	1978
一九七九年	1979
一九六九年	1969
公曆四月五日	5 april
衛星	Måne
公曆五月四日	4 maj
土衛六	Titan (måne)
一九六八年	1968
一九六七年	1967
一九六六年	1966
一九六五年	1965
一九六四年	1964
公曆六月廿日	20 juni
公曆七月廿三日	23 juli
足球	Fotboll
一九六三年	1963
一九六二年	1962
公曆九月十日	10 september
公曆十二月卅一日	31 december
公曆十月十日	10 oktober
灶神星	4 Vesta
查理曼	Karl den store
木衛一	Io (måne)
木衛四	Callisto
木衛二	Europa (måne)
木衛三	Ganymedes (måne)
火	Eld
新南威爾士州	New South Wales
土衛二	Enceladus
天衛三	Titania
海衛一	Triton (måne)
雅加達	Jakarta
一九六一年	1961
Category:模板	Kategori:Mallar
一九六〇年	1960
小行星	Asteroid
日食	Solförmörkelse
二進制	Binära talsystemet
阿斯圖里亞斯	Asturien
維基大典:沙盒	Wikipedia:Sandlådan
卡爾梅克共和國	Kalmuckien
代數學	Algebra
地圖	Karta
阿拉貢自治區	Aragonien
前卅三年	33 f.Kr.
硫酸	Svavelsyra
同海機場	Dong Hoi flygplats
Category:大韓民國紀事	Kategori:Sydkoreas historia
Category:日本史	Kategori:Japans historia
伯力	Chabarovsk
Category:越南史	Kategori:Vietnams historia
孔子	Konfucius
莎拉伯恩哈特	Sarah Bernhardt
Category:伊拉克史	Kategori:Iraks historia
南加州大学	University of Southern California
Category:數學	Kategori:Matematik
Category:蒙古史	Kategori:Mongoliets historia
Category:人造語言	Kategori:Konstgjorda språk
文藝復興	Renässansen
歐元	Euro
美金	Amerikansk dollar
地中海	Medelhavet
遼	Liaodynastin
杭州市	Hangzhou
基督教	Kristendom
Template:亞洲	Mall:Asien
金朝	Jindynastin (1115–1234)
柏林圍牆	Berlinmuren
稻	Ris
大陸	Världsdelar och kontinenter
京	Huvudstad
Template:門	Mall:Portal
一九四八年	1948
艾爾瑪善鎮	Almazán
黃現璠	Huang Xianfan
一九四五年	1945
一九五八年	1958
日語	Japanska
百科全書	Uppslagsverk
維基大典:卷首	Portal:Huvudsida
一九五九年	1959
Template:正典	Mall:Bra
電晶體	Transistor
棒球	Baseboll
奧林匹克運動會	Olympiska spelen
長江	Yangtze
喜瑪拉雅山	Himalaya
落磯山	Klippiga bergen
韃靼斯坦共和國	Tatarstan
一二六三年	1263
古斯巴達	Sparta
埃斯特雷馬杜拉	Extremadura
安達盧西亞	Andalusien
麥加	Mecka
毛澤東	Mao Zedong
西安市	Xi'an
拉薩市	Lhasa
哲學	Filosofi
Category:速刪候	Kategori:Snabbraderingar
茶	Te
馬可·波羅	Marco Polo
一三六三年	1363
共產主義	Kommunism
一三六八年	1368
迦太基	Karthago
大英博物館	British Museum
巴拉頓湖	Balaton
蒙庇利埃	Montpellier
Category:天文	Kategori:Astronomi
吉他	Gitarr
同性戀	Homosexualitet
漢堡包	Hamburgare
夸克	Kvark
高斯	Carl Friedrich Gauss
一六四四年	1644
一六四五年	1645
Category:恒星	Kategori:Stjärnor
李白	Li Bai
伽羅華	Évariste Galois
政府	Regering
秦始皇帝	Qin Shi Huangdi
秦二世皇帝	Qin Er Shi
秦王子嬰	Ying Ziying
中東	Mellanöstern
漢	Handynastin
漢太祖高皇帝	Liu Bang
漢孝惠皇帝	Han Huidi
漢太宗孝文皇帝	Han Wendi
漢孝景皇帝	Han Jingdi
漢世宗孝武皇帝	Han Wudi
聖女貞德	Jeanne d’Arc
王莽	Wang Mang
意理	Ideologi
帝國主義	Imperialism
漢世祖光武皇帝	Han Guangwudi
共和	Republik
國	Stat
元	Yuandynastin
德意志第三帝國	Nazityskland
哥倫布	Christofer Columbus
庫克船長	James Cook
科爾蒂斯	Hernán Cortés
鄭和	Zheng He
大堡礁	Stora barriärrevet
巴拿馬運河	Panamakanalen
晉	Jindynastin (265–420)
黃河	Gula floden
晉武帝	Sima Yan
隋	Suidynastin
西夏	Xixia
脫氧核酸	DNA
趙宋	Songdynastin
宋太祖	Song Taizu
宋徽宗	Song Huizong
歐拉	Leonhard Euler
一七七四年	1774
一七七五年	1775
一七七六年	1776
一八六六年	1866
一八六七年	1867
一八六八年	1868
晝	Morgon
拿破崙二世	Napoleon II
砒霜	Arseniktrioxid
法律	Juridik
一七九四年	1794
世界人權宣言	FN:s deklaration om de mänskliga rättigheterna
一七九五年	1795
一七九六年	1796
漢語	Kinesiska
細胞	Cell
全球暖化	Global uppvärmning
禪宗	Zen
鼠標	Datormus
聖奧思定	Augustinus
精靈	Fe
朊	Protein
理則	Logik
龍捲風	Tromb
幾何	Geometri
語法	Grammatik
熱帶氣旋	Tropisk cyklon
計學	Nationalekonomi
語言學	Språkvetenskap
文字	Skrift
阿拉伯字	Arabiska alfabetet
漢字	Kinesiska tecken
西里爾字母	Kyrilliska alfabetet
孫子兵法	Krigskonsten
Category:音樂	Kategori:Musik
紅樓夢	Drömmar om röda gemak
Category:法國史	Kategori:Frankrikes historia
哈利波特	Harry Potter
放手銃	Onani
法文維基大典	Franskspråkiga Wikipedia
死刑	Dödsstraff
人權	Mänskliga rättigheter
乳	Mjölk
山	Berg
沙漠	Öken
孫文	Sun Yat-sen
薩拉丁	Saladin
阿育王	Ashoka
阿克巴大帝	Akbar den store
香港	Hongkong
韓戰	Koreakriget
南北戰爭	Amerikanska inbördeskriget
首爾特別市	Seoul
上海市	Shanghai
清	Qingdynastin
越戰	Vietnamkriget
歐几里得	Euklides
巴斯克語	Baskiska
星座	Stjärnbild
拉脫維亞語	Lettiska
原子	Atom
宗教	Religion
朝鮮語	Koreanska
笛卡兒	René Descartes
官話	Mandarin (språk)
越南語	Vietnamesiska
猶太教	Judendom
老子	Lao Zi
電鼠	Pikachu
尼采	Friedrich Nietzsche
司馬遷	Sima Qian
斯密亞丹	Adam Smith
朱熹	Zhu Xi
廷巴克圖	Timbuktu
洋	Ocean
阿奎那	Thomas av Aquino
英王維多利亞	Viktoria av Storbritannien
釋迦牟尼	Buddha
馬丁·路德	Martin Luther
儒家	Konfucianism
腹	Buken
陰脈	Ven (blodkärl)
福克蘭群島	Falklandsöarna
陽脈	Artär
唐	Tangdynastin
威爾斯王妃黛安娜	Diana, prinsessa av Wales
唐高祖	Tang Gaozu
唐太宗	Tang Taizong
唐玄宗	Tang Xuanzong
唐憲宗	Tang Xianzong
小學	Grundskola
明	Mingdynastin
明太祖	Zhu Yuanzhang
明惠宗	Jianwen-kejsaren
明成祖	Yongle-kejsaren
明仁宗	Hongxi-kejsaren
明宣宗	Xuande-kejsaren
明英宗	Zhengtong-kejsaren
明代宗	Jingtai-kejsaren
明憲宗	Chenghua-kejsaren
明孝宗	Hongzhi-kejsaren
明武宗	Zhengde-kejsaren
明世宗	Jiajing-kejsaren
明穆宗	Longqing-kejsaren
明神宗	Wanli-kejsaren
明光宗	Taichang-kejsaren
明熹宗	Tianqi-kejsaren
明思宗	Chongzhen-kejsaren
電漿	Plasma
北斗七星	Karlavagnen
金正日	Kim Jong Il
元素週期表	Periodiska systemet
自殺	Självmord
九一一事件	11 september-attackerna
電話	Telefon
梵語	Sanskrit
化合物	Kemisk förening
算術	Aritmetik
食鹽	Salt
化學元素	Grundämne
方程	Ekvation
映射	Funktion
角	Vinkel
分子	Molekyl
加速度	Acceleration
能量	Energi
弈	Go (brädspel)
金屬	Metall
氣體	Gas
液體	Vätska
固體	Fast form
船舶	Skepp
農	Jordbruk
速度	Hastighet
納米科技	Nanoteknik
勾股定理	Pythagoras sats
證明	Matematiskt bevis
數	Tal
複數	Komplexa tal
公斤	Kilogram
公尺	Meter
大麥	Korn
繪畫	Målarkonst
華爾街	Wall Street
美國總統	USA:s president
東南亞	Sydostasien
瀋陽市	Shenyang
重慶市	Chongqing
天津市	Tianjin
武漢市	Wuhan
史前	Förhistorisk tid
古埃及	Forntida Egypten
白令海峽	Berings sund
古希臘	Antikens Grekland
傑弗遜	Thomas Jefferson
麥	Vetesläktet
格里曆	Gregorianska kalendern
拉丁文維基大典	Latinskspråkiga Wikipedia
麻雀 (棋牌)	Mahjong
鹽	Salter
牛頓（單位）	Newton (enhet)
度量衡	Mätning
萬國公制	Internationella måttenhetssystemet
集論	Mängdteori
哈里發塔	Burj Khalifa
長城	Kinesiska muren
整數	Heltal
球	Sfär
大憲章	Magna Charta
阿兹特克	Azteker
上塞納省	Hauts-de-Seine
東羅馬帝國	Bysantinska riket
奧斯曼帝國	Osmanska riket
國內生產總值	Bruttonationalprodukt
銃	Eldvapen
伊比利半島	Pyreneiska halvön
坦克	Stridsvagn
實數	Reella tal
楈枒	Kokospalm
桃	Persika
湘語	Xiang (dialekt)
冰酪	Glass
文胸	Behå
阿拉伯語	Arabiska
本州	Honshu
四國	Shikoku
地中海氣候	Medelhavsklimat
科西嘉	Korsika
頂級域名	Toppdomän
百度	Baidu
澳門	Macao
土衛一	Mimas
土衛四	Dione (måne)
土衛三	Tethys (måne)
土衛五	Rhea (måne)
廣東省	Guangdong
廣西壯族自治區	Guangxi
蘇聯	Sovjetunionen
亡神星	90482 Orcus
塞德娜	90377 Sedna
孟德斯鳩	Charles-Louis de Secondat Montesquieu
青馬大橋	Tsing Ma-bron
維基大典:卓著	Wikipedia:Utmärkta artiklar
Template:Link FA	Mall:Link FA
維基大典:會館	Wikipedia:Bybrunnen
釜山廣域市	Pusan
廣州市	Guangzhou
蔣中正	Chiang Kai-shek
南京市	Nanjing
君士坦丁堡	Konstantinopel
首爾地鐵	Seouls tunnelbana
北京大學	Pekinguniversitetet
清華大學	Tsinghuauniversitetet
烏魯木齊市	Ürümqi
江蘇省	Jiangsu
浙江省	Zhejiang
鄧小平	Deng Xiaoping
新好男孩	Backstreet Boys
西藏	Tibet
西藏自治區	Autonoma regionen Tibet
圓	Cirkel
歐氏幾何	Euklidiskt rum
周恩來	Zhou Enlai
中國共產黨	Kinas kommunistiska parti
馮諾曼	John von Neumann
偽基大典	Psyklopedin
太平山	Victoria Peak
公理	Axiom
清聖祖	Kangxi-kejsaren
檀香山	Honolulu
紋章	Heraldik
曼徹斯特聯足球俱樂部	Manchester United FC
平壤直轄市	Pyongyang
模 (代數)	Modul (matematik)
九	9 (tal)
清高宗	Qianlong-kejsaren
蕭伯納	George Bernard Shaw
黑龍江省	Heilongjiang
香港島	Hongkongön
鹼金屬	Alkalimetall
非金屬	Icke-metall
鹵素	Halogen
稀有氣體	Ädelgas
維基大典:正典	Wikipedia:Bra artiklar
四川省	Sichuan
舊約	Gamla Testamentet
聖誕節	Jul
三角形	Triangel
印歐語系	Indoeuropeiska språk
穆阿邁爾·格達費	Muammar al-Gaddafi
獨島	Liancourtöarna
江南區	Gangnam-gu
大田廣域市	Daejeon
大邱廣域市	Daegu
仁川國際機場	Incheon International Airport
仁川廣域市	Inchon
京畿道	Gyeonggi
自然數	Naturliga tal
萬國音標字	Internationella fonetiska alfabetet
河北省	Hebei
革奴自由文檔許可協議	GNU Free Documentation License
臺灣	Taiwan (ö)
紐約	New York (olika betydelser)
公元元年	1
魯迅	Lu Xun
八	8 (tal)
馬德堡半球	Magdeburgska halvkloten
主禱文	Herrens bön
蒜	Vitlök
白	Vit
黑	Svart
六九八年	698
巴爾幹半島	Balkanhalvön
七二七年	727
墨索里尼	Benito Mussolini
四方	Väderstreck
十	10 (tal)
原子序	Atomnummer
九一八年	918
公元百年	100
五七〇年	570
四時	Årstid
二二二年	222
利物浦	Liverpool
鐵達尼號	RMS Titanic
五五二年	552
同位素	Isotop
蜚蠊	Kackerlackor
功率	Effekt
螢	Lysmaskar
索布語	Sorbiska
一八一二年戰爭	1812 års krig
頂點	Hörn
大理國	Dali (kungarike)
福岡市	Fukuoka
建城	Ab urbe condita
日本海	Japanska havet
宮古列島	Miyakoöarna
中亞	Centralasien
琉球國	Kungariket Ryukyu
朝鮮國	Joseon
大韓帝國	Kejsardömet Korea
高句麗	Koguryo
百濟	Baekje
新羅	Silla
奧匈帝國	Österrike-Ungern
吸血鬼日記	The Vampire Diaries
馬雅	Mayakulturen
印加國	Inkariket
縣	County
韓非子	Han Feizi
錦州市	Jinzhou, Liaoning
導數	Derivata
黃帝	Huang-Di
釣魚臺列嶼	Senkaku-öarna
中國	Kina (region)
成都市	Chengdu
咖啡廳	Kafé
蒲公英	Maskrossläktet
雪豹	Snöleopard
白話維基大典	Kinesiskspråkiga Wikipedia
二二一年	221
五四三年	543
五三六年	536
二三〇年	230
二〇二年	202
一九二年	192
總統	President
五五五年	555
五七一年	571
滿洲國	Manchukuo
二三一年	231
二二五年	225
三一一年	311
二二〇年	220
三一三年	313
五八七年	587
五四八年	548
五四九年	549
五五一年	551
五五七年	557
兄弟	Syskon
二二三年	223
二二四年	224
二一九年	219
大運河	Stora kanalen
五八九年	589
三〇四年	304
五五〇年	550
五八六年	586
五八八年	588
五五四年	554
二二九年	229
五八三年	583
二六五年	265
二六三年	263
五八五年	585
五八二年	582
五五六年	556
四二〇年	420
二八〇年	280
五八一年	581
五五八年	558
客家語	Hakka (språk)
切羅基語	Cherokesiska
羅素悖論	Russells paradox
五六九年	569
贛語	Gan (dialekt)
爪哇語	Javanesiska
滿語	Manchuiska
弧度	Radian
五五三年	553
三〇七年	307
五八四年	584
杜甫	Du Fu
人口	Befolkning
瓦爾帕萊索	Valparaíso
青銅	Brons
情報及特殊使命局	Mossad
尼亞加拉瀑布	Niagarafallen
吳語	Wu (dialekt)
昭和天皇	Hirohito
基地組織	Al-Qaida
穆罕默德二世	Mehmet II
希臘神話	Grekisk mytologi
秦	Qin (stat)
新疆維吾爾族自治區	Xinjiang
萬國首都全覽	Lista över huvudstäder
周	Zhoudynastin
形而上學	Metafysik
白宮	Vita huset
北海道	Hokkaido
科科斯（基林）群島	Kokosöarna
胡志明	Ho Chi Minh
蘇軾	Su Shi
明尼阿波利斯	Minneapolis
集	Mängd
順化市	Hué
閩東語	Mindong
閩南語	Minnan
離子	Jon
壯族	Zhuang
南斯拉夫	Jugoslavien
長毛象	Mammutar
四邊形	Fyrhörning
三船敏郎	Toshiro Mifune
文言	Klassisk kinesiska
線	Rät linje
甲烷	Metan
孫武	Sun Zi
中央情報局	Central Intelligence Agency
語法學	Syntax
聯合國安全理事會	FN:s säkerhetsråd
眼鏡	Glasögon
火柴	Tändsticka
多邊形	Polygon
市場	Marknad (ekonomi)
南海	Sydkinesiska havet
朝鮮世宗	Sejong den store
俳句	Haiku
黃海	Gula havet
今上天皇	Akihito
橫濱市	Yokohama
普魯士	Preussen
前四年	4 f.Kr.
柳州市	Liuzhou
皇帝	Kejsare
索契	Sotji
壓強	Tryck
龍貓	Min granne Totoro
线粒体	Mitokondrie
吠陀	Veda
橢圓	Ellips (matematik)
杠杆	Hävstång
自由亞洲電臺	Radio Free Asia
蟹	Krabbor
前九十年	90 f.Kr.
酸鹼度	PH
美國革命	Amerikanska frihetskriget
安徽省	Anhui
前九十一年	91 f.Kr.
忠清北道	Nordchungcheong
忠清南道	Sydchungcheong
內蒙古自治區	Inre Mongoliet
金日成	Kim Il Sung
慶尚南道	Sydgyeongsang
慶尚北道	Nordgyeongsang
全羅北道	Nordjeolla
全羅南道	Sydjeolla
濟州特別自治道	Jeju
巴別塔	Babels torn
蔚山廣域市	Ulsan
光州廣域市	Gwangju
一元二次方程	Andragradsekvation
李斯特	Franz Liszt
美式足球	Amerikansk fotboll
前八十七年	87 f.Kr.
哥德爾	Kurt Gödel
摩爾	Mol
華國鋒	Hua Guofeng
烷烴	Alkan
希爾伯特	David Hilbert
前九十五年	95 f.Kr.
黃金分割	Gyllene snittet
福建省	Fujian
班夫國家公園	Banffs nationalpark
查士丁尼一世	Justinianus I
前七十四年	74 f.Kr.
慶州市	Gyeongju
安東市	Andong
尚州市	Sangju
阿貝爾·塔斯曼	Abel Tasman
海南省	Hainan
功	Fysikaliskt arbete
漢語拼音	Pinyin
莽原氣候	Savann
甘肅省	Gansu
蘇州市	Suzhou
溫州市	Wenzhou
無錫市	Wuxi
湖州市	Huzhou
紹興市	Shaoxing
崑山市	Kunshan
寧波市	Ningbo
紙鳶	Drake (leksak)
前二〇一年	201 f.Kr.
前二〇二年	202 f.Kr.
哈爾濱市	Harbin
油	Olja
拓撲學	Topologi
文身	Tatuering
金融學	Finans
雲南省	Yunnan
多項式	Polynom
山東省	Shandong
中南半島	Indokina
天擇	Naturligt urval
地質年代	Geologisk tidsskala
壟斷	Monopol
河南省	Henan
遼寧省	Liaoning
席德	El Cid
刳剔者傑克	Jack Uppskäraren
前一五六年	156 f.Kr.
列奧尼達一世	Leonidas I av Sparta
前一三九年	139 f.Kr.
前一二二年	122 f.Kr.
前二〇六年	206 f.Kr.
西爾門·拉什迪	Salman Rushdie
前二〇三年	203 f.Kr.
化學鍵	Kemisk bindning
槍	Spjut
前一四一年	141 f.Kr.
僧院	Kloster
白堊紀	Krita (geologi)
前二〇九年	209 f.Kr.
皮薩羅	Francisco Pizarro
點	Punkt (geometri)
骰子	Tärning
吉林省	Jilin
東海	Östkinesiska havet
前二三二年	232 f.Kr.
湖南省	Hunan
青海省	Qinghai
前一九七年	197 f.Kr.
前二〇七年	207 f.Kr.
前一八八年	188 f.Kr.
矢	Pil (vapen)
前二〇五年	205 f.Kr.
鮨	Sushi
前二〇八年	208 f.Kr.
湖北省	Hubei
山西省	Shanxi
魔方	Rubiks kub
伊洛瓦底省	Ayeyarwady (region)
貴州省	Guizhou
京都議定書	Kyotoprotokollet
聯合國大會	FN:s generalförsamling
乙酸	Ättiksyra
安達曼海	Andamansjön
前二〇四年	204 f.Kr.
胡適	Hu Shi
莊子	Zhuang Zi
清孝欽顯皇后	Änkekejsarinnan Cixi
陝西省	Shaanxi
Template:共享類	Mall:Commonscat
三八三年	383
德文維基大典	Tyskspråkiga Wikipedia
拋物線	Parabel (kurva)
尿素	Urea
質數	Primtal
五七二年	572
南北朝	De sydliga och nordliga dynastierna
吾世	Minecraft
罷工	Strejk
都羅山車驛	Dorasanstationen
李舜臣汝諧	Yi Sun-shin
泰國地方	Thailands administrativa indelning
中華人民共和國地方	Administrativa regioner i Kina
日本都道府縣	Japans prefekturer
氧化物	Oxider
合數	Sammansatt tal
因數	Delbarhet
口琴	Munspel
朝鮮灣	Koreabukten
Template:Taxobox	Mall:Taxobox
繩文時代	Jōmon
魔法少女小圓	Puella Magi Madoka Magica
太極	Taiji
平行	Parallell (matematik)
極品飛車	Need for Speed
海鳥	Havsfåglar
琉球語	Ryūkyū (språk)
閩語	Min (språk)
江西省	Jiangxi
阿卜杜拉·本·阿卜杜勒-阿齊茲·沙特	Abdullah bin Abdul Aziz
寧夏回族自治區	Ningxia
揚州市	Yangzhou
鎮江市	Zhenjiang
嘉興市	Jiaxing
金華市	Jinhua
衢州市	Quzhou
台州市	Taizhou, Zhejiang
舟山市	Zhoushan
石家莊市	Shijiazhuang
亞當與夏娃	Adam och Eva
卡金納答	Kakinada
珠海	Zhuhai
韶關市	Shaoguan
東莞市	Dongguan
俄羅斯正教會	Rysk-ortodoxa kyrkan
鯢	Kinesisk jättesalamander
空師	Flygvapen
大名	Daimyo
威氏鷸	Wilsonbeckasin
哈布斯堡氏	Habsburg
中央銀行	Centralbank
福州市	Fuzhou
南平市	Nanping
莆田市	Putian
三明市	Sanming
泉州市	Quanzhou
廈門市	Xiamen
漳州市	Zhangzhou
龍岩市	Longyan
寧德市	Ningde
西寧市	Xining
西遊記	Färden till Västern
三國演義	Romansen om de tre kungadömena
水滸傳	Berättelser från träskmarkerna
鄂州市	Ezhou
福島縣	Fukushima (prefektur)
豬油	Ister
鞍山市	Anshan, Liaoning
羅馬治世	Pax Romana
克羅內克	Leopold Kronecker
康托爾	Georg Cantor
戴德金	Richard Dedekind
寒武紀	Kambrium
十六元數	Sedenion
神聖羅馬皇帝腓特烈一世	Fredrik I Barbarossa
前三八七年	387 f.Kr.
盲文	Punktskrift
千葉縣	Chiba prefektur
賽珍珠	Pearl Buck
聯合國秘書長	Förenta nationernas generalsekreterare
龐加萊	Henri Poincaré
西北水道	Nordvästpassagen
十進制	Decimala talsystemet
烯烴	Alken
皇祚	Kimi ga yo
氣壓	Lufttryck
箸	Ätpinnar
英格蘭王表	Lista över Englands regenter
民之旨	Jana-Gana-Mana
臺北一零一	Taipei 101
化學式	Kemisk formel
波斯	Persiska riket
群 (代數)	Grupp (matematik)
天安門	Himmelska fridens port
波蘭球	Polandball
三角函數	Trigonometrisk funktion
六四事件	Protesterna och massakern på Himmelska fridens torg
趙紫陽	Zhao Ziyang
胡耀邦	Hu Yaobang
安樂死	Dödshjälp
姓氏	Efternamn
醛	Aldehyd
規	Passare
物質之量	Substansmängd
平安北道	Norra P'yŏngan
咸鏡南道	Södra Hamgyong
島國	Östat
尺規作圖	Geometrisk konstruktion
京都府	Kyoto prefektur
絕對值	Absolutbelopp
羅賓漢	Robin Hood
表數法	Talsystem
大阪府	Osaka prefektur
瑪瑙	Agat
愛媛縣	Ehime prefektur
圓錐曲線	Kägelsnitt
海平面	Havsyta
羅馬皇帝表	Lista över romerska kejsare
矢量空間	Linjärt rum
距	Avstånd
臺灣海峽	Taiwansundet
山口縣	Yamaguchi prefektur
市盈率	P/E
神奈川縣	Kanagawa prefektur
中國地方	Chugoku
長野縣	Nagano prefektur
殷商	Shangdynastin
色諾芬	Xenofon
兵庫縣	Hyogo prefektur
廣州恆大淘寶蹴鞠會	Guangzhou Evergrande FC
關係 (數學)	Binär relation
等價	Ekvivalensrelation
主格	Nominativ
泰國灣	Thailandviken
螳螂	Bönsyrsor
維基大典:書海	Wikipedia:Bokkällor
征夷大將軍	Shogun
春節	Kinesiskt nyår
切腹	Seppuku
色盲	Defekt färgseende
阿什莫爾島與卡捷島	Ashmore- och Cartieröarna
農曆	Kinesiska kalendern
可樂	Cola
高知縣	Kochi prefektur
道德經	Daodejing
萬有引力	Newtons gravitationslag
坐標幾何	Analytisk geometri
芬瑟島	Fraserön
臺南市	Tainan
與格	Dativ
摩爾質量	Molmassa
滿洲族	Manchuer
義大利半島	Apenninska halvön
袁枚	Yuan Mei
汽水	Läskedryck
天象館	Planetarium
微積分	Infinitesimalkalkyl
岳陽市	Yueyang
東寧	Kungadömet Tungning
李斯	Li Si
碗	Skål
全等	Kongruens (geometri)
維多利亞港	Victoria Harbour
義勇軍進行曲	De frivilligas marsch
數理物理	Matematisk fysik
紅花	Safflor
庖人	Kock
大正天皇	Taishokejsaren
主義	-ism
毛納洛峰	Mauna Loa
富牌國際機場	Phu Bais internationella flygplats
符節	Lösenord
環 (代數)	Ring (matematik)
環球小姐	Miss Universum
香川縣	Kagawa prefektur
曲線	Kurva
白求恩	Norman Bethune
牽牛花	Kejsarvinda
中日戰爭	Kinesisk-japanska kriget
平面幾何	Euklidisk geometri
基數	Kardinaltal
二元運算	Binär operator
餘弦定理	Cosinussatsen
新幹線	Shinkansen
雙曲線	Hyperbel
星際爭霸	Starcraft
反射	Reflexion (fysik)
形意拳	Xingyiquan
近視	Närsynthet
代數數	Algebraiska tal
夏后氏	Xiadynastin
連續	Kontinuerlig funktion
教廷諸屬國	Kyrkostaten
濟南市	Jinan
十一月革命	Tyska novemberrevolutionen
中國抗日戰爭	Andra kinesisk-japanska kriget
青島市	Qingdao
PSP	Playstation Portable
葛利斯五八一丙	Gliese 581 c
官能團	Funktionell grupp
世氣公會	Meteorologiska världsorganisationen
見即所得	WYSIWYG
新西班牙代王領	Nya Spanien
織田信長	Oda Nobunaga
向日葵	Solros
南昌市	Nanchang
中壢區	Zhongli
玫瑰之名	Rosens namn
幾何原本	Elementa
米高·哥連斯	Michael Collins
金本位	Myntfot
直積	Cartesisk produkt
艾狄胥	Paul Erdős
四元數	Kvaternion
長沙市	Changsha
有機化合物	Kolföreningar
明治天皇	Meiji
源實朝	Minamoto no Sanetomo
蜉蝣	Dagsländor
伊藤博文	Hirobumi Ito
絞刑	Hängning
門:史	Portal:Historia
電極	Elektrod
阿拉伯數字	Arabiska siffror
股骨	Lårben
子集	Delmängd
海東青	Jaktfalk
日文維基大典	Japanskspråkiga Wikipedia
繁體字	Traditionella kinesiska tecken
甲午戰爭	Första kinesisk-japanska kriget
哈丹格爾小提琴	Hardingfela
克里希那穆提	Jiddu Krishnamurti
宦官	Eunuck
選擇公理	Urvalsaxiomet
行星環	Planetarisk ring
青藏高原	Tibetanska högplatån
古文書	Paleografi
數學符表	Lista över matematiska symboler
錫克金廟	Gyllene templet
查良鏞	Jin Yong
卡奔塔利亞灣	Carpentariaviken
度量空間	Metriskt rum
千分比	Promille
交換群	Abelsk grupp
高雄市	Kaohsiung
華盛頓歐文	Washington Irving
易經	I Ching
弩	Armborst
渤海	Bohai
甑帶瘡	Bältros
西楚霸王	Xiang Yu
戰艦	Slagskepp
人魚	Sjöjungfru
海倫公式	Herons formel
昆明市	Kunming
天氣預報	Väderprognos
人蔘	Panax ginseng
回族	Hui (folk)
蘭州市	Lanzhou
期貨	Terminskontrakt
鰂	Sepialiknande bläckfiskar
林則徐	Lin Zexu
三國	De tre kungadömena
春秋時代	Vår- och höstperioden
戰國	De stridande staterna
名偵探柯南	Mästerdetektiven Conan
區間	Intervall (matematik)
清宣統帝	Puyi
併集	Union (matematik)
簡化字	Förenklade kinesiska tecken
合肥市	Hefei
交集	Snitt
常染色體	Autosom
啓	Qi (kung)
簡歷	Curriculum vitae
蝴蝶效應	Fjärilseffekten
豐臣秀吉	Toyotomi Hideyoshi
假名	Kana (skriftsystem)
民律大全	Corpus juris civilis
白鱀豚	Asiatisk floddelfin
弦	Korda
平昌郡	Pyeongchang
泰國國際航空	Thai Airways International
北九州市	Kitakyūshū
匈奴	Xiongnu
孟子	Mencius
曾國藩	Zeng Guofan
桂林市	Guilin
海口市	Haikou
域 (代數)	Kropp (algebra)
海拔	Altitud
挪威廣播公司	Norsk Rikskringkasting
道	Tao
世界語維基大典	Esperantospråkiga Wikipedia
刺身	Sashimi
高錳酸鉀	Kaliumpermanganat
鴉片戰爭	Första opiumkriget
魔鬼之詩篇	Satansverserna
有序對	Ordnat par
金屬鍵	Metallbindning
書面挪威語維基大典	Norskspråkiga Wikipedia
序數	Ordinaltal
南京大屠殺	Nanjingmassakern
吳廷琰	Ngo Dinh Diem
複式記帳	Dubbel bokföring
麵	Nudlar
路易斯安那購地案	Louisianaköpet
扇	Solfjäder
平安時代	Heian
旦	Soluppgång
韓信點兵	Kinesiska restklassatsen
無窮小	Infinitesimal
單鏡筒反光相機	Spegelreflexkamera
雙城子	Ussurijsk
章炳麟	Zhang Binglin
張飛	Zhang Fei
張衡	Zhang Heng
張居正	Zhang Juzheng
張遼	Zhang Liao
張騫	Zhang Qian
趙 (釋義)	Zhao
趙	Zhao (stat)
趙雲	Zhao Yun
浙江大學	Zhejianguniversitetet
鄭成功	Koxinga
鎮海區	Zhenhai
周泰	Zhou Tai
周瑜	Zhou Yu
帝顓頊	Gaoyao (Xiadynastin)
諸葛亮	Zhuge Liang
慶良間群島	Keramaöarna
壯學	Zhuangologi
烏克蘭語維基大典	Ukrainskspråkiga Wikipedia
阿拉伯文維基大典	Arabiskspråkiga Wikipedia
金孟加拉	Amar Sonar Bangla
洞里薩湖	Tonlé Sap
賈姆謝德布爾	Jamshedpur
越南文維基大典	Vietnamesiskspråkiga Wikipedia
負數	Negativa tal
中醫	Traditionell kinesisk medicin
高松市	Takamatsu (stad)
中華人民共和國憲法	Folkrepubliken Kinas konstitution
提格兰二世	Tigran II
珠江	Pärlfloden
泰西格致史	Vetenskapshistoria
五帝	Tre härskare och fem kejsare
瑪格麗特一世	Drottning Margareta
日本國會	Japans parlament
先哥倫布	Förcolumbiansk tid
英聯邦王國	Samväldesrike
彼得一世島	Peter I:s ö
墓碑	Gravsten
十二銅表法	Tolv tavlornas lag
漢魏武王	Cao Cao
連江縣	Lianjiang, Fuzhou
斬首	Halshuggning
垂直	Vinkelrät
冪集	Potensmängd
魚鉤	Fiskekrok
齊齊哈爾市	Qiqihar
椰蟹	Kokoskrabba
俄文維基大典	Ryskspråkiga Wikipedia
平行公理	Parallellaxiomet
春武里府	Chon Buri
西線無戰事	På västfronten intet nytt
嘧啶	Pyrimidin
泰王國歌	Phleng Chat
冬至	Vintersolståndet
中國中央電視臺	China Central Television
圖蘭朵	Turandot (opera)
巴列維王朝	Pahlavidynastin
天皇	Kejsaren av Japan
熱帶雨林氣候	Tropiskt regnskogsklimat
袁世凱	Yuan Shikai
北海市	Beihai, Guangxi
袋鼠島	Kangaroo Island
阮世祖	Gia Long
辛普生沙漠	Simpsonöknen
雷曼兄弟公司	Lehman Brothers
娜塔莎·北鼎斐	Natasha Bedingfield
開集	Öppen mängd
健陀羅	Gandhara
愛爾蘭共和國總統	Irlands president
內積空間	Inre produktrum
江戶	Edo
泰山	Taishan
荀況	Xun Zi
九江市	Jiujiang
反氫	Antiväte
占婆	Champa
倒數	Reciprok (matematik)
黃道兇賊	Zodiac Killer
陰陽五行	De fem elementen (wu xing)
盧溝橋事變	Marco Polo-broincidenten
關羽	Guan Yu
龜	Sköldpaddor
阮福晪	Bao Dai
空集	Tomma mängden
羅馬 (釋義)	Roma
連通	Komponent (grafteori)
瀨戶內海	Japanska innanhavet
自由民主黨	Liberaldemokratiska partiet (Japan)
環	Loop (olika betydelser)
利瑪竇	Matteo Ricci
原富	Nationernas välstånd
技術分析	Teknisk analys
哆啦A夢	Doraemon
宋卡府	Songkhla (provins)
甲米府	Krabi (provins)
拉廊府	Ranong (provins)
伏羲	Fuxi
法家	Legalism (kinesisk filosofi)
九龍	Kowloon
瑪麗·安·尼科爾斯	Mary Ann Nichols
素叻府	Surat Thani
成本	Utgift
桐艾府	Trat
五代	De fem dynastierna och De tio rikena
瑪麗·簡·凱利	Mary Jane Kelly
森理世	Riyo Mori
補集	Komplement
靖國神社	Yasukuni Jinja
博他侖府	Phatthalung
鹽田	Salin
班武里府	Prachuap Khiri Khan (provins)
洛坤府	Nakhon Si Thammarat
春蓬府	Chumphon
臺中市	Taichung
漢昭烈皇帝	Liu Bei
干支	Himmelska stammar och jordiska grenar
三國志	Krönika över de tre kungadömena
邁克學搖滾	Michael Learns to Rock
金門縣	Kinmen
新竹市	Hsinchu
嘉義市	Jiayi
基隆市	Chilung
從眾	Argumentum ad populum
牢不可破之聯盟	Hymn till Sovjetunionen
相似	Likformighet
年號	Nianhao
大韓高宗	Gojong av Korea
語序	Grundordföljd
摩托羅拉	Motorola
賢哲賽義巴巴	Shirdi Sai Baba
淨土宗	Det rena landet
伊麗莎白·史泰德	Elizabeth Stride
安妮·查普曼	Annie Chapman
沈括	Shen Kuo
懿德天皇	Itoku
史記	Shiji
早稻田大學	Wasedauniversitetet
孫吳	Östra Wu
論語	Lun-yü
平清盛	Taira no Kiyomori
澳洲聯邦銀行	Commonwealth Bank of Australia
海寧市	Haining
拉臘·杜塔	Lara Dutta
小野田寬郎	Hiroo Onoda
清太宗	Hung Taiji
漢高皇后	Änkekejsarinnan Lü
楊貴妃	Yang Guifei
推古天皇	Suiko
清德宗	Guangxu-kejsaren
鎖國	Isolationism
戈登	Charles George Gordon
清世祖	Shunzhi-kejsaren
清太祖	Nurhaci
進數	P-adiska tal
綏靖天皇	Suizei
阮攸	Nguyen Du
白居易	Bai Juyi
吳大帝	Sun Quan
屈原	Qu Yuan
魏世祖文皇帝	Cao Pi
神農	Shennong
小淵惠三	Keizo Obuchi
帝舜	Shun
安寧天皇	Annei
發勃耳	Jean Henri Fabre
張國榮	Leslie Cheung
蔣經國	Chiang Ching-kuo
王維	Wang Wei
陶潛	Tao Qian
林彪	Lin Biao
清世宗	Yongzheng-kejsaren
呂布	Lü Bu
鴨脷洲	Ap Lei Chau
清穆宗	Tongzhi-kejsaren
韓愈	Han Yu
米芾	Mi Fei
拓撲閉包	Slutet hölje
閉集	Sluten mängd
曹魏	Cao Wei
作格	Ergativ
尖竹汶府	Chanthaburi
基斯孔哈拉斯	Kiskunhalas
竭澤而漁	Utfiskning
通格	Absolutiv
清仁宗	Jiaqing-kejsaren
林語堂	Lin Yutang
杜牧	Du Mu
大韓純宗	Sunjong av Korea
婆羅多舞	Bharata natyam
清宣宗	Daoguang-kejsaren
清文宗	Xianfeng-kejsaren
北柳府	Chachoengsao
羅勇府	Rayong
阮景宗	Dong Khanh
福澤諭吉	Fukuzawa Yukichi
安慶市	Anqing
安祿山	An Lushan
六安市	Lu'an
呂不韋	Lü Buwei
陳獨秀	Chen Duxiu
蒂邁歐篇	Timaios (Platon)
魏 (釋義)	Wei
坂本龍馬	Sakamoto Ryoma
王守仁	Wang Yangming
李鴻章	Li Hongzhang
顧愷之	Gu Kaizhi
王羲之	Wang Xizhi
中秋	Månfestivalen
李珥	Yi I
光中帝	Nguyen Hue
梁啟超	Liang Qichao
墓	Gravvård
沙繳府	Sa Kaeo
緊集	Kompakt
依善	Isan
高順	Gao Shun
赤腹蠑螈	Japansk eldbukssalamander
南陽市	Nanyang
秋葉原	Akihabara
徐光啟	Xu Guangqi
虹吸	Hävert
南充市	Nanchong
鄧小平理論	Deng Xiaoping-teori
阮聖祖	Minh Mang
阮出帝	Ham Nghi
丸龜市	Marugame
鄧麗君	Teresa Teng
李清照	Li Qingzhao
明成皇后	Min Myongsong
殷墟	Yinxu
阮福昭	Thanh Thai
詩經	Shi Jing
阮福晃	Duy Tan
秋瑾	Qiu Jin
阮簡宗	Kien Phuoc
阮福昇	Hiep Hoa
自斷	Autotomi
戈公省	Koh Kong (provins)
效用	Nytta
阮翼宗	Tu Duc
吳三桂	Wu Sangui
阮弘宗	Khai Dinh
潘清簡	Phan Thanh Giản
噌汁	Misosoppa
偏序	Partiellt ordnad mängd
康托爾定理	Cantors sats
新山一國際機場	Tan Son Nhat internationella flygplats
朝鮮半島	Koreahalvön
和服	Kimono
遜尼派	Sunni
白翎島	Baengnyeongön
哥德巴赫猜想	Goldbachs hypotes
三國遺事	Samguk Yusa
三國史記	Samguk Sagi
鬱陵郡	Ulleung
朝鮮漢字	Hanja
李滉	Yi Hwang
國會議員	Parlamentsledamot
摩爾體積	Molvolym
復旦大學	Fudanuniversitetet
萌	Moe (slang)
韓國放送公社	Korean Broadcasting System
涼宮春日系列	The Melancholy of Haruhi Suzumiya
莎阿南	Shah Alam
玉山	Yushan
大嶼山	Lantau
楚	Chu (stat)
梅爾維爾島	Melvilleön (Northern Territory)
新	Wang Mangs interregnum
北太平洋露脊鯨	Stillahavsnordkapare
海北藏族自治州	Haibei
西單民主牆	Demokratimuren
中國禮儀之爭	Ritstriden i Kina
鳳凰	Fenghuang
宋教仁	Song Jiaoren
阮恭宗	Duc Duc
中正紀念堂	Chiang Kai-sheks minneshall
阮憲祖	Thieu Tri
真言宗	Shingon
星期四島	Torsdagsön
吉田松陰	Yoshida Shōin
錢鍾書	Qian Zhongshu
嚴復	Yan Fu
帕覺柯	José Emilio Pacheco
猫眼林克	Link
尼奧寵物	Neopets
包頭市	Baotou
大化革新	Taikareformerna
壬辰倭亂	Japans invasion av Korea (1500-talet)
軍曹	Keroro - grodan från rymden
新界	Nya territorierna
午餐肉	Spam (maträtt)
呂底亞	Lydien
自焚	Självförbränning
廬山	Lushan (berg)
老撾之歌	Pheng Xat Lao
夏禹	Yu
漢 (釋義)	Han
杭思朗	Armstrong
馬步芳	Ma Bufang
香港語言學學會粵語拼音方案	Jyutping
刀	Dao (svärd)
水龍頭	Vattenkran
子拓撲	Delrumstopologi
廣州地鐵	Guangzhou Metro
性染色體	Könskromosom
算術基本定理	Aritmetikens fundamentalsats
存活期	Time to Live
稠密	Tät mängd
崑曲	Kunqu
流亡政府	Exilregering
天主教輔仁大學	Fu Jen katolska universitet
武器貿易條約	Vapenhandelsfördraget
內田蝲蛄	Signalkräfta
諡	Postumt namn
大東諸島	Daitoöarna
恆春丙戌地震	Jordbävningen i Hengchun 2006
李時珍	Li Shizhen
東沙	Dongshaöarna
張勳	Zhang Xun
和珅	Heshen
聶榮臻	Nie Rongzhen
劉伯承	Liu Bocheng
蒼南縣	Cangnan
李仁宗	Ly Nhan Tong
段祺瑞	Duan Qirui
臺灣問題	Taiwans politiska status
太平公主	Prinsessan Taiping
世界新七大奇蹟	Världens sju nya underverk
臺北捷運	Taipeis tunnelbana
延邊州	Yanbian
桃園區	Taoyuan
李太祖	Ly Thai To
色戒	Lust, Caution
清明	Qingmingfestivalen
釣魚嶼	Uotsuri-jima
墨家	Mohism
帝嚳	Ku (kejsare)
琴	Guqin
範空間	Normerat rum
有界	Begränsad mängd
呂氏春秋	Lüshi chunqiu
乃蠻	Naimaner
鎮	Köping (Kina)
魯	Lu (stat)
倫敦東隅	East End
申 (地支)	Apa (zodiak)
歐羅巴	Europa (olika betydelser)
八元數	Oktonion
春秋	Vår- och höstannalerna
黃巾之亂	Gula turbanerna
迴文數	Palindromtal
沖繩縣	Okinawa prefektur
三國志人物列表	Lista över personer från De tre kungadömena
百度大典	Baidu Baike
基 (拓撲)	Bas (topologi)
本草綱目	Bencao gangmu
帝堯	Yao (kejsare)
二虎歌	Broder Jakob
南越	Nanyue
赤壁之戰	Slaget vid Chibi
超複數	Hyperkomplexa tal
奧海鎮	Ojai
天下通言	Internationellt hjälpspråk
渭水	Weifloden
阿巴諾湖	Albanosjön
康熙字典	Kangxi-ordboken
證明論	Bevisteori
石	Koku
族 (數學)	Familj (matematik)
中華民國元首	Lista över Republiken Kinas presidenter
內點	Det inre
州際三十五號公路大橋	I-35W Mississippi River bridge
元朗區	Yuen Long
北魏	Norra Wei
雲隙光	Skuggstrålar
康威數	Surreella tal
喃字	Chu nom
天命	Himlens mandat
周界	Rand (topologi)
漢水	Han Shui
窮奇	Kamaitachi
單連通	Enkelt sammanhängande mängd
吳	Wu (stat)
藁人之謬	Halmdocka
海瑞	Hai Rui
地球之年歲	Jordens ålder
曼谷大橋	Krungthepbron
馬拉浦南	Malappuram
階乘質數	Fakultetsprimtal
代數 (代數)	Algebra över en kropp
汶川縣	Wenchuan
江陰市	Jiangyin
固始縣	Gushi
馬達納帕利	Madanapalle
臨安市	Lin'an
越秀	Yuexiu
新會區	Xinhui
黃巖區	Huangyan
大都	Khanbalik
倉頡	Cangjie
卡羅萊納箱龜	Carolinasköldpadda
凌遲	Lingchi
美洲殖民	USA:s koloniala historia
燕	Yan (Zhoudynastin)
日本新字體	Shinjitai
周武王	Zhou Wu
去衣馳騁	Streaking
宋	Song (stat)
頌聖歌	Phleng Sansaroen Phra Barami
閣帕岸島	Phangan
說文解字	Shuowen Jiezi
祁連山	Qilianbergen
中國共產黨中央政治局	Politbyrån i Kinas kommunistiska parti
韓國	Korea (olika betydelser)
亞米利加蝲蛄	Röd sumpkräfta
源義仲	Minamoto no Yoshinaka
藏學	Tibetologi
日本舊字體	Kyūjitai
人民公社	Folkkommun
瑟	Se (instrument)
辛棄疾	Xin Qiji
丁先皇	Dinh Bo Linh
譚嗣同	Tan Sitong
共形場論	Konform fältteori
鰲拜	Oboi
黎太祖	Le Loi
零號元素	Neutronium
六朝	De sex dynastierna
京口	Jingkou
維基大典:大使館	Wikipedia:Ambassaden
慶元縣	Qingyuan, Lishui
歐陽詢	Ouyang Xun
叉燒包	Cha siu baau
分數	Rationella tal
賀拉斯多尼索普	Horace Donisthorpe
黎大行	Le Hoan
胡季犛	Hồ Quý Ly
古丁尼柏國家公園	Quttinirpaaqs nationalpark
竹林七賢	De sju vise i bambulunden
下城區	Xiacheng
武穴市	Wuxue
海安縣	Hai'an
顧城	Gu Cheng
動物莊園	Djurfarmen
Category:德國史	Kategori:Tyskland
Category:俄羅斯聯邦書	Kategori:Ryssland
Category:大韓民國書	Kategori:Sydkorea
Category:羅馬帝國書	Kategori:Romerska riket
Category:鳥	Kategori:Fåglar
Category:植物	Kategori:Växter
Category:物理	Kategori:Fysik
Category:自然科學	Kategori:Naturvetenskap
Category:化學	Kategori:Kemi
Category:史部	Kategori:Historia
Category:群	Kategori:Samhälle
Category:宗教	Kategori:Religion
Category:運動	Kategori:Sport
Category:經部	Kategori:Vetenskap
Category:聯合國	Kategori:Förenta nationerna
Category:地球	Kategori:Jorden
道路連通	Sammanhängande rum
平潭島	Pingtanön
桿秤	Besman
羅伯特·赫德	Robert Hart
古羅馬	Romerska riket
聖火降魔錄	Fire Emblem
清談	Qingtan
太平清領道	Taipingjing
不寐	Sömnlöshet
Category:釋義	Kategori:Förgreningssidor
Category:哲學	Kategori:Filosofi
Category:心理	Kategori:Psykologi
Category:佛教	Kategori:Buddhism
Category:基督教	Kategori:Kristendom
Category:回教	Kategori:Islam
Category:猶太教	Kategori:Judendom
洋油貓弔詭	Smörgåskattsparadoxen
華東師範大學	East China Normal University
汝有二牯	Du har två kor
吳 (釋義)	Wu
唐寅	Tang Yin
丁亥中國雪災	Vinterstormarna i Kina 2008
鄰域	Omgivning
Category:殘章	Kategori:Stubbar
Category:維基分類	Kategori:Wikipedia:Strukturering
Category:維基事	Kategori:Wikipedia:Administration
Category:行星	Kategori:Planeter
Category:地質	Kategori:Geologi
未央宮	Weiyangpalatset
明治	Meijiperioden
維基大典:陳年今誌	Wikipedia:Dagens händelser
正數	Positiva tal
Help:凡例	Wikipedia:Introduktion till redigering
Template:太陽系	Mall:Solsystemet
春運	Chunyun
門:子	Portal:Filosofi
門:集	Portal:Konst
Category:小行星帶天體	Kategori:Asteroidbältet
Category:美國列傳	Kategori:Amerikaner
Template:Tl	Mall:Mall
Template:Userbox	Mall:Användarbox
Category:網頁瀏覽器	Kategori:Webbläsare
Template:世事	Portal:Huvudsida/Aktuella händelser
Category:律法	Kategori:Juridik
Category:計學	Kategori:Nationalekonomi
維基大典:有秩選舉	Wikipedia:Ansökan om administrativ behörighet
Category:醫學	Kategori:Medicin
Category:政治	Kategori:Politik
Category:教育	Kategori:Utbildning
Category:藝術	Kategori:Konst
會計	Redovisning
密思兒	Egypten
Category:統計	Kategori:Statistik
Template:Bot	Mall:Bot
加拿大	Kanada
Category:卓著	Kategori:Wikipedia:Utmärkta artiklar
維	Dimension
Category:遊戲	Kategori:Spel
門:經	Portal:Naturvetenskap
Category:幫助文檔	Kategori:Wikipedia:Hjälp
維基大典:世事	Portal:Aktuella händelser
Template:Documentation	Mall:Dokumentation
Category:有秩	Kategori:Wikipedia:Administratörer
維基大典:簿之權限	Wikipedia:Typer av användare
Category:半保護	Kategori:Halvlåsta sidor
維基大典:聯繫	Wikipedia:Kontakt
維基大典:市集	Wikipedia:Deltagarportalen
Category:維基人	Kategori:Användare efter språk
Category:維基人 (地方)	Kategori:Användare efter geografi
維基大典:忽略規則	Wikipedia:Strunta i reglerna
維基大典:五柱	Wikipedia:Grundprinciperna
企業	Näringsliv
Template:Softredirect	Mall:Mjuk omdirigering
Template:刪	Mall:Radera
Category:技術	Kategori:Teknologi
Category:語言	Kategori:Språk
Category:語法	Kategori:Grammatik
Category:維基大典	Kategori:Wikipedia
Category:諸語維基大典	Kategori:Wikipediautgåvor
Category:未索之頁	Kategori:Icke-indexerade sidor
Category:帶壞檔之頁	Kategori:Sidor med trasiga fillänkar
門:卷首	Portal:Portaler
Template:Navbox	Mall:Navbox
Template:捷徑	Mall:Genväg
Category:時區	Kategori:Tidszoner
Category:維基大典維護	Kategori:Kvalitetskontroll
門:美國史	Portal:USA
Template:!	Mall:!
Template:Navbar	Mall:Navbar
Template:Unicode	Mall:Unicode
Category:格式模板	Kategori:Formaterings- och funktionsmallar
Template:Transclude	Mall:Transclude
Template:Clear	Mall:Clear
Template:Nowrap	Mall:Nowrap
維基大典:當有之文	Wikipedia:Artiklar som bör finnas på Wikipedia
Category:數	Kategori:Tal
Category:書籍	Kategori:Böcker
Template:Wikisource	Mall:Wikisource
Template:Babel	Mall:Babel
Template:共享	Mall:Commons
Template:Link GA	Mall:Link GA
維基大典:掃興警示	Wikipedia:Spoilers
Template:芻文	Mall:Stub
Template:See also	Mall:Se även
Template:User de	Mall:Användare de
Template:User de-1	Mall:Användare de-1
Template:User es-2	Mall:Användare es
Template:User en-3	Mall:Användare en-3
Template:User en-1	Mall:Användare en-1
Template:User en-2	Mall:Användare en-2
Template:User en-4	Mall:Användare en-4
Template:User en	Mall:Användare en
Template:User de-2	Mall:Användare de-2
Template:User es-1	Mall:Användare es-1
Template:User fr-1	Mall:Användare fr-1
Category:香港大專院校	Kategori:Universitet och högskolor i Hongkong
Template:User he-2	Mall:Användare he-2
Template:User id-3	Mall:Användare id-3
Template:User sk	Mall:Användare sk
Template:User fr-2	Mall:Användare fr-2
Template:User ja	Mall:Användare ja
Template:User ja-1	Mall:Användare ja-1
Template:User fr	Mall:Användare fr
Category:智利	Kategori:Chile
Category:廿一世紀	Kategori:2000-talet
Category:維護模板	Kategori:Åtgärdsmallar
Category:User uk	Kategori:Användare uk
Category:User uk-N	Kategori:Användare uk-N
Template:Esoteric	Mall:Komplicerad kod
Template:Mod	Mall:Mod
Template:User uk	Mall:Användare uk
Category:百科全書	Kategori:Uppslagsverk
Template:歡迎	Mall:Nybörjare
Category:User ms	Kategori:Användare ms
Template:Ref	Mall:Ref
Category:連結模板	Kategori:Länkmallar
Category:User fr-1	Kategori:Användare fr-1
Template:Wikiquote	Mall:Wikiquote
Template:Image label	Mall:Image label
Template:Ja	Mall:Ja ikon
Template:維基諸策	Mall:Wikimedia Foundation
Template:大修	Mall:Pågår
Template:Es	Mall:Es ikon
Template:Ambox	Mall:Ambox
Template:Disputed	Mall:Faktakoll
Template:Hide in print	Mall:Uteslut vid utskrift
Category:美國史	Kategori:USA:s historia
Template:國	Mall:Landsfakta
Template:Infobox software	Mall:Datorprogram
Template:Wide image	Mall:Panorama
Template:Audio	Mall:Audio
Template:電玩訊欄	Mall:Datorspelsfakta
Template:卓著	Mall:Utmärkt
Category:User en-4	Kategori:Användare en-4
Category:User en	Kategori:Användare en
Category:User zh	Kategori:Användare zh
Category:User zh-N	Kategori:Användare zh-N
Category:User en-2	Kategori:Användare en-2
Category:曲	Kategori:Musikverk
Template:Infobox	Mall:Faktamall
Template:User zh	Mall:Användare zh
Template:Template other	Mall:Mall annan
Template:Legend	Mall:Legend
Template:引網	Mall:Webbref
Category:食	Kategori:Mat och dryck
Template:未已之作	Mall:Framtida
Template:Coor URL	Mall:Coor URL
Template:維基爾雅	Mall:Wiktionary
Template:Languageicon	Mall:Språkikon
Category:農業	Kategori:Jordbruk
Category:User ms-N	Kategori:Användare ms-N
Template:User ru	Mall:Användare ru
Category:二十世紀	Kategori:1900-talet
Template:IPA	Mall:IPA
Template:釋義二	Mall:Olika betydelser
Category:東羅馬史	Kategori:Bysantinska riket
Template:LangWithName	Mall:LangWithName
Template:Dyk	Portal:Huvudsida/Visste du att
Template:Archive box	Mall:Arkivbox
Template:KIA	Mall:KIA
Template:Navbox with collapsible groups	Mall:Navbox with collapsible groups
Template:Copyvio	Mall:Plagiat
Template:元素週期表	Mall:Periodiska systemet navbox
Template:天下觀	Mall:Global
Template:Image label end	Mall:Image label end
Template:澳大利亞地方	Mall:Australiens delstater och territorier
Template:Purge	Mall:Rensa
Template:土星之衛星	Mall:Saturnus månar
Template:User IE	Mall:Användare Internet Explorer
Template:中華人民共和國地方	Mall:Kina
Template:齋	Mall:Wikipediaanvändare
Template:User	Mall:Anv-data
非標準實數	Hyperreella tal
Template:Note	Mall:Note
Category:公司	Kategori:Företag
Template:User fr-3	Mall:Användare fr-3
Template:Th	Mall:Th ikon
Template:Redirect	Mall:Omdirigering
Category:電腦	Kategori:Datorer
Category:器	Kategori:Utrustning
Template:SUL Box	Mall:SUL Box
Category:複分析	Kategori:Komplex analys
Category:User ja-N	Kategori:Användare ja-N
Category:茶	Kategori:Te
Template:Browsebar	Mall:Browsebar
Template:釋義	Mall:Förgrening
Category:攝影	Kategori:Fotografi
Category:天皇本紀	Kategori:Japanska kejsare
Category:德意志第三帝國書	Kategori:Nazityskland
Category:朝鮮史	Kategori:Koreas historia
Category:礦冶	Kategori:Gruvdrift
Template:Legend inline	Mall:Legend inline
Template:User ksh	Mall:Användare ksh
Template:User yue-3	Mall:Användare zh-yue-3
Template:User yue-1	Mall:Användare zh-yue-1
Category:廣州	Kategori:Guangzhou
Category:建築	Kategori:Arkitektur
Category:生物	Kategori:Organismer
Template:De	Mall:De ikon
Template:Infobox person	Mall:Infobox biografi
Category:鐵路	Kategori:Spårtrafik
Template:InterWiki	Mall:Interwiki
Category:金蘭之模	Kategori:Interwikimallar
Template:User la-1	Mall:Användare la-1
Template:APEC	Mall:Apec
Template:歐洲	Mall:Europa
Category:User yue	Kategori:Användare zh-yue
Category:User sk	Kategori:Användare sk
Category:User fr	Kategori:Användare fr
Category:User id	Kategori:Användare id
Category:User ja	Kategori:Användare ja
Category:User la	Kategori:Användare la
Category:User th	Kategori:Användare th
Category:User fr-3	Kategori:Användare fr-3
Category:User fr-2	Kategori:Användare fr-2
Category:User ja-2	Kategori:Användare ja-2
Category:User ko-N	Kategori:Användare ko-N
Category:User fr-N	Kategori:Användare fr-N
Category:User ru-N	Kategori:Användare ru-N
Category:娛樂	Kategori:Nöjen
Category:商學	Kategori:Näringsliv
Template:User yue	Mall:Användare zh-yue
Category:文字	Kategori:Skrift
Category:User bg	Kategori:Användare bg
Category:輕小說	Kategori:Light novels
Category:道教	Kategori:Taoism
Category:User bg-N	Kategori:Användare bg-N
Category:User sk-N	Kategori:Användare sk-N
Category:User de	Kategori:Användare de
Category:User de-2	Kategori:Användare de-2
Category:User de-N	Kategori:Användare de-N
Category:User en-3	Kategori:Användare en-3
Category:User en-N	Kategori:Användare en-N
Category:User es	Kategori:Användare es
Category:User es-1	Kategori:Användare es-1
Category:User id-3	Kategori:Användare id-3
Category:韓語	Kategori:Koreanska
Category:幾何	Kategori:Geometri
Category:User ja-1	Kategori:Användare ja-1
Category:User ko	Kategori:Användare ko
Category:User ko-1	Kategori:Användare ko-1
Category:User ko-2	Kategori:Användare ko-2
Category:User ksh	Kategori:Användare ksh
Category:User ksh-N	Kategori:Användare ksh-N
Category:User la-3	Kategori:Användare la-3
Category:斯巴達書	Kategori:Sparta
Template:辨	Mall:Förväxlas
Category:User ru-1	Kategori:Användare ru-1
維基大典:巴别	Wikipedia:Babel
Template:木星之衛星	Mall:Jupiters månar
Category:化合物	Kategori:Kemiska föreningar
Category:大洋洲史	Kategori:Oceaniens historia
長安	Chang’an
Template:Math.abs	Mall:Abs
Category:以嗜好類之維基人	Kategori:Wikipedia:Användare efter intresse
Category:廣東省	Kategori:Guangdong
Category:四川省	Kategori:Sichuan
Category:遼寧省	Kategori:Liaoning
Category:陝西省	Kategori:Shaanxi
Category:安徽省	Kategori:Anhui
Category:江西省	Kategori:Jiangxi
Category:江蘇省	Kategori:Jiangsu
Category:吉林省	Kategori:Jilin
Category:福建省	Kategori:Fujian
Category:海南省	Kategori:Hainan
Category:河北省	Kategori:Hebei
Category:黑龍江省	Kategori:Heilongjiang
Category:湖北省	Kategori:Hubei
Category:地理	Kategori:Fysisk geografi
Category:水	Kategori:Vatten
Category:美洲史	Kategori:Amerikas historia
Template:提案	Mall:Föreslagen riktlinje
Category:社會科學	Kategori:Samhällsvetenskap
Template:Zh	Mall:Zh ikon
Template:User ja-2	Mall:Användare ja-2
Template:User ko-1	Mall:Användare ko-1
Template:User ru-2	Mall:Användare ru-2
Category:User ru	Kategori:Användare ru
Category:User ru-2	Kategori:Användare ru-2
Category:User yue-1	Kategori:Användare zh-yue-1
Template:En	Mall:En ikon
Category:山東省	Kategori:Shandong
Category:雲南省	Kategori:Yunnan
Category:浙江省	Kategori:Zhejiang
Category:青海省	Kategori:Qinghai
Category:河南省	Kategori:Henan
Category:湖南省	Kategori:Hunan
Template:Lang	Mall:Lang
Category:日本文學	Kategori:Japansk litteratur
Category:群學	Kategori:Sociologi
Template:2images	Mall:Dubbel bild
Category:三世紀	Kategori:200-talet
Category:十七世紀	Kategori:1600-talet
Category:七世紀	Kategori:600-talet
Category:人	Kategori:Människor
Category:東羅馬本紀	Kategori:Bysantinska kejsare
Category:門	Kategori:Portaler
Template:Ko	Mall:Ko ikon
Template:粒子	Mall:Navigationsruta partiklar
Template:Main	Mall:Huvudartikel
Category:User zh-0	Kategori:Användare zh-0
Category:希臘史	Kategori:Greklands historia
Category:澳大利亞史	Kategori:Australiens historia
Category:北韓紀事	Kategori:Nordkoreas historia
Category:加拿大史	Kategori:Kanadas historia
Template:User ko	Mall:Användare ko
Template:User ko-0	Mall:Användare ko-0
Template:User ru-1	Mall:Användare ru-1
Category:俄羅斯史	Kategori:Rysslands historia
Template:Multi-listen end	Mall:Multi-listen end
Category:羅馬皇帝本紀	Kategori:Romerska kejsare
維基大典:維基聊齋	Wikipedia:Kuriosaartiklar
Category:戲劇	Kategori:Teater
Category:中東史	Kategori:Främre Orientens historia
Category:User zh-1	Kategori:Användare zh-1
Category:User zh-4	Kategori:Användare zh-4
Category:User zh-3	Kategori:Användare zh-3
Category:User zh-2	Kategori:Användare zh-2
Category:刑法	Kategori:Straffrätt
Category:酸	Kategori:Syror
Category:算法	Kategori:Algoritmer
Category:一世紀	Kategori:000-talet
Category:十四世紀	Kategori:1300-talet
Category:二世紀	Kategori:100-talet
Category:四世紀	Kategori:300-talet
Category:十八世紀	Kategori:1700-talet
Category:八世紀	Kategori:700-talet
Category:整數	Kategori:Heltal
Category:香港列傳	Kategori:Personer från Hongkong
Category:印歐語系	Kategori:Indoeuropeiska språk
Category:化學元素	Kategori:Grundämnen
Category:日本小說	Kategori:Japanska romaner
Template:中國世界遺產	Mall:Världsarv i Kina
Category:姓氏	Kategori:Efternamn
Category:朝鮮民主主義人民共和國書	Kategori:Nordkorea
Category:英國史	Kategori:Storbritanniens historia
Category:中華史	Kategori:Kinas historia
Category:臺灣省教育	Kategori:Utbildning i Taiwan
Category:新聞學	Kategori:Journalistik
Category:前二世紀	Kategori:100-talet f.Kr.
Category:前三世紀	Kategori:200-talet f.Kr.
Category:越南地理志	Kategori:Vietnams geografi
Category:高句麗書	Kategori:Koguryo
Category:蘇聯書	Kategori:Sovjetunionen
Category:古羅馬史	Kategori:Antikens Rom
Category:滿洲國志	Kategori:Manchukuo
Category:前一世紀	Kategori:000-talet f.Kr.
Category:美國總統世家	Kategori:USA:s presidenter
Category:歐洲史	Kategori:Europas historia
Category:魚	Kategori:Fiskar
Category:北京市	Kategori:Peking
Category:果	Kategori:Frukter
Category:天候學	Kategori:Klimatologi
Category:亞洲地理志	Kategori:Asiens geografi
Category:人類學	Kategori:Antropologi
Category:作業系統	Kategori:Operativsystem
Category:明書	Kategori:Mingdynastin
Category:阮氏大南書	Kategori:Nguyendynastin
Category:天演	Kategori:Evolution
Category:動物	Kategori:Djur
Category:俄羅斯加盟共和國	Kategori:Rysslands delrepubliker
Category:三國書	Kategori:De tre kungadömena
Category:涼宮春日	Kategori:Haruhi Suzumiya
Category:兵器	Kategori:Vapen
Category:紀年	Kategori:Tideräkning
Category:弦論	Kategori:Strängteori
Category:數學分析	Kategori:Matematisk analys
Category:樂器	Kategori:Musikinstrument
Category:氣象	Kategori:Meteorologi
Category:實驗儀器	Kategori:Laboratorieutrustning
Category:香港	Kategori:Hongkong
Category:PS2遊戲	Kategori:Playstation 2-spel
Category:鹽	Kategori:Salter
Category:廣西壯族自治區	Kategori:Guangxi
Category:衣	Kategori:Kläder
Category:上海市	Kategori:Shanghai
Category:龜	Kategori:Sköldpaddor
Category:節日	Kategori:Festivaler
Category:臺北市	Kategori:Taipei
Category:書體	Kategori:Typsnitt
Category:古希臘史	Kategori:Antikens Grekland
Category:交通	Kategori:Transport
Category:玩	Kategori:Leksaker
Category:清本紀	Kategori:Qingdynastins kejsare
Category:群論	Kategori:Gruppteori
Category:數論	Kategori:Talteori
Category:拓撲學	Kategori:Topologi
Category:疇人	Kategori:Matematiker
Category:雕塑	Kategori:Skulptur
Category:大韓民國大統領世家	Kategori:Sydkoreas presidenter
Category:漢語	Kategori:Kinesiska
Category:澳門	Kategori:Macao
Category:塔	Kategori:Torn
Category:衛星	Kategori:Månar
Category:數理物理	Kategori:Matematisk fysik
Category:數學史	Kategori:Matematikens historia
Category:目錄學	Kategori:Bibliografi
夏至	Sommarsolståndet
中國 (釋義)	China
門:數學	Portal:Matematik
Category:三國人	Kategori:Personer under De tre kungadömena
Category:美國維基人	Kategori:Användare USA
Template:User yue-4	Mall:Användare zh-yue-4
Template:User yue-2	Mall:Användare zh-yue-2
Template:Sister	Mall:Interwikimall
Category:代數	Kategori:Algebra
Category:User ko-0	Kategori:Användare ko-0
Category:胴體	Kategori:Torso
Category:鹼	Kategori:Baser
Category:橋	Kategori:Broar
Category:矮行星	Kategori:Dvärgplaneter
Category:地震	Kategori:Jordbävningar
Category:東正教會	Kategori:Ortodox kristendom
Category:香港教育	Kategori:Utbildning i Hongkong
Category:電極	Kategori:Elektroder
Category:版權	Kategori:Upphovsrätt
Category:世界語	Kategori:Esperanto
Template:Lang-zh	Mall:Zh
Category:語法格	Kategori:Kasus
Category:內蒙古自治區	Kategori:Inre Mongoliet
Category:日本年號	Kategori:Japanska tideräkningsperioder
Category:蘇州市	Kategori:Suzhou
Category:律史	Kategori:Rättshistoria
門:化學	Portal:Kemi
Category:軍事	Kategori:Krigföring
Category:泰國報章	Kategori:Thailändska tidningar
Category:有機化學	Kategori:Organisk kemi
Category:琉球群島	Kategori:Ryukyuöarna
Category:船舶	Kategori:Fartyg
Category:衡器	Kategori:Mätinstrument
Category:電話	Kategori:Telefoni
Category:音節文字	Kategori:Stavelseskrift
Category:臺灣省大專院校	Kategori:Universitet och högskolor i Taiwan
Category:User cdo	Kategori:Användare cdo
Category:User cdo-N	Kategori:Användare cdo-N
Category:應用科學	Kategori:Tillämpade vetenskaper
Category:中華當世諸省	Kategori:Kinas provinser
Category:輿圖學	Kategori:Kartografi
Category:行星環	Kategori:Planetariska ringar
Template:Image label begin	Mall:Image label begin
Category:儒家	Kategori:Konfucianism
Category:民法	Kategori:Civilrätt
Category:李代數	Kategori:Liealgebror
Category:寧波市	Kategori:Ningbo
Template:Babels	Mall:Babels
Category:方位	Kategori:Väderstreck
Category:User en-1	Kategori:Användare en-1
Category:User de-1	Kategori:Användare de-1
Category:語言標示模	Kategori:Språkikoner
Category:非洲史	Kategori:Afrikas historia
Category:國憲	Kategori:Statsrätt
Template:FZW-Intro	Mall:Kontakt
Help:校對	Wikipedia:Flagged revisions
雨冰	Frysande regn
Template:海王星之衛星	Mall:Neptunus månar
Template:Multi-listen item	Mall:Multi-listen item
Template:User zh-yue-0	Mall:Användare zh-yue-0
維基大典:編輯次數	Wikipedia:Lista över Wikipedia-användare sorterad efter antalet redigeringar
Template:Style/IPA	Mall:Style/IPA
Template:Style/yid	Mall:Style/yid
麗水市	Lishui
Module:Yesno	Modul:Yesno
如釋冰	Let It Go (Disney)
Module:Arguments	Modul:Arguments
Special:近易	Special:Senaste ändringar
Module:HtmlBuilder	Modul:HtmlBuilder
Module:String	Modul:String
Module:Navbox	Modul:Navbox
Module:Infobox	Modul:Infobox
雨傘運動	Protesterna i Hongkong 2014
代言 (動漫)	Maskot
